CODREG;REG;CODDEP;CODARR;CODCAN;CODCOM;COM;PMUN;PCAP;PTOT
84;Auvergne-Rhône-Alpes;01;2;08;001;L'Abergement-Clémenciat;806;15;821
84;Auvergne-Rhône-Alpes;01;1;01;002;L'Abergement-de-Varey;262;6;268
84;Auvergne-Rhône-Alpes;01;1;01;004;Ambérieu-en-Bugey;14288;374;14662
84;Auvergne-Rhône-Alpes;01;2;22;005;Ambérieux-en-Dombes;1782;24;1806
84;Auvergne-Rhône-Alpes;01;1;04;006;Ambléon;113;0;113
84;Auvergne-Rhône-Alpes;01;1;01;007;Ambronay;2827;119;2946
84;Auvergne-Rhône-Alpes;01;1;01;008;Ambutrix;768;13;781
84;Auvergne-Rhône-Alpes;01;1;04;009;Andert-et-Condon;324;8;332
84;Auvergne-Rhône-Alpes;01;1;10;010;Anglefort;1101;15;1116
84;Auvergne-Rhône-Alpes;01;4;14;011;Apremont;368;11;379
84;Auvergne-Rhône-Alpes;01;1;10;012;Aranc;327;3;330
84;Auvergne-Rhône-Alpes;01;1;01;013;Arandas;143;4;147
84;Auvergne-Rhône-Alpes;01;4;15;014;Arbent;3336;91;3427
84;Auvergne-Rhône-Alpes;01;1;04;015;Arboys en Bugey;663;15;678
84;Auvergne-Rhône-Alpes;01;2;17;016;Arbigny;458;9;467
84;Auvergne-Rhône-Alpes;01;1;01;017;Argis;445;11;456
84;Auvergne-Rhône-Alpes;01;1;10;019;Armix;26;4;30
84;Auvergne-Rhône-Alpes;01;2;22;021;Ars-sur-Formans;1490;30;1520
84;Auvergne-Rhône-Alpes;01;1;10;022;Artemare;1213;16;1229
84;Auvergne-Rhône-Alpes;01;2;17;023;Asnières-sur-Saône;76;0;76
84;Auvergne-Rhône-Alpes;01;2;02;024;Attignat;3299;66;3365
84;Auvergne-Rhône-Alpes;01;2;17;025;Bâgé-Dommartin;4068;104;4172
84;Auvergne-Rhône-Alpes;01;2;17;026;Bâgé-le-Châtel;977;68;1045
84;Auvergne-Rhône-Alpes;01;2;12;027;Balan;2647;52;2699
84;Auvergne-Rhône-Alpes;01;2;22;028;Baneins;625;17;642
84;Auvergne-Rhône-Alpes;01;2;18;029;Beaupont;683;8;691
84;Auvergne-Rhône-Alpes;01;2;21;030;Beauregard;821;15;836
84;Auvergne-Rhône-Alpes;01;4;14;031;Bellignat;3671;234;3905
84;Auvergne-Rhône-Alpes;01;2;12;032;Béligneux;3414;29;3443
84;Auvergne-Rhône-Alpes;01;4;03;033;Valserhône;16434;336;16770
84;Auvergne-Rhône-Alpes;01;1;04;034;Belley;9207;343;9550
84;Auvergne-Rhône-Alpes;01;4;14;035;Belleydoux;308;8;316
84;Auvergne-Rhône-Alpes;01;1;10;036;Valromey-sur-Séran;1334;24;1358
84;Auvergne-Rhône-Alpes;01;1;11;037;Bénonces;309;3;312
84;Auvergne-Rhône-Alpes;01;2;18;038;Bény;759;19;778
84;Auvergne-Rhône-Alpes;01;1;10;039;Béon;439;7;446
84;Auvergne-Rhône-Alpes;01;2;02;040;Béréziat;480;10;490
84;Auvergne-Rhône-Alpes;01;1;01;041;Bettant;748;20;768
84;Auvergne-Rhône-Alpes;01;2;23;042;Bey;291;7;298
84;Auvergne-Rhône-Alpes;01;2;13;043;Beynost;4829;114;4943
84;Auvergne-Rhône-Alpes;01;4;03;044;Billiat;628;17;645
84;Auvergne-Rhône-Alpes;01;2;22;045;Birieux;285;3;288
84;Auvergne-Rhône-Alpes;01;2;23;046;Biziat;912;8;920
84;Auvergne-Rhône-Alpes;01;1;11;047;Blyes;1269;34;1303
84;Auvergne-Rhône-Alpes;01;2;13;049;La Boisse;3335;77;3412
84;Auvergne-Rhône-Alpes;01;2;17;050;Boissey;380;4;384
84;Auvergne-Rhône-Alpes;01;4;16;051;Bolozon;91;1;92
84;Auvergne-Rhône-Alpes;01;2;22;052;Bouligneux;332;6;338
84;Auvergne-Rhône-Alpes;01;2;99;053;Bourg-en-Bresse;41681;1682;43363
84;Auvergne-Rhône-Alpes;01;1;12;054;Bourg-Saint-Christophe;1482;35;1517
84;Auvergne-Rhône-Alpes;01;4;16;056;Boyeux-Saint-Jérôme;351;4;355
84;Auvergne-Rhône-Alpes;01;2;17;057;Boz;514;16;530
84;Auvergne-Rhône-Alpes;01;1;04;058;Brégnier-Cordon;819;19;838
84;Auvergne-Rhône-Alpes;01;4;10;060;Brénod;486;19;505
84;Auvergne-Rhône-Alpes;01;1;04;061;Brens;1133;33;1166
84;Auvergne-Rhône-Alpes;01;2;12;062;Bressolles;951;23;974
84;Auvergne-Rhône-Alpes;01;4;14;063;Brion;561;16;577
84;Auvergne-Rhône-Alpes;01;1;11;064;Briord;1095;19;1114
84;Auvergne-Rhône-Alpes;01;2;02;065;Buellas;1825;64;1889
84;Auvergne-Rhône-Alpes;01;1;04;066;La Burbanche;92;1;93
84;Auvergne-Rhône-Alpes;01;4;16;067;Ceignes;259;12;271
84;Auvergne-Rhône-Alpes;01;4;16;068;Cerdon;771;17;788
84;Auvergne-Rhône-Alpes;01;2;07;069;Certines;1514;39;1553
84;Auvergne-Rhône-Alpes;01;3;09;071;Cessy;5045;123;5168
84;Auvergne-Rhône-Alpes;01;2;07;072;Ceyzériat;3202;63;3265
84;Auvergne-Rhône-Alpes;01;1;04;073;Ceyzérieu;995;25;1020
84;Auvergne-Rhône-Alpes;01;2;07;074;Chalamont;2574;38;2612
84;Auvergne-Rhône-Alpes;01;2;22;075;Chaleins;1402;31;1433
84;Auvergne-Rhône-Alpes;01;1;10;076;Chaley;122;3;125
84;Auvergne-Rhône-Alpes;01;4;16;077;Challes-la-Montagne;192;2;194
84;Auvergne-Rhône-Alpes;01;3;20;078;Challex;1597;34;1631
84;Auvergne-Rhône-Alpes;01;1;10;079;Champagne-en-Valromey;822;30;852
84;Auvergne-Rhône-Alpes;01;1;10;080;Champdor-Corcelles;636;16;652
84;Auvergne-Rhône-Alpes;01;4;03;081;Champfromier;726;21;747
84;Auvergne-Rhône-Alpes;01;4;03;082;Chanay;637;15;652
84;Auvergne-Rhône-Alpes;01;2;22;083;Chaneins;965;17;982
84;Auvergne-Rhône-Alpes;01;2;23;084;Chanoz-Châtenay;921;19;940
84;Auvergne-Rhône-Alpes;01;2;08;085;La Chapelle-du-Châtelard;397;6;403
84;Auvergne-Rhône-Alpes;01;4;14;087;Charix;279;10;289
84;Auvergne-Rhône-Alpes;01;1;11;088;Charnoz-sur-Ain;902;28;930
84;Auvergne-Rhône-Alpes;01;1;01;089;Château-Gaillard;2254;49;2303
84;Auvergne-Rhône-Alpes;01;2;07;090;Châtenay;361;6;367
84;Auvergne-Rhône-Alpes;01;2;07;092;Châtillon-la-Palud;1622;60;1682
84;Auvergne-Rhône-Alpes;01;2;08;093;Châtillon-sur-Chalaronne;4968;203;5171
84;Auvergne-Rhône-Alpes;01;2;17;094;Chavannes-sur-Reyssouze;761;12;773
84;Auvergne-Rhône-Alpes;01;2;18;095;Nivigne et Suran;843;18;861
84;Auvergne-Rhône-Alpes;01;2;23;096;Chaveyriat;1033;30;1063
84;Auvergne-Rhône-Alpes;01;1;04;098;Chazey-Bons;1175;38;1213
84;Auvergne-Rhône-Alpes;01;1;11;099;Chazey-sur-Ain;1590;60;1650
84;Auvergne-Rhône-Alpes;01;1;04;100;Cheignieu-la-Balme;131;4;135
84;Auvergne-Rhône-Alpes;01;4;10;101;Chevillard;152;7;159
84;Auvergne-Rhône-Alpes;01;2;17;102;Chevroux;966;15;981
84;Auvergne-Rhône-Alpes;01;3;20;103;Chevry;2226;50;2276
84;Auvergne-Rhône-Alpes;01;3;20;104;Chézery-Forens;453;11;464
84;Auvergne-Rhône-Alpes;01;2;22;105;Civrieux;1867;52;1919
84;Auvergne-Rhône-Alpes;01;2;18;106;Cize;178;7;185
84;Auvergne-Rhône-Alpes;01;1;01;107;Cleyzieu;136;4;140
84;Auvergne-Rhône-Alpes;01;2;18;108;Coligny;1161;24;1185
84;Auvergne-Rhône-Alpes;01;3;20;109;Collonges;2230;46;2276
84;Auvergne-Rhône-Alpes;01;1;04;110;Colomieu;159;2;161
84;Auvergne-Rhône-Alpes;01;1;01;111;Conand;133;2;135
84;Auvergne-Rhône-Alpes;01;4;10;112;Condamine;467;6;473
84;Auvergne-Rhône-Alpes;01;2;08;113;Condeissiat;817;12;829
84;Auvergne-Rhône-Alpes;01;4;03;114;Confort;693;11;704
84;Auvergne-Rhône-Alpes;01;2;02;115;Confrançon;1339;31;1370
84;Auvergne-Rhône-Alpes;01;1;04;116;Contrevoz;496;14;510
84;Auvergne-Rhône-Alpes;01;1;04;117;Conzieu;150;1;151
84;Auvergne-Rhône-Alpes;01;1;10;118;Corbonod;1279;27;1306
84;Auvergne-Rhône-Alpes;01;1;10;121;Corlier;116;1;117
84;Auvergne-Rhône-Alpes;01;2;23;123;Cormoranche-sur-Saône;1159;36;1195
84;Auvergne-Rhône-Alpes;01;2;18;124;Cormoz;702;8;710
84;Auvergne-Rhône-Alpes;01;2;18;125;Corveissiat;604;13;617
84;Auvergne-Rhône-Alpes;01;2;18;127;Courmangoux;506;8;514
84;Auvergne-Rhône-Alpes;01;2;17;128;Courtes;301;1;302
84;Auvergne-Rhône-Alpes;01;2;07;129;Crans;303;5;308
84;Auvergne-Rhône-Alpes;01;2;02;130;Bresse Vallons;2368;38;2406
84;Auvergne-Rhône-Alpes;01;1;04;133;Cressin-Rochefort;395;5;400
84;Auvergne-Rhône-Alpes;01;2;23;134;Crottet;1792;44;1836
84;Auvergne-Rhône-Alpes;01;3;20;135;Crozet;2205;64;2269
84;Auvergne-Rhône-Alpes;01;2;23;136;Cruzilles-lès-Mépillat;922;21;943
84;Auvergne-Rhône-Alpes;01;1;10;138;Culoz;2987;61;3048
84;Auvergne-Rhône-Alpes;01;2;17;139;Curciat-Dongalon;444;5;449
84;Auvergne-Rhône-Alpes;01;2;02;140;Curtafond;764;19;783
84;Auvergne-Rhône-Alpes;01;1;04;141;Cuzieu;443;6;449
84;Auvergne-Rhône-Alpes;01;2;12;142;Dagneux;4765;54;4819
84;Auvergne-Rhône-Alpes;01;3;09;143;Divonne-les-Bains;9999;240;10239
84;Auvergne-Rhône-Alpes;01;2;07;145;Dompierre-sur-Veyle;1190;24;1214
84;Auvergne-Rhône-Alpes;01;2;08;146;Dompierre-sur-Chalaronne;436;3;439
84;Auvergne-Rhône-Alpes;01;2;18;147;Domsure;509;3;512
84;Auvergne-Rhône-Alpes;01;4;16;148;Dortan;1892;47;1939
84;Auvergne-Rhône-Alpes;01;1;01;149;Douvres;1094;29;1123
84;Auvergne-Rhône-Alpes;01;2;18;150;Drom;214;5;219
84;Auvergne-Rhône-Alpes;01;2;07;151;Druillat;1139;29;1168
84;Auvergne-Rhône-Alpes;01;4;14;152;Échallon;756;25;781
84;Auvergne-Rhône-Alpes;01;3;20;153;Échenevex;2123;75;2198
84;Auvergne-Rhône-Alpes;01;1;10;155;Évosges;142;5;147
84;Auvergne-Rhône-Alpes;01;1;12;156;Faramans;843;12;855
84;Auvergne-Rhône-Alpes;01;2;22;157;Fareins;2339;53;2392
84;Auvergne-Rhône-Alpes;01;3;20;158;Farges;1053;19;1072
84;Auvergne-Rhône-Alpes;01;2;17;159;Feillens;3366;72;3438
84;Auvergne-Rhône-Alpes;01;3;19;160;Ferney-Voltaire;10612;172;10784
84;Auvergne-Rhône-Alpes;01;1;04;162;Flaxieu;65;3;68
84;Auvergne-Rhône-Alpes;01;2;02;163;Foissiat;2016;34;2050
84;Auvergne-Rhône-Alpes;01;2;22;165;Francheleins;1586;33;1619
84;Auvergne-Rhône-Alpes;01;2;21;166;Frans;2417;36;2453
84;Auvergne-Rhône-Alpes;01;2;08;167;Garnerans;657;24;681
84;Auvergne-Rhône-Alpes;01;2;08;169;Genouilleux;651;23;674
84;Auvergne-Rhône-Alpes;01;4;14;170;Béard-Géovreissiat;1044;27;1071
84;Auvergne-Rhône-Alpes;01;4;14;171;Géovreisset;830;41;871
84;Auvergne-Rhône-Alpes;01;3;09;173;Gex;13177;290;13467
84;Auvergne-Rhône-Alpes;01;4;03;174;Giron;176;2;178
84;Auvergne-Rhône-Alpes;01;2;17;175;Gorrevod;790;23;813
84;Auvergne-Rhône-Alpes;01;2;18;177;Grand-Corent;184;5;189
84;Auvergne-Rhône-Alpes;01;2;23;179;Grièges;1884;52;1936
84;Auvergne-Rhône-Alpes;01;3;09;180;Grilly;842;20;862
84;Auvergne-Rhône-Alpes;01;4;14;181;Groissiat;1241;50;1291
84;Auvergne-Rhône-Alpes;01;2;08;183;Guéreins;1487;29;1516
84;Auvergne-Rhône-Alpes;01;2;18;184;Hautecourt-Romanèche;756;28;784
84;Auvergne-Rhône-Alpes;01;1;10;185;Plateau d'Hauteville;4824;157;4981
84;Auvergne-Rhône-Alpes;01;1;10;187;Haut Valromey;615;19;634
84;Auvergne-Rhône-Alpes;01;2;08;188;Illiat;681;21;702
84;Auvergne-Rhône-Alpes;01;4;03;189;Injoux-Génissiat;1123;27;1150
84;Auvergne-Rhône-Alpes;01;1;11;190;Innimond;86;1;87
84;Auvergne-Rhône-Alpes;01;4;10;191;Izenave;152;4;156
84;Auvergne-Rhône-Alpes;01;4;16;192;Izernore;2272;55;2327
84;Auvergne-Rhône-Alpes;01;1;04;193;Izieu;220;6;226
84;Auvergne-Rhône-Alpes;01;2;21;194;Jassans-Riottier;6337;93;6430
84;Auvergne-Rhône-Alpes;01;2;18;195;Jasseron;1822;39;1861
84;Auvergne-Rhône-Alpes;01;2;02;196;Jayat;1241;20;1261
84;Auvergne-Rhône-Alpes;01;2;07;197;Journans;377;14;391
84;Auvergne-Rhône-Alpes;01;1;12;198;Joyeux;266;3;269
84;Auvergne-Rhône-Alpes;01;4;16;199;Jujurieux;2129;44;2173
84;Auvergne-Rhône-Alpes;01;4;16;200;Labalme;213;5;218
84;Auvergne-Rhône-Alpes;01;1;11;202;Lagnieu;7214;126;7340
84;Auvergne-Rhône-Alpes;01;2;23;203;Laiz;1306;30;1336
84;Auvergne-Rhône-Alpes;01;4;14;204;Le Poizat-Lalleyriat;746;16;762
84;Auvergne-Rhône-Alpes;01;4;10;206;Lantenay;274;6;280
84;Auvergne-Rhône-Alpes;01;2;22;207;Lapeyrouse;314;12;326
84;Auvergne-Rhône-Alpes;01;1;04;208;Lavours;135;1;136
84;Auvergne-Rhône-Alpes;01;3;20;209;Léaz;796;16;812
84;Auvergne-Rhône-Alpes;01;3;20;210;Lélex;231;4;235
84;Auvergne-Rhône-Alpes;01;2;07;211;Lent;1397;39;1436
84;Auvergne-Rhône-Alpes;01;2;17;212;Lescheroux;712;8;720
84;Auvergne-Rhône-Alpes;01;1;11;213;Leyment;1332;29;1361
84;Auvergne-Rhône-Alpes;01;4;16;214;Leyssard;161;5;166
84;Auvergne-Rhône-Alpes;01;4;03;215;Surjoux-Lhopital;143;2;145
84;Auvergne-Rhône-Alpes;01;1;11;216;Lhuis;893;21;914
84;Auvergne-Rhône-Alpes;01;1;11;219;Lompnas;162;4;166
84;Auvergne-Rhône-Alpes;01;1;11;224;Loyettes;3296;28;3324
84;Auvergne-Rhône-Alpes;01;2;22;225;Lurcy;383;15;398
84;Auvergne-Rhône-Alpes;01;1;04;227;Magnieu;642;12;654
84;Auvergne-Rhône-Alpes;01;4;14;228;Maillat;668;14;682
84;Auvergne-Rhône-Alpes;01;2;02;229;Malafretaz;1226;22;1248
84;Auvergne-Rhône-Alpes;01;2;17;230;Mantenay-Montlin;310;7;317
84;Auvergne-Rhône-Alpes;01;2;17;231;Manziat;1948;49;1997
84;Auvergne-Rhône-Alpes;01;2;18;232;Marboz;2275;44;2319
84;Auvergne-Rhône-Alpes;01;1;11;233;Marchamp;130;2;132
84;Auvergne-Rhône-Alpes;01;1;04;234;Marignieu;167;3;170
84;Auvergne-Rhône-Alpes;01;2;08;235;Marlieux;1179;87;1266
84;Auvergne-Rhône-Alpes;01;2;02;236;Marsonnas;1021;29;1050
84;Auvergne-Rhône-Alpes;01;4;14;237;Martignat;1674;66;1740
84;Auvergne-Rhône-Alpes;01;2;21;238;Massieux;2709;58;2767
84;Auvergne-Rhône-Alpes;01;1;04;239;Massignieu-de-Rives;631;9;640
84;Auvergne-Rhône-Alpes;01;4;16;240;Matafelon-Granges;628;18;646
84;Auvergne-Rhône-Alpes;01;2;18;241;Meillonnas;1379;35;1414
84;Auvergne-Rhône-Alpes;01;4;16;242;Mérignat;136;2;138
84;Auvergne-Rhône-Alpes;01;2;22;243;Messimy-sur-Saône;1262;37;1299
84;Auvergne-Rhône-Alpes;01;1;12;244;Meximieux;7998;143;8141
84;Auvergne-Rhône-Alpes;01;2;18;245;Bohas-Meyriat-Rignat;950;21;971
84;Auvergne-Rhône-Alpes;01;2;23;246;Mézériat;2204;40;2244
84;Auvergne-Rhône-Alpes;01;3;20;247;Mijoux;299;13;312
84;Auvergne-Rhône-Alpes;01;2;22;248;Mionnay;2245;54;2299
84;Auvergne-Rhône-Alpes;01;2;13;249;Miribel;10202;153;10355
84;Auvergne-Rhône-Alpes;01;2;21;250;Misérieux;1979;270;2249
84;Auvergne-Rhône-Alpes;01;2;08;252;Mogneneins;796;23;819
84;Auvergne-Rhône-Alpes;01;2;07;254;Montagnat;2142;51;2193
84;Auvergne-Rhône-Alpes;01;1;11;255;Montagnieu;651;11;662
84;Auvergne-Rhône-Alpes;01;4;03;257;Montanges;351;10;361
84;Auvergne-Rhône-Alpes;01;2;08;258;Montceaux;1194;22;1216
84;Auvergne-Rhône-Alpes;01;2;02;259;Montcet;708;16;724
84;Auvergne-Rhône-Alpes;01;1;12;260;Le Montellier;304;5;309
84;Auvergne-Rhône-Alpes;01;2;22;261;Monthieux;681;24;705
84;Auvergne-Rhône-Alpes;01;2;12;262;Montluel;6864;80;6944
84;Auvergne-Rhône-Alpes;01;2;08;263;Montmerle-sur-Saône;3761;88;3849
84;Auvergne-Rhône-Alpes;01;2;02;264;Montracol;1017;19;1036
84;Auvergne-Rhône-Alpes;01;4;14;265;Montréal-la-Cluse;3499;81;3580
84;Auvergne-Rhône-Alpes;01;2;02;266;Montrevel-en-Bresse;2576;43;2619
84;Auvergne-Rhône-Alpes;01;4;16;267;Nurieux-Volognat;1008;27;1035
84;Auvergne-Rhône-Alpes;01;1;04;268;Murs-et-Gélignieux;244;3;247
84;Auvergne-Rhône-Alpes;01;4;14;269;Nantua;3453;134;3587
84;Auvergne-Rhône-Alpes;01;2;08;272;Neuville-les-Dames;1490;21;1511
84;Auvergne-Rhône-Alpes;01;4;16;273;Neuville-sur-Ain;1799;25;1824
84;Auvergne-Rhône-Alpes;01;4;14;274;Les Neyrolles;632;13;645
84;Auvergne-Rhône-Alpes;01;2;13;275;Neyron;2596;52;2648
84;Auvergne-Rhône-Alpes;01;2;13;276;Niévroz;1627;25;1652
84;Auvergne-Rhône-Alpes;01;1;01;277;Nivollet-Montgriffon;115;1;116
84;Auvergne-Rhône-Alpes;01;1;01;279;Oncieu;77;5;82
84;Auvergne-Rhône-Alpes;01;1;11;280;Ordonnaz;136;0;136
84;Auvergne-Rhône-Alpes;01;3;19;281;Ornex;4591;175;4766
84;Auvergne-Rhône-Alpes;01;4;10;282;Outriaz;258;7;265
84;Auvergne-Rhône-Alpes;01;4;15;283;Oyonnax;22271;453;22724
84;Auvergne-Rhône-Alpes;01;2;17;284;Ozan;700;13;713
84;Auvergne-Rhône-Alpes;01;2;21;285;Parcieux;1334;32;1366
84;Auvergne-Rhône-Alpes;01;1;04;286;Parves et Nattages;959;37;996
84;Auvergne-Rhône-Alpes;01;3;20;288;Péron;2777;59;2836
84;Auvergne-Rhône-Alpes;01;2;06;289;Péronnas;6460;275;6735
84;Auvergne-Rhône-Alpes;01;1;12;290;Pérouges;1309;31;1340
84;Auvergne-Rhône-Alpes;01;2;23;291;Perrex;844;8;852
84;Auvergne-Rhône-Alpes;01;4;16;293;Peyriat;145;3;148
84;Auvergne-Rhône-Alpes;01;1;04;294;Peyrieu;897;18;915
84;Auvergne-Rhône-Alpes;01;2;08;295;Peyzieux-sur-Saône;676;10;686
84;Auvergne-Rhône-Alpes;01;2;18;296;Pirajoux;413;11;424
84;Auvergne-Rhône-Alpes;01;2;12;297;Pizay;890;16;906
84;Auvergne-Rhône-Alpes;01;4;03;298;Plagne;157;2;159
84;Auvergne-Rhône-Alpes;01;2;07;299;Le Plantay;589;10;599
84;Auvergne-Rhône-Alpes;01;2;02;301;Polliat;2606;61;2667
84;Auvergne-Rhône-Alpes;01;1;04;302;Pollieu;165;4;169
84;Auvergne-Rhône-Alpes;01;4;16;303;Poncin;1696;39;1735
84;Auvergne-Rhône-Alpes;01;4;16;304;Pont-d'Ain;2904;53;2957
84;Auvergne-Rhône-Alpes;01;2;17;305;Pont-de-Vaux;2195;43;2238
84;Auvergne-Rhône-Alpes;01;2;23;306;Pont-de-Veyle;1637;64;1701
84;Auvergne-Rhône-Alpes;01;4;14;307;Port;840;21;861
84;Auvergne-Rhône-Alpes;01;3;20;308;Pougny;803;14;817
84;Auvergne-Rhône-Alpes;01;2;18;309;Pouillat;83;0;83
84;Auvergne-Rhône-Alpes;01;1;04;310;Prémeyzel;249;4;253
84;Auvergne-Rhône-Alpes;01;1;10;311;Prémillieu;44;0;44
84;Auvergne-Rhône-Alpes;01;3;19;313;Prévessin-Moëns;8948;245;9193
84;Auvergne-Rhône-Alpes;01;4;16;314;Priay;1725;31;1756
84;Auvergne-Rhône-Alpes;01;2;18;317;Ramasse;331;6;337
84;Auvergne-Rhône-Alpes;01;2;22;318;Rancé;735;18;753
84;Auvergne-Rhône-Alpes;01;2;22;319;Relevant;467;9;476
84;Auvergne-Rhône-Alpes;01;2;17;320;Replonges;3833;92;3925
84;Auvergne-Rhône-Alpes;01;2;07;321;Revonnas;892;29;921
84;Auvergne-Rhône-Alpes;01;2;21;322;Reyrieux;5050;142;5192
84;Auvergne-Rhône-Alpes;01;2;17;323;Reyssouze;1018;17;1035
84;Auvergne-Rhône-Alpes;01;1;12;325;Rignieux-le-Franc;1065;19;1084
84;Auvergne-Rhône-Alpes;01;2;08;328;Romans;606;4;610
84;Auvergne-Rhône-Alpes;01;1;04;329;Rossillon;157;2;159
84;Auvergne-Rhône-Alpes;01;1;10;330;Ruffieu;180;7;187
84;Auvergne-Rhône-Alpes;01;4;16;331;Saint-Alban;192;1;193
84;Auvergne-Rhône-Alpes;01;2;17;332;Saint-André-de-Bâgé;792;23;815
84;Auvergne-Rhône-Alpes;01;2;22;333;Saint-André-de-Corcy;3366;59;3425
84;Auvergne-Rhône-Alpes;01;2;23;334;Saint-André-d'Huiriat;680;9;689
84;Auvergne-Rhône-Alpes;01;2;08;335;Saint-André-le-Bouchoux;410;6;416
84;Auvergne-Rhône-Alpes;01;2;07;336;Saint-André-sur-Vieux-Jonc;1187;22;1209
84;Auvergne-Rhône-Alpes;01;2;17;337;Saint-Bénigne;1336;27;1363
84;Auvergne-Rhône-Alpes;01;1;04;338;Groslée-Saint-Benoit;1245;34;1279
84;Auvergne-Rhône-Alpes;01;2;21;339;Saint-Bernard;1484;44;1528
84;Auvergne-Rhône-Alpes;01;2;12;342;Sainte-Croix;546;10;556
84;Auvergne-Rhône-Alpes;01;2;23;343;Saint-Cyr-sur-Menthon;1822;41;1863
84;Auvergne-Rhône-Alpes;01;2;06;344;Saint-Denis-lès-Bourg;5971;166;6137
84;Auvergne-Rhône-Alpes;01;1;01;345;Saint-Denis-en-Bugey;2245;33;2278
84;Auvergne-Rhône-Alpes;01;2;02;346;Saint-Didier-d'Aussiat;852;19;871
84;Auvergne-Rhône-Alpes;01;2;21;347;Saint-Didier-de-Formans;2072;64;2136
84;Auvergne-Rhône-Alpes;01;2;08;348;Saint-Didier-sur-Chalaronne;3003;66;3069
84;Auvergne-Rhône-Alpes;01;1;12;349;Saint-Éloi;523;6;529
84;Auvergne-Rhône-Alpes;01;2;18;350;Saint-Étienne-du-Bois;2538;37;2575
84;Auvergne-Rhône-Alpes;01;2;08;351;Saint-Étienne-sur-Chalaronne;1602;27;1629
84;Auvergne-Rhône-Alpes;01;2;17;352;Saint-Étienne-sur-Reyssouze;586;5;591
84;Auvergne-Rhône-Alpes;01;2;21;353;Sainte-Euphémie;1723;29;1752
84;Auvergne-Rhône-Alpes;01;3;19;354;Saint-Genis-Pouilly;14274;189;14463
84;Auvergne-Rhône-Alpes;01;2;23;355;Saint-Genis-sur-Menthon;484;7;491
84;Auvergne-Rhône-Alpes;01;2;08;356;Saint-Georges-sur-Renon;203;5;208
84;Auvergne-Rhône-Alpes;01;4;03;357;Saint-Germain-de-Joux;502;7;509
84;Auvergne-Rhône-Alpes;01;1;04;358;Saint-Germain-les-Paroisses;426;8;434
84;Auvergne-Rhône-Alpes;01;2;08;359;Saint-Germain-sur-Renon;251;2;253
84;Auvergne-Rhône-Alpes;01;3;20;360;Saint-Jean-de-Gonville;1934;48;1982
84;Auvergne-Rhône-Alpes;01;1;11;361;Saint-Jean-de-Niost;1600;46;1646
84;Auvergne-Rhône-Alpes;01;2;22;362;Saint-Jean-de-Thurigneux;809;12;821
84;Auvergne-Rhône-Alpes;01;4;16;363;Saint-Jean-le-Vieux;1786;73;1859
84;Auvergne-Rhône-Alpes;01;2;17;364;Saint-Jean-sur-Reyssouze;767;8;775
84;Auvergne-Rhône-Alpes;01;2;23;365;Saint-Jean-sur-Veyle;1165;28;1193
84;Auvergne-Rhône-Alpes;01;1;11;366;Sainte-Julie;1088;17;1105
84;Auvergne-Rhône-Alpes;01;2;17;367;Saint-Julien-sur-Reyssouze;726;7;733
84;Auvergne-Rhône-Alpes;01;2;23;368;Saint-Julien-sur-Veyle;842;15;857
84;Auvergne-Rhône-Alpes;01;2;07;369;Saint-Just;955;25;980
84;Auvergne-Rhône-Alpes;01;2;23;370;Saint-Laurent-sur-Saône;1674;28;1702
84;Auvergne-Rhône-Alpes;01;2;22;371;Saint-Marcel;1221;27;1248
84;Auvergne-Rhône-Alpes;01;1;04;372;Saint-Martin-de-Bavel;441;13;454
84;Auvergne-Rhône-Alpes;01;4;14;373;Saint-Martin-du-Frêne;1009;29;1038
84;Auvergne-Rhône-Alpes;01;2;07;374;Saint-Martin-du-Mont;1877;45;1922
84;Auvergne-Rhône-Alpes;01;2;02;375;Saint-Martin-le-Châtel;788;19;807
84;Auvergne-Rhône-Alpes;01;2;13;376;Saint-Maurice-de-Beynost;4066;41;4107
84;Auvergne-Rhône-Alpes;01;1;11;378;Saint-Maurice-de-Gourdans;2699;56;2755
84;Auvergne-Rhône-Alpes;01;1;01;379;Saint-Maurice-de-Rémens;762;12;774
84;Auvergne-Rhône-Alpes;01;2;17;380;Saint-Nizier-le-Bouchoux;612;13;625
84;Auvergne-Rhône-Alpes;01;2;07;381;Saint-Nizier-le-Désert;920;18;938
84;Auvergne-Rhône-Alpes;01;2;22;382;Sainte-Olive;305;4;309
84;Auvergne-Rhône-Alpes;01;2;08;383;Saint-Paul-de-Varax;1583;21;1604
84;Auvergne-Rhône-Alpes;01;1;01;384;Saint-Rambert-en-Bugey;2172;29;2201
84;Auvergne-Rhône-Alpes;01;2;06;385;Saint-Rémy;964;19;983
84;Auvergne-Rhône-Alpes;01;1;11;386;Saint-Sorlin-en-Bugey;1117;60;1177
84;Auvergne-Rhône-Alpes;01;2;02;387;Saint-Sulpice;256;3;259
84;Auvergne-Rhône-Alpes;01;2;17;388;Saint-Trivier-de-Courtes;1116;8;1124
84;Auvergne-Rhône-Alpes;01;2;22;389;Saint-Trivier-sur-Moignans;1823;43;1866
84;Auvergne-Rhône-Alpes;01;1;11;390;Saint-Vulbas;1247;21;1268
84;Auvergne-Rhône-Alpes;01;2;18;391;Salavre;273;8;281
84;Auvergne-Rhône-Alpes;01;4;16;392;Samognat;654;28;682
84;Auvergne-Rhône-Alpes;01;2;08;393;Sandrans;555;13;568
84;Auvergne-Rhône-Alpes;01;1;11;396;Sault-Brénaz;987;14;1001
84;Auvergne-Rhône-Alpes;01;3;09;397;Sauverny;988;19;1007
84;Auvergne-Rhône-Alpes;01;2;22;398;Savigneux;1438;19;1457
84;Auvergne-Rhône-Alpes;01;3;20;399;Ségny;2145;53;2198
84;Auvergne-Rhône-Alpes;01;1;11;400;Seillonnaz;139;3;142
84;Auvergne-Rhône-Alpes;01;3;20;401;Sergy;2209;73;2282
84;Auvergne-Rhône-Alpes;01;2;17;402;Sermoyer;650;20;670
84;Auvergne-Rhône-Alpes;01;1;11;403;Serrières-de-Briord;1310;40;1350
84;Auvergne-Rhône-Alpes;01;4;16;404;Serrières-sur-Ain;134;2;136
84;Auvergne-Rhône-Alpes;01;2;07;405;Servas;1273;28;1301
84;Auvergne-Rhône-Alpes;01;2;17;406;Servignat;173;1;174
84;Auvergne-Rhône-Alpes;01;1;10;407;Seyssel;1006;17;1023
84;Auvergne-Rhône-Alpes;01;2;18;408;Simandre-sur-Suran;659;11;670
84;Auvergne-Rhône-Alpes;01;4;16;410;Sonthonnax-la-Montagne;299;7;306
84;Auvergne-Rhône-Alpes;01;1;11;411;Souclin;271;8;279
84;Auvergne-Rhône-Alpes;01;2;08;412;Sulignat;611;12;623
84;Auvergne-Rhône-Alpes;01;1;10;415;Talissieu;524;7;531
84;Auvergne-Rhône-Alpes;01;1;10;416;Tenay;1012;12;1024
84;Auvergne-Rhône-Alpes;01;2;13;418;Thil;1103;27;1130
84;Auvergne-Rhône-Alpes;01;3;20;419;Thoiry;6119;180;6299
84;Auvergne-Rhône-Alpes;01;2;08;420;Thoissey;1664;8;1672
84;Auvergne-Rhône-Alpes;01;1;01;421;Torcieu;734;15;749
84;Auvergne-Rhône-Alpes;01;2;07;422;Tossiat;1354;36;1390
84;Auvergne-Rhône-Alpes;01;2;21;423;Toussieux;1169;22;1191
84;Auvergne-Rhône-Alpes;01;2;13;424;Tramoyes;1823;44;1867
84;Auvergne-Rhône-Alpes;01;2;07;425;La Tranclière;284;7;291
84;Auvergne-Rhône-Alpes;01;2;18;426;Val-Revermont;2506;55;2561
84;Auvergne-Rhône-Alpes;01;2;21;427;Trévoux;6945;163;7108
84;Auvergne-Rhône-Alpes;01;2;08;428;Valeins;128;0;128
84;Auvergne-Rhône-Alpes;01;2;02;429;Vandeins;714;15;729
84;Auvergne-Rhône-Alpes;01;4;16;430;Varambon;636;12;648
84;Auvergne-Rhône-Alpes;01;1;01;431;Vaux-en-Bugey;1224;29;1253
84;Auvergne-Rhône-Alpes;01;2;18;432;Verjon;333;3;336
84;Auvergne-Rhône-Alpes;01;2;17;433;Vernoux;306;4;310
84;Auvergne-Rhône-Alpes;01;2;07;434;Versailleux;488;10;498
84;Auvergne-Rhône-Alpes;01;3;09;435;Versonnex;2146;69;2215
84;Auvergne-Rhône-Alpes;01;3;09;436;Vesancy;492;9;501
84;Auvergne-Rhône-Alpes;01;2;17;437;Vescours;221;5;226
84;Auvergne-Rhône-Alpes;01;2;17;439;Vésines;99;4;103
84;Auvergne-Rhône-Alpes;01;4;10;441;Vieu-d'Izenave;743;18;761
84;Auvergne-Rhône-Alpes;01;2;22;443;Villars-les-Dombes;4946;94;5040
84;Auvergne-Rhône-Alpes;01;1;11;444;Villebois;1195;18;1213
84;Auvergne-Rhône-Alpes;01;2;18;445;Villemotier;628;22;650
84;Auvergne-Rhône-Alpes;01;2;22;446;Villeneuve;1562;37;1599
84;Auvergne-Rhône-Alpes;01;2;18;447;Villereversure;1345;31;1376
84;Auvergne-Rhône-Alpes;01;4;03;448;Villes;394;7;401
84;Auvergne-Rhône-Alpes;01;2;07;449;Villette-sur-Ain;760;15;775
84;Auvergne-Rhône-Alpes;01;1;11;450;Villieu-Loyes-Mollon;3755;72;3827
84;Auvergne-Rhône-Alpes;01;2;05;451;Viriat;6665;152;6817
84;Auvergne-Rhône-Alpes;01;1;04;452;Virieu-le-Grand;1127;24;1151
84;Auvergne-Rhône-Alpes;01;1;10;453;Arvière-en-Valromey;712;17;729
84;Auvergne-Rhône-Alpes;01;1;04;454;Virignin;1118;21;1139
84;Auvergne-Rhône-Alpes;01;1;04;456;Vongnes;71;2;73
84;Auvergne-Rhône-Alpes;01;2;23;457;Vonnas;3198;42;3240
32;Hauts-de-France;02;2;03;001;Abbécourt;505;11;516
32;Hauts-de-France;02;2;18;002;Achery;602;13;615
32;Hauts-de-France;02;4;17;003;Acy;1019;26;1045
32;Hauts-de-France;02;2;11;004;Agnicourt-et-Séchelles;185;5;190
32;Hauts-de-France;02;2;06;005;Aguilcourt;382;9;391
32;Hauts-de-France;02;5;07;006;Aisonville-et-Bernoville;260;9;269
32;Hauts-de-France;02;2;06;007;Aizelles;120;3;123
32;Hauts-de-France;02;4;05;008;Aizy-Jouy;299;4;303
32;Hauts-de-France;02;3;12;009;Alaincourt;531;6;537
32;Hauts-de-France;02;4;05;010;Allemant;171;4;175
32;Hauts-de-France;02;4;20;011;Ambleny;1159;55;1214
32;Hauts-de-France;02;4;21;012;Ambrief;73;0;73
32;Hauts-de-France;02;2;06;013;Amifontaine;390;9;399
32;Hauts-de-France;02;2;03;014;Amigny-Rouy;721;22;743
32;Hauts-de-France;02;4;21;015;Ancienville;74;1;75
32;Hauts-de-France;02;2;18;016;Andelain;215;8;223
32;Hauts-de-France;02;2;18;017;Anguilcourt-le-Sart;308;2;310
32;Hauts-de-France;02;2;09;018;Anizy-le-Grand;2587;54;2641
32;Hauts-de-France;02;3;12;019;Annois;359;5;364
32;Hauts-de-France;02;5;08;020;Any-Martin-Rieux;455;8;463
32;Hauts-de-France;02;5;19;021;Archon;82;1;83
32;Hauts-de-France;02;4;21;022;Arcy-Sainte-Restitue;401;6;407
32;Hauts-de-France;02;1;21;023;Armentières-sur-Ourcq;101;3;104
32;Hauts-de-France;02;2;10;024;Arrancy;49;0;49
32;Hauts-de-France;02;3;12;025;Artemps;367;2;369
32;Hauts-de-France;02;2;11;027;Assis-sur-Serre;210;8;218
32;Hauts-de-France;02;2;10;028;Athies-sous-Laon;2597;59;2656
32;Hauts-de-France;02;3;13;029;Attilly;351;12;363
32;Hauts-de-France;02;3;01;030;Aubencheul-aux-Bois;254;4;258
32;Hauts-de-France;02;5;08;031;Aubenton;659;8;667
32;Hauts-de-France;02;3;12;032;Aubigny-aux-Kaisnes;254;4;258
32;Hauts-de-France;02;2;06;033;Aubigny-en-Laonnois;102;2;104
32;Hauts-de-France;02;4;20;034;Audignicourt;122;3;125
32;Hauts-de-France;02;5;07;035;Audigny;283;9;292
32;Hauts-de-France;02;4;05;036;Augy;70;1;71
32;Hauts-de-France;02;2;09;037;Aulnois-sous-Laon;1380;30;1410
32;Hauts-de-France;02;5;19;038;Les Autels;60;1;61
32;Hauts-de-France;02;2;11;039;Autremencourt;174;3;177
32;Hauts-de-France;02;5;19;040;Autreppes;176;3;179
32;Hauts-de-France;02;2;03;041;Autreville;815;15;830
32;Hauts-de-France;02;1;04;042;Azy-sur-Marne;379;6;385
32;Hauts-de-France;02;4;16;043;Bagneux;64;1;65
32;Hauts-de-France;02;5;19;044;Bancigny;24;0;24
32;Hauts-de-France;02;2;11;046;Barenton-Bugny;557;10;567
32;Hauts-de-France;02;2;11;047;Barenton-Cel;108;1;109
32;Hauts-de-France;02;2;11;048;Barenton-sur-Serre;131;1;132
32;Hauts-de-France;02;2;20;049;Barisis-aux-Bois;740;13;753
32;Hauts-de-France;02;5;07;050;Barzy-en-Thiérache;320;2;322
32;Hauts-de-France;02;1;04;051;Barzy-sur-Marne;391;6;397
32;Hauts-de-France;02;2;09;052;Bassoles-Aulers;132;7;139
32;Hauts-de-France;02;1;04;053;Vallées en Champagne;573;6;579
32;Hauts-de-France;02;4;05;054;Bazoches-et-Saint-Thibaut;532;15;547
32;Hauts-de-France;02;5;08;055;Beaumé;87;2;89
32;Hauts-de-France;02;2;03;056;Beaumont-en-Beine;180;1;181
32;Hauts-de-France;02;3;01;057;Beaurevoir;1411;18;1429
32;Hauts-de-France;02;2;06;058;Beaurieux;851;11;862
32;Hauts-de-France;02;2;18;059;Beautor;2718;28;2746
32;Hauts-de-France;02;3;13;060;Beauvois-en-Vermandois;255;7;262
32;Hauts-de-France;02;3;01;061;Becquigny;245;7;252
32;Hauts-de-France;02;1;02;062;Belleau;136;2;138
32;Hauts-de-France;02;3;01;063;Bellenglise;379;8;387
32;Hauts-de-France;02;4;17;064;Belleu;3762;67;3829
32;Hauts-de-France;02;3;01;065;Bellicourt;587;11;598
32;Hauts-de-France;02;3;12;066;Benay;193;2;195
32;Hauts-de-France;02;5;07;067;Bergues-sur-Sambre;209;5;214
32;Hauts-de-France;02;5;11;068;Berlancourt;85;5;90
32;Hauts-de-France;02;5;19;069;Berlise;105;2;107
32;Hauts-de-France;02;5;07;070;Bernot;441;12;453
32;Hauts-de-France;02;4;20;071;Berny-Rivière;650;11;661
32;Hauts-de-France;02;2;06;072;Berrieux;183;3;186
32;Hauts-de-France;02;2;06;073;Berry-au-Bac;687;4;691
32;Hauts-de-France;02;2;18;074;Bertaucourt-Epourdon;592;11;603
32;Hauts-de-France;02;3;12;075;Berthenicourt;194;2;196
32;Hauts-de-France;02;2;06;076;Bertricourt;153;3;156
32;Hauts-de-France;02;4;17;077;Berzy-le-Sec;380;9;389
32;Hauts-de-France;02;2;20;078;Besmé;164;3;167
32;Hauts-de-France;02;5;08;079;Besmont;147;0;147
32;Hauts-de-France;02;2;09;080;Besny-et-Loizy;327;9;336
32;Hauts-de-France;02;2;03;081;Béthancourt-en-Vaux;432;8;440
32;Hauts-de-France;02;4;21;082;Beugneux;110;0;110
32;Hauts-de-France;02;1;05;083;Beuvardes;751;15;766
32;Hauts-de-France;02;1;04;084;Bézu-le-Guéry;255;5;260
32;Hauts-de-France;02;1;02;085;Bézu-Saint-Germain;1003;25;1028
32;Hauts-de-France;02;2;20;086;Bichancourt;999;12;1011
32;Hauts-de-France;02;4;20;087;Bieuxy;34;1;35
32;Hauts-de-France;02;2;10;088;Bièvres;88;5;93
32;Hauts-de-France;02;4;17;089;Billy-sur-Aisne;1146;21;1167
32;Hauts-de-France;02;4;21;090;Billy-sur-Ourcq;203;4;207
32;Hauts-de-France;02;4;05;091;Blanzy-lès-Fismes;94;1;95
32;Hauts-de-France;02;2;20;093;Blérancourt;1306;60;1366
32;Hauts-de-France;02;1;02;094;Blesmes;469;10;479
32;Hauts-de-France;02;3;01;095;Bohain-en-Vermandois;5703;75;5778
32;Hauts-de-France;02;2;11;096;Bois-lès-Pargny;194;2;196
32;Hauts-de-France;02;2;06;097;Boncourt;261;2;263
32;Hauts-de-France;02;1;04;098;Bonneil;378;14;392
32;Hauts-de-France;02;1;21;099;Bonnesvalyn;216;5;221
32;Hauts-de-France;02;3;01;100;Bony;138;0;138
32;Hauts-de-France;02;2;11;101;Bosmont-sur-Serre;186;3;189
32;Hauts-de-France;02;2;06;102;Bouconville-Vauclair;188;3;191
32;Hauts-de-France;02;5;07;103;Boué;1331;6;1337
32;Hauts-de-France;02;2;06;104;Bouffignereux;98;4;102
32;Hauts-de-France;02;1;02;105;Bouresches;193;2;195
32;Hauts-de-France;02;2;06;106;Bourg-et-Comin;810;9;819
32;Hauts-de-France;02;2;20;107;Bourguignon-sous-Coucy;105;4;109
32;Hauts-de-France;02;2;09;108;Bourguignon-sous-Montbavin;158;4;162
32;Hauts-de-France;02;5;19;109;La Bouteille;473;11;484
32;Hauts-de-France;02;4;05;110;Braine;2232;26;2258
32;Hauts-de-France;02;2;09;111;Brancourt-en-Laonnois;726;13;739
32;Hauts-de-France;02;3;01;112;Brancourt-le-Grand;554;12;566
32;Hauts-de-France;02;1;02;114;Brasles;1558;35;1593
32;Hauts-de-France;02;2;06;115;Braye-en-Laonnois;186;6;192
32;Hauts-de-France;02;5;19;116;Braye-en-Thiérache;142;1;143
32;Hauts-de-France;02;3;12;117;Bray-Saint-Christophe;67;0;67
32;Hauts-de-France;02;4;05;118;Braye;129;3;132
32;Hauts-de-France;02;1;02;119;Brécy;321;6;327
32;Hauts-de-France;02;4;05;120;Brenelle;196;6;202
32;Hauts-de-France;02;4;21;121;Breny;237;4;241
32;Hauts-de-France;02;2;18;122;Brie;55;1;56
32;Hauts-de-France;02;3;12;123;Brissay-Choigny;299;5;304
32;Hauts-de-France;02;3;12;124;Brissy-Hamégicourt;651;10;661
32;Hauts-de-France;02;1;21;125;Brumetz;183;10;193
32;Hauts-de-France;02;5;19;126;Brunehamel;448;5;453
32;Hauts-de-France;02;1;05;127;Bruyères-sur-Fère;191;5;196
32;Hauts-de-France;02;2;10;128;Bruyères-et-Montbérault;1447;46;1493
32;Hauts-de-France;02;4;05;129;Bruys;19;0;19
32;Hauts-de-France;02;5;08;130;Bucilly;198;9;207
32;Hauts-de-France;02;4;05;131;Bucy-le-Long;1883;41;1924
32;Hauts-de-France;02;2;09;132;Bucy-lès-Cerny;192;3;195
32;Hauts-de-France;02;2;06;133;Bucy-lès-Pierrepont;403;9;412
32;Hauts-de-France;02;5;08;134;Buire;854;19;873
32;Hauts-de-France;02;5;19;135;Buironfosse;1148;16;1164
32;Hauts-de-France;02;5;19;136;Burelles;128;3;131
32;Hauts-de-France;02;1;21;137;Bussiares;151;6;157
32;Hauts-de-France;02;4;21;138;Buzancy;200;3;203
32;Hauts-de-France;02;2;03;139;Caillouël-Crépigny;447;8;455
32;Hauts-de-France;02;2;20;140;Camelin;457;9;466
32;Hauts-de-France;02;5;19;141;La Capelle;1772;80;1852
32;Hauts-de-France;02;3;15;142;Castres;251;4;255
32;Hauts-de-France;02;3;01;143;Le Catelet;184;7;191
32;Hauts-de-France;02;3;13;144;Caulaincourt;140;3;143
32;Hauts-de-France;02;2;03;145;Caumont;545;10;555
32;Hauts-de-France;02;1;04;146;Celles-lès-Condé;96;1;97
32;Hauts-de-France;02;4;05;148;Celles-sur-Aisne;256;2;258
32;Hauts-de-France;02;3;12;149;Cerizy;60;2;62
32;Hauts-de-France;02;2;10;150;Cerny-en-Laonnois;62;0;62
32;Hauts-de-France;02;2;09;151;Cerny-lès-Bucy;116;3;119
32;Hauts-de-France;02;4;05;152;Cerseuil;87;1;88
32;Hauts-de-France;02;2;09;153;Cessières-Suzy;775;21;796
32;Hauts-de-France;02;4;21;154;Chacrise;365;7;372
32;Hauts-de-France;02;2;09;155;Chaillevois;177;1;178
32;Hauts-de-France;02;2;11;156;Chalandry;258;1;259
32;Hauts-de-France;02;2;09;157;Chambry;834;23;857
32;Hauts-de-France;02;2;10;158;Chamouille;271;2;273
32;Hauts-de-France;02;2;20;159;Champs;302;2;304
32;Hauts-de-France;02;5;19;160;Chaourse;527;18;545
32;Hauts-de-France;02;1;04;162;La Chapelle-sur-Chézy;298;8;306
32;Hauts-de-France;02;1;04;163;Charly-sur-Marne;2585;41;2626
32;Hauts-de-France;02;1;05;164;Le Charmel;327;7;334
32;Hauts-de-France;02;2;18;165;Charmes;1655;29;1684
32;Hauts-de-France;02;1;04;166;Chartèves;359;9;368
32;Hauts-de-France;02;4;05;167;Chassemy;888;14;902
32;Hauts-de-France;02;1;02;168;Château-Thierry;15306;312;15618
32;Hauts-de-France;02;2;11;169;Châtillon-lès-Sons;84;0;84
32;Hauts-de-France;02;3;12;170;Châtillon-sur-Oise;124;0;124
32;Hauts-de-France;02;2;06;171;Chaudardes;90;1;91
32;Hauts-de-France;02;4;21;172;Chaudun;251;8;259
32;Hauts-de-France;02;2;03;173;Chauny;11438;405;11843
32;Hauts-de-France;02;4;05;174;Chavignon;835;17;852
32;Hauts-de-France;02;4;16;175;Chavigny;164;4;168
32;Hauts-de-France;02;4;05;176;Chavonne;207;3;210
32;Hauts-de-France;02;2;10;177;Chérêt;141;1;142
32;Hauts-de-France;02;2;06;178;Chermizy-Ailles;110;2;112
32;Hauts-de-France;02;4;05;179;Chéry-Chartreuve;381;7;388
32;Hauts-de-France;02;2;11;180;Chéry-lès-Pouilly;726;14;740
32;Hauts-de-France;02;5;19;181;Chéry-lès-Rozoy;85;0;85
32;Hauts-de-France;02;5;11;182;Chevennes;113;3;116
32;Hauts-de-France;02;2;06;183;Chevregny;185;1;186
32;Hauts-de-France;02;3;12;184;Chevresis-Monceau;346;5;351
32;Hauts-de-France;02;1;21;185;Chézy-en-Orxois;385;15;400
32;Hauts-de-France;02;1;04;186;Chézy-sur-Marne;1336;30;1366
32;Hauts-de-France;02;1;02;187;Chierry;1146;20;1166
32;Hauts-de-France;02;5;07;188;Chigny;145;3;148
32;Hauts-de-France;02;2;06;189;Chivres-en-Laonnois;345;8;353
32;Hauts-de-France;02;4;05;190;Chivres-Val;523;7;530
32;Hauts-de-France;02;2;10;191;Chivy-lès-Étouvelles;511;7;518
32;Hauts-de-France;02;4;21;192;Chouy;370;7;377
32;Hauts-de-France;02;1;05;193;Cierges;65;1;66
32;Hauts-de-France;02;2;11;194;Cilly;179;8;187
32;Hauts-de-France;02;4;05;195;Ciry-Salsogne;900;28;928
32;Hauts-de-France;02;2;09;196;Clacy-et-Thierret;306;7;313
32;Hauts-de-France;02;5;19;197;Clairfontaine;530;101;631
32;Hauts-de-France;02;4;05;198;Clamecy;228;2;230
32;Hauts-de-France;02;3;12;199;Clastres;597;8;605
32;Hauts-de-France;02;5;19;200;Clermont-les-Fermes;104;1;105
32;Hauts-de-France;02;4;20;201;Cœuvres-et-Valsery;449;6;455
32;Hauts-de-France;02;1;02;203;Coincy;1268;19;1287
32;Hauts-de-France;02;5;08;204;Coingt;64;2;66
32;Hauts-de-France;02;2;10;205;Colligis-Crandelain;219;3;222
32;Hauts-de-France;02;5;11;206;Colonfay;75;3;78
32;Hauts-de-France;02;2;03;207;Commenchon;217;3;220
32;Hauts-de-France;02;2;06;208;Concevreux;262;6;268
32;Hauts-de-France;02;1;04;209;Condé-en-Brie;691;11;702
32;Hauts-de-France;02;4;05;210;Condé-sur-Aisne;361;6;367
32;Hauts-de-France;02;2;06;211;Condé-sur-Suippe;310;3;313
32;Hauts-de-France;02;2;03;212;Condren;702;8;710
32;Hauts-de-France;02;1;04;213;Connigis;342;2;344
32;Hauts-de-France;02;3;15;214;Contescourt;61;1;62
32;Hauts-de-France;02;2;06;215;Corbeny;842;6;848
32;Hauts-de-France;02;4;21;216;Corcy;290;4;294
32;Hauts-de-France;02;2;20;217;Coucy-le-Château-Auffrique;992;10;1002
32;Hauts-de-France;02;2;06;218;Coucy-lès-Eppes;627;12;639
32;Hauts-de-France;02;2;20;219;Coucy-la-Ville;196;64;260
32;Hauts-de-France;02;1;05;220;Coulonges-Cohan;442;15;457
32;Hauts-de-France;02;1;04;221;Coupru;154;4;158
32;Hauts-de-France;02;2;18;222;Courbes;34;0;34
32;Hauts-de-France;02;1;04;223;Courboin;304;14;318
32;Hauts-de-France;02;4;05;224;Courcelles-sur-Vesle;340;5;345
32;Hauts-de-France;02;1;21;225;Courchamps;83;1;84
32;Hauts-de-France;02;4;17;226;Courmelles;1877;28;1905
32;Hauts-de-France;02;1;05;227;Courmont;120;0;120
32;Hauts-de-France;02;1;04;228;Courtemont-Varennes;346;5;351
32;Hauts-de-France;02;2;06;229;Courtrizy-et-Fussigny;74;0;74
32;Hauts-de-France;02;4;05;230;Couvrelles;186;6;192
32;Hauts-de-France;02;2;11;231;Couvron-et-Aumencourt;949;9;958
32;Hauts-de-France;02;4;21;232;Coyolles;365;8;373
32;Hauts-de-France;02;4;21;233;Cramaille;145;8;153
32;Hauts-de-France;02;2;06;234;Craonne;84;2;86
32;Hauts-de-France;02;2;06;235;Craonnelle;114;3;117
32;Hauts-de-France;02;2;20;236;Crécy-au-Mont;329;3;332
32;Hauts-de-France;02;2;11;237;Crécy-sur-Serre;1499;17;1516
32;Hauts-de-France;02;2;09;238;Crépy;1798;31;1829
32;Hauts-de-France;02;1;04;239;Crézancy;1250;84;1334
32;Hauts-de-France;02;3;01;240;Croix-Fonsomme;198;3;201
32;Hauts-de-France;02;1;21;241;La Croix-sur-Ourcq;91;3;94
32;Hauts-de-France;02;1;04;242;Crouttes-sur-Marne;640;11;651
32;Hauts-de-France;02;4;16;243;Crouy;2958;37;2995
32;Hauts-de-France;02;5;07;244;Crupilly;63;3;66
32;Hauts-de-France;02;4;16;245;Cuffies;1797;34;1831
32;Hauts-de-France;02;3;12;246;Cugny;608;4;612
32;Hauts-de-France;02;2;11;248;Cuirieux;156;3;159
32;Hauts-de-France;02;4;21;249;Cuiry-Housse;101;0;101
32;Hauts-de-France;02;2;06;250;Cuiry-lès-Chaudardes;72;4;76
32;Hauts-de-France;02;5;19;251;Cuiry-lès-Iviers;27;1;28
32;Hauts-de-France;02;2;06;252;Cuissy-et-Geny;71;1;72
32;Hauts-de-France;02;4;16;253;Cuisy-en-Almont;357;3;360
32;Hauts-de-France;02;4;20;254;Cutry;128;5;133
32;Hauts-de-France;02;4;05;255;Cys-la-Commune;155;2;157
32;Hauts-de-France;02;5;19;256;Dagny-Lambercy;130;3;133
32;Hauts-de-France;02;3;12;257;Dallon;437;12;449
32;Hauts-de-France;02;4;21;258;Dammard;372;12;384
32;Hauts-de-France;02;4;21;259;Dampleux;390;15;405
32;Hauts-de-France;02;2;18;260;Danizy;654;11;665
32;Hauts-de-France;02;2;11;261;Dercy;389;10;399
32;Hauts-de-France;02;2;18;262;Deuillet;208;3;211
32;Hauts-de-France;02;4;05;263;Dhuizel;114;0;114
32;Hauts-de-France;02;5;19;264;Dizy-le-Gros;724;16;740
32;Hauts-de-France;02;5;19;265;Dohis;93;1;94
32;Hauts-de-France;02;5;19;266;Dolignon;44;2;46
32;Hauts-de-France;02;4;20;267;Dommiers;297;9;306
32;Hauts-de-France;02;1;04;268;Domptin;635;13;648
32;Hauts-de-France;02;5;07;269;Dorengt;154;6;160
32;Hauts-de-France;02;3;13;270;Douchy;164;3;167
32;Hauts-de-France;02;1;05;271;Dravegny;129;2;131
32;Hauts-de-France;02;4;21;272;Droizy;77;2;79
32;Hauts-de-France;02;3;12;273;Dury;199;0;199
32;Hauts-de-France;02;2;06;274;Ébouleau;192;6;198
32;Hauts-de-France;02;5;08;275;Effry;316;7;323
32;Hauts-de-France;02;5;19;276;Englancourt;115;5;120
32;Hauts-de-France;02;4;20;277;Épagny;343;7;350
32;Hauts-de-France;02;5;08;278;Éparcy;30;2;32
32;Hauts-de-France;02;1;02;279;Épaux-Bézu;552;24;576
32;Hauts-de-France;02;1;02;280;Épieds;408;12;420
32;Hauts-de-France;02;1;04;281;L'Épine-aux-Bois;252;11;263
32;Hauts-de-France;02;2;10;282;Eppes;432;8;440
32;Hauts-de-France;02;2;11;283;Erlon;285;7;292
32;Hauts-de-France;02;5;19;284;Erloy;104;0;104
32;Hauts-de-France;02;5;07;286;Esquéhéries;861;20;881
32;Hauts-de-France;02;3;12;287;Essigny-le-Grand;1045;27;1072
32;Hauts-de-France;02;3;14;288;Essigny-le-Petit;349;8;357
32;Hauts-de-France;02;1;04;289;Essises;413;11;424
32;Hauts-de-France;02;1;04;290;Essômes-sur-Marne;2730;67;2797
32;Hauts-de-France;02;3;01;291;Estrées;410;6;416
32;Hauts-de-France;02;1;02;292;Étampes-sur-Marne;1331;27;1358
32;Hauts-de-France;02;3;01;293;Étaves-et-Bocquiaux;551;10;561
32;Hauts-de-France;02;2;10;294;Étouvelles;206;8;214
32;Hauts-de-France;02;5;19;295;Étréaupont;850;10;860
32;Hauts-de-France;02;3;13;296;Étreillers;1187;21;1208
32;Hauts-de-France;02;1;02;297;Étrépilly;123;2;125
32;Hauts-de-France;02;5;07;298;Étreux;1454;13;1467
32;Hauts-de-France;02;2;06;299;Évergnicourt;534;6;540
32;Hauts-de-France;02;4;21;302;Faverolles;332;12;344
32;Hauts-de-France;02;3;13;303;Fayet;684;16;700
32;Hauts-de-France;02;2;18;304;La Fère;2845;136;2981
32;Hauts-de-France;02;1;05;305;Fère-en-Tardenois;2970;52;3022
32;Hauts-de-France;02;3;12;306;La Ferté-Chevresis;513;9;522
32;Hauts-de-France;02;4;21;307;La Ferté-Milon;2055;135;2190
32;Hauts-de-France;02;5;07;308;Fesmy-le-Sart;489;4;493
32;Hauts-de-France;02;2;10;309;Festieux;683;5;688
32;Hauts-de-France;02;3;14;310;Fieulaine;250;7;257
32;Hauts-de-France;02;4;05;311;Filain;118;2;120
32;Hauts-de-France;02;5;19;312;La Flamengrie;1088;10;1098
32;Hauts-de-France;02;5;07;313;Flavigny-le-Grand-et-Beaurain;444;5;449
32;Hauts-de-France;02;3;12;315;Flavy-le-Martel;1660;35;1695
32;Hauts-de-France;02;4;21;316;Fleury;124;5;129
32;Hauts-de-France;02;3;13;317;Fluquières;212;4;216
32;Hauts-de-France;02;2;20;318;Folembray;1377;18;1395
32;Hauts-de-France;02;3;14;319;Fonsomme;500;8;508
32;Hauts-de-France;02;3;12;320;Fontaine-lès-Clercs;233;4;237
32;Hauts-de-France;02;5;19;321;Fontaine-lès-Vervins;892;189;1081
32;Hauts-de-France;02;3;14;322;Fontaine-Notre-Dame;383;4;387
32;Hauts-de-France;02;3;01;323;Fontaine-Uterte;138;3;141
32;Hauts-de-France;02;5;19;324;Fontenelle;288;3;291
32;Hauts-de-France;02;4;20;326;Fontenoy;467;8;475
32;Hauts-de-France;02;3;13;327;Foreste;159;1;160
32;Hauts-de-France;02;1;02;328;Fossoy;512;7;519
32;Hauts-de-France;02;2;18;329;Fourdrain;434;9;443
32;Hauts-de-France;02;3;13;330;Francilly-Selency;546;8;554
32;Hauts-de-France;02;5;11;331;Franqueville;108;4;112
32;Hauts-de-France;02;1;05;332;Fresnes-en-Tardenois;271;4;275
32;Hauts-de-France;02;2;20;333;Fresnes-sous-Coucy;163;3;166
32;Hauts-de-France;02;3;01;334;Fresnoy-le-Grand;2946;69;3015
32;Hauts-de-France;02;2;18;335;Fressancourt;179;8;187
32;Hauts-de-France;02;2;03;336;Frières-Faillouël;981;16;997
32;Hauts-de-France;02;5;19;337;Froidestrées;177;5;182
32;Hauts-de-France;02;2;11;338;Froidmont-Cohartille;250;8;258
32;Hauts-de-France;02;1;21;339;Gandelu;695;9;704
32;Hauts-de-France;02;3;15;340;Gauchy;5216;67;5283
32;Hauts-de-France;02;5;19;341;Gercy;262;1;263
32;Hauts-de-France;02;5;19;342;Gergny;130;2;132
32;Hauts-de-France;02;3;13;343;Germaine;82;0;82
32;Hauts-de-France;02;3;12;345;Gibercourt;40;0;40
32;Hauts-de-France;02;2;06;346;Gizy;654;8;662
32;Hauts-de-France;02;1;02;347;Gland;438;6;444
32;Hauts-de-France;02;2;06;349;Goudelancourt-lès-Berrieux;56;0;56
32;Hauts-de-France;02;2;06;350;Goudelancourt-lès-Pierrepont;138;2;140
32;Hauts-de-France;02;1;05;351;Goussancourt;113;6;119
32;Hauts-de-France;02;3;01;352;Gouy;563;7;570
32;Hauts-de-France;02;2;11;353;Grandlup-et-Fay;281;10;291
32;Hauts-de-France;02;5;19;354;Grandrieux;79;2;81
32;Hauts-de-France;02;3;13;355;Gricourt;945;25;970
32;Hauts-de-France;02;1;02;356;Grisolles;234;2;236
32;Hauts-de-France;02;5;19;357;Gronard;70;2;72
32;Hauts-de-France;02;5;07;358;Grougis;321;3;324
32;Hauts-de-France;02;3;15;359;Grugies;1274;20;1294
32;Hauts-de-France;02;2;06;360;Villeneuve-sur-Aisne;2780;35;2815
32;Hauts-de-France;02;5;07;361;Guise;4559;69;4628
32;Hauts-de-France;02;2;03;362;Guivry;238;4;242
32;Hauts-de-France;02;2;20;363;Guny;374;3;377
32;Hauts-de-France;02;2;06;364;Guyencourt;254;4;258
32;Hauts-de-France;02;5;07;366;Hannapes;326;7;333
32;Hauts-de-France;02;3;12;367;Happencourt;146;0;146
32;Hauts-de-France;02;4;21;368;Haramont;568;9;577
32;Hauts-de-France;02;5;19;369;Harcigny;242;2;244
32;Hauts-de-France;02;3;01;370;Hargicourt;590;12;602
32;Hauts-de-France;02;3;15;371;Harly;1567;33;1600
32;Hauts-de-France;02;4;21;372;Hartennes-et-Taux;344;10;354
32;Hauts-de-France;02;5;19;373;Hary;193;5;198
32;Hauts-de-France;02;3;01;374;Lehaucourt;853;8;861
32;Hauts-de-France;02;1;21;375;Hautevesnes;160;3;163
32;Hauts-de-France;02;5;07;376;Hauteville;177;5;182
32;Hauts-de-France;02;5;19;377;Haution;133;8;141
32;Hauts-de-France;02;5;08;378;La Hérie;126;5;131
32;Hauts-de-France;02;5;11;379;Le Hérie-la-Viéville;198;126;324
32;Hauts-de-France;02;3;12;380;Hinacourt;26;0;26
32;Hauts-de-France;02;5;08;381;Hirson;8685;189;8874
32;Hauts-de-France;02;3;13;382;Holnon;1360;37;1397
32;Hauts-de-France;02;3;15;383;Homblières;1441;33;1474
32;Hauts-de-France;02;5;19;384;Houry;57;2;59
32;Hauts-de-France;02;5;11;385;Housset;165;4;169
32;Hauts-de-France;02;5;07;386;Iron;225;2;227
32;Hauts-de-France;02;3;12;387;Itancourt;1007;36;1043
32;Hauts-de-France;02;5;08;388;Iviers;221;5;226
32;Hauts-de-France;02;1;04;389;Jaulgonne;666;13;679
32;Hauts-de-France;02;3;13;390;Jeancourt;260;2;262
32;Hauts-de-France;02;5;08;391;Jeantes;212;5;217
32;Hauts-de-France;02;3;01;392;Joncourt;317;6;323
32;Hauts-de-France;02;4;05;393;Jouaignes;139;5;144
32;Hauts-de-France;02;2;20;395;Jumencourt;139;6;145
32;Hauts-de-France;02;2;06;396;Jumigny;63;2;65
32;Hauts-de-France;02;3;12;397;Jussy;1252;19;1271
32;Hauts-de-France;02;4;16;398;Juvigny;281;4;285
32;Hauts-de-France;02;2;06;399;Juvincourt-et-Damary;615;4;619
32;Hauts-de-France;02;4;05;400;Laffaux;152;4;156
32;Hauts-de-France;02;5;19;401;Laigny;191;2;193
32;Hauts-de-France;02;3;13;402;Lanchy;37;2;39
32;Hauts-de-France;02;5;11;403;Landifay-et-Bertaignemont;257;7;264
32;Hauts-de-France;02;5;19;404;Landouzy-la-Cour;183;4;187
32;Hauts-de-France;02;5;08;405;Landouzy-la-Ville;535;5;540
32;Hauts-de-France;02;2;20;406;Landricourt;131;0;131
32;Hauts-de-France;02;2;09;407;Laniscourt;208;9;217
32;Hauts-de-France;02;2;97;408;Laon;24091;647;24738
32;Hauts-de-France;02;2;06;409;Lappion;272;7;279
32;Hauts-de-France;02;4;21;410;Largny-sur-Automne;242;5;247
32;Hauts-de-France;02;1;21;411;Latilly;200;4;204
32;Hauts-de-France;02;4;21;412;Launoy;100;1;101
32;Hauts-de-France;02;2;10;413;Laval-en-Laonnois;241;4;245
32;Hauts-de-France;02;5;07;414;Lavaqueresse;201;5;206
32;Hauts-de-France;02;4;20;415;Laversine;159;5;164
32;Hauts-de-France;02;5;11;416;Lemé;417;4;421
32;Hauts-de-France;02;3;01;417;Lempire;120;0;120
32;Hauts-de-France;02;5;19;418;Lerzy;223;4;227
32;Hauts-de-France;02;5;07;419;Leschelle;268;10;278
32;Hauts-de-France;02;3;14;420;Lesdins;830;10;840
32;Hauts-de-France;02;4;05;421;Lesges;99;2;101
32;Hauts-de-France;02;5;07;422;Lesquielles-Saint-Germain;802;9;811
32;Hauts-de-France;02;2;20;423;Leuilly-sous-Coucy;426;8;434
32;Hauts-de-France;02;4;16;424;Leury;103;0;103
32;Hauts-de-France;02;5;08;425;Leuze;173;0;173
32;Hauts-de-France;02;3;01;426;Levergies;541;7;548
32;Hauts-de-France;02;4;05;427;Lhuys;140;1;141
32;Hauts-de-France;02;1;21;428;Licy-Clignon;74;2;76
32;Hauts-de-France;02;2;10;429;Lierval;123;1;124
32;Hauts-de-France;02;2;06;430;Liesse-Notre-Dame;1270;129;1399
32;Hauts-de-France;02;2;18;431;Liez;378;9;387
32;Hauts-de-France;02;4;05;432;Limé;190;5;195
32;Hauts-de-France;02;5;19;433;Lislet;219;7;226
32;Hauts-de-France;02;5;08;435;Logny-lès-Aubenton;82;0;82
32;Hauts-de-France;02;4;21;438;Longpont;244;9;253
32;Hauts-de-France;02;4;05;439;Les Septvallons;1196;13;1209
32;Hauts-de-France;02;2;06;440;Lor;138;0;138
32;Hauts-de-France;02;4;21;441;Louâtre;181;3;184
32;Hauts-de-France;02;1;05;442;Loupeigne;90;1;91
32;Hauts-de-France;02;1;04;443;Lucy-le-Bocage;206;6;212
32;Hauts-de-France;02;5;11;444;Lugny;125;0;125
32;Hauts-de-France;02;5;19;445;Luzoir;277;3;280
32;Hauts-de-France;02;3;12;446;Ly-Fontaine;118;1;119
32;Hauts-de-France;02;4;21;447;Maast-et-Violaine;148;5;153
32;Hauts-de-France;02;2;06;448;Mâchecourt;117;3;120
32;Hauts-de-France;02;4;21;449;Macogny;64;3;67
32;Hauts-de-France;02;5;07;450;Macquigny;361;4;365
32;Hauts-de-France;02;3;01;451;Magny-la-Fosse;122;0;122
32;Hauts-de-France;02;3;13;452;Maissemy;235;10;245
32;Hauts-de-France;02;2;06;453;Maizy;404;8;412
32;Hauts-de-France;02;2;06;454;La Malmaison;404;3;407
32;Hauts-de-France;02;5;07;455;Malzy;196;4;200
32;Hauts-de-France;02;2;20;456;Manicamp;295;4;299
32;Hauts-de-France;02;2;06;457;Marchais;389;10;399
32;Hauts-de-France;02;1;04;458;Dhuys et Morin-en-Brie;822;14;836
32;Hauts-de-France;02;3;14;459;Marcy;158;8;166
32;Hauts-de-France;02;2;11;460;Marcy-sous-Marle;206;1;207
32;Hauts-de-France;02;2;03;461;Marest-Dampcourt;369;8;377
32;Hauts-de-France;02;1;05;462;Mareuil-en-Dôle;229;2;231
32;Hauts-de-France;02;5;11;463;Marfontaine;87;0;87
32;Hauts-de-France;02;4;05;464;Margival;366;2;368
32;Hauts-de-France;02;1;04;465;Marigny-en-Orxois;527;7;534
32;Hauts-de-France;02;4;21;466;Marizy-Sainte-Geneviève;131;1;132
32;Hauts-de-France;02;4;21;467;Marizy-Saint-Mard;50;1;51
32;Hauts-de-France;02;2;11;468;Marle;2219;31;2250
32;Hauts-de-France;02;5;07;469;Marly-Gomont;487;13;500
32;Hauts-de-France;02;5;08;470;Martigny;433;12;445
32;Hauts-de-France;02;2;10;471;Martigny-Courpierre;136;2;138
32;Hauts-de-France;02;2;06;472;Mauregny-en-Haye;404;7;411
32;Hauts-de-France;02;2;18;473;Mayot;219;1;220
32;Hauts-de-France;02;2;18;474;Mennessis;394;4;398
32;Hauts-de-France;02;5;07;476;Mennevret;669;14;683
32;Hauts-de-France;02;4;17;477;Mercin-et-Vaux;964;22;986
32;Hauts-de-France;02;2;09;478;Merlieux-et-Fouquerolles;259;12;271
32;Hauts-de-France;02;2;11;480;Mesbrecourt-Richecourt;316;3;319
32;Hauts-de-France;02;3;15;481;Mesnil-Saint-Laurent;480;16;496
32;Hauts-de-France;02;2;06;482;Meurival;55;1;56
32;Hauts-de-France;02;3;12;483;Mézières-sur-Oise;511;11;522
32;Hauts-de-France;02;1;04;484;Mézy-Moulins;532;3;535
32;Hauts-de-France;02;4;17;485;Missy-aux-Bois;95;5;100
32;Hauts-de-France;02;2;06;486;Missy-lès-Pierrepont;106;1;107
32;Hauts-de-France;02;4;05;487;Missy-sur-Aisne;620;8;628
32;Hauts-de-France;02;5;07;488;Molain;158;2;160
32;Hauts-de-France;02;2;09;489;Molinchart;348;7;355
32;Hauts-de-France;02;4;05;490;Monampteuil;124;3;127
32;Hauts-de-France;02;5;11;491;Monceau-le-Neuf-et-Faucouzy;322;9;331
32;Hauts-de-France;02;2;18;492;Monceau-lès-Leups;445;8;453
32;Hauts-de-France;02;2;11;493;Monceau-le-Waast;223;6;229
32;Hauts-de-France;02;5;07;494;Monceau-sur-Oise;127;2;129
32;Hauts-de-France;02;5;08;495;Mondrepuis;1043;15;1058
32;Hauts-de-France;02;4;21;496;Monnes;98;1;99
32;Hauts-de-France;02;2;09;497;Mons-en-Laonnois;1151;30;1181
32;Hauts-de-France;02;2;06;498;Montaigu;762;17;779
32;Hauts-de-France;02;2;09;499;Montbavin;42;2;44
32;Hauts-de-France;02;3;01;500;Montbrehain;807;18;825
32;Hauts-de-France;02;2;10;501;Montchâlons;97;2;99
32;Hauts-de-France;02;5;19;502;Montcornet;1291;12;1303
32;Hauts-de-France;02;3;12;503;Mont-d'Origny;827;2;829
32;Hauts-de-France;02;3;12;504;Montescourt-Lizerolles;1608;27;1635
32;Hauts-de-France;02;1;04;505;Montfaucon;207;5;212
32;Hauts-de-France;02;4;21;506;Montgobert;197;4;201
32;Hauts-de-France;02;4;21;507;Montgru-Saint-Hilaire;31;0;31
32;Hauts-de-France;02;2;10;508;Monthenault;152;6;158
32;Hauts-de-France;02;1;21;509;Monthiers;153;0;153
32;Hauts-de-France;02;1;04;510;Monthurel;146;5;151
32;Hauts-de-France;02;3;01;511;Montigny-en-Arrouaise;302;6;308
32;Hauts-de-France;02;1;21;512;Montigny-l'Allier;269;5;274
32;Hauts-de-France;02;2;11;513;Montigny-le-Franc;136;2;138
32;Hauts-de-France;02;4;20;514;Montigny-Lengrain;702;15;717
32;Hauts-de-France;02;1;04;515;Montigny-lès-Condé;53;4;57
32;Hauts-de-France;02;2;11;516;Montigny-sous-Marle;69;1;70
32;Hauts-de-France;02;2;11;517;Montigny-sur-Crécy;295;5;300
32;Hauts-de-France;02;1;04;518;Montlevon;301;2;303
32;Hauts-de-France;02;5;19;519;Montloué;188;4;192
32;Hauts-de-France;02;4;05;520;Mont-Notre-Dame;737;5;742
32;Hauts-de-France;02;1;04;521;Montreuil-aux-Lions;1374;14;1388
32;Hauts-de-France;02;5;08;522;Mont-Saint-Jean;73;2;75
32;Hauts-de-France;02;4;05;523;Mont-Saint-Martin;71;1;72
32;Hauts-de-France;02;1;02;524;Mont-Saint-Père;692;18;710
32;Hauts-de-France;02;3;14;525;Morcourt;566;6;572
32;Hauts-de-France;02;5;19;526;Morgny-en-Thiérache;102;3;105
32;Hauts-de-France;02;4;20;527;Morsain;461;9;470
32;Hauts-de-France;02;4;20;528;Mortefontaine;223;6;229
32;Hauts-de-France;02;2;11;529;Mortiers;180;3;183
32;Hauts-de-France;02;2;06;530;Moulins;78;1;79
32;Hauts-de-France;02;2;06;531;Moussy-Verneuil;125;3;128
32;Hauts-de-France;02;3;12;532;Moÿ-de-l'Aisne;983;18;1001
32;Hauts-de-France;02;4;21;533;Muret-et-Crouttes;108;6;114
32;Hauts-de-France;02;2;06;534;Muscourt;47;1;48
32;Hauts-de-France;02;5;19;535;Nampcelles-la-Cour;113;5;118
32;Hauts-de-France;02;4;21;536;Nampteuil-sous-Muret;104;1;105
32;Hauts-de-France;02;4;05;537;Nanteuil-la-Fosse;203;1;204
32;Hauts-de-France;02;1;05;538;Nanteuil-Notre-Dame;74;0;74
32;Hauts-de-France;02;3;01;539;Nauroy;699;7;706
32;Hauts-de-France;02;1;02;540;Nesles-la-Montagne;1216;36;1252
32;Hauts-de-France;02;2;06;541;Neufchâtel-sur-Aisne;420;5;425
32;Hauts-de-France;02;2;03;542;Neuflieux;80;2;82
32;Hauts-de-France;02;1;21;543;Neuilly-Saint-Front;2055;34;2089
32;Hauts-de-France;02;5;08;544;Neuve-Maison;613;11;624
32;Hauts-de-France;02;2;11;545;La Neuville-Bosmont;187;2;189
32;Hauts-de-France;02;2;03;546;La Neuville-en-Beine;188;4;192
32;Hauts-de-France;02;5;11;547;La Neuville-Housset;66;1;67
32;Hauts-de-France;02;5;07;548;La Neuville-lès-Dorengt;382;6;388
32;Hauts-de-France;02;3;15;549;Neuville-Saint-Amand;849;22;871
32;Hauts-de-France;02;2;06;550;Neuville-sur-Ailette;120;3;123
32;Hauts-de-France;02;4;05;551;Neuville-sur-Margival;110;0;110
32;Hauts-de-France;02;3;12;552;Neuvillette;190;8;198
32;Hauts-de-France;02;2;06;553;Nizy-le-Comte;247;4;251
32;Hauts-de-France;02;1;04;554;Nogentel;1100;23;1123
32;Hauts-de-France;02;1;04;555;Nogent-l'Artaud;2095;45;2140
32;Hauts-de-France;02;5;19;556;Noircourt;77;2;79
32;Hauts-de-France;02;4;21;557;Noroy-sur-Ourcq;128;0;128
32;Hauts-de-France;02;5;07;558;Le Nouvion-en-Thiérache;2531;25;2556
32;Hauts-de-France;02;2;11;559;Nouvion-et-Catillon;483;6;489
32;Hauts-de-France;02;2;11;560;Nouvion-le-Comte;245;4;249
32;Hauts-de-France;02;2;10;561;Nouvion-le-Vineux;147;4;151
32;Hauts-de-France;02;4;20;562;Nouvron-Vingré;206;2;208
32;Hauts-de-France;02;5;07;563;Noyales;163;3;166
32;Hauts-de-France;02;4;17;564;Noyant-et-Aconin;491;6;497
32;Hauts-de-France;02;2;06;565;Œuilly;293;3;296
32;Hauts-de-France;02;2;03;566;Ognes;1106;22;1128
32;Hauts-de-France;02;5;08;567;Ohis;275;8;283
32;Hauts-de-France;02;4;21;568;Oigny-en-Valois;165;4;169
32;Hauts-de-France;02;5;07;569;Oisy;476;3;479
32;Hauts-de-France;02;3;12;570;Ollezy;174;0;174
32;Hauts-de-France;02;3;14;571;Omissy;711;75;786
32;Hauts-de-France;02;2;06;572;Orainville;500;9;509
32;Hauts-de-France;02;2;10;573;Orgeval;57;1;58
32;Hauts-de-France;02;5;08;574;Origny-en-Thiérache;1409;21;1430
32;Hauts-de-France;02;3;12;575;Origny-Sainte-Benoite;1660;12;1672
32;Hauts-de-France;02;4;16;576;Osly-Courtil;328;8;336
32;Hauts-de-France;02;4;05;577;Ostel;91;1;92
32;Hauts-de-France;02;2;06;578;Oulches-la-Vallée-Foulon;86;1;87
32;Hauts-de-France;02;4;21;579;Oulchy-la-Ville;124;9;133
32;Hauts-de-France;02;4;21;580;Oulchy-le-Château;816;9;825
32;Hauts-de-France;02;4;05;581;Paars;320;1;321
32;Hauts-de-France;02;2;06;582;Paissy;77;2;79
32;Hauts-de-France;02;2;06;583;Pancy-Courtecon;53;2;55
32;Hauts-de-France;02;5;19;584;Papleux;117;7;124
32;Hauts-de-France;02;4;21;585;Parcy-et-Tigny;255;6;261
32;Hauts-de-France;02;5;19;586;Parfondeval;138;6;144
32;Hauts-de-France;02;2;10;587;Parfondru;353;11;364
32;Hauts-de-France;02;2;06;588;Pargnan;67;2;69
32;Hauts-de-France;02;4;05;589;Pargny-Filain;262;0;262
32;Hauts-de-France;02;1;04;590;Pargny-la-Dhuys;169;2;171
32;Hauts-de-France;02;2;11;591;Pargny-les-Bois;136;2;138
32;Hauts-de-France;02;3;12;592;Parpeville;193;5;198
32;Hauts-de-France;02;4;16;593;Pasly;1067;21;1088
32;Hauts-de-France;02;4;21;594;Passy-en-Valois;129;6;135
32;Hauts-de-France;02;1;04;595;Passy-sur-Marne;137;0;137
32;Hauts-de-France;02;1;04;596;Pavant;762;13;775
32;Hauts-de-France;02;4;20;598;Pernant;679;18;697
32;Hauts-de-France;02;2;03;599;Pierremande;253;3;256
32;Hauts-de-France;02;2;11;600;Pierrepont;340;5;345
32;Hauts-de-France;02;2;06;601;Pignicourt;190;4;194
32;Hauts-de-France;02;2;09;602;Pinon;1668;25;1693
32;Hauts-de-France;02;3;12;604;Pithon;82;0;82
32;Hauts-de-France;02;3;12;605;Pleine-Selve;192;5;197
32;Hauts-de-France;02;4;21;606;Le Plessier-Huleu;69;3;72
32;Hauts-de-France;02;4;17;607;Ploisy;84;1;85
32;Hauts-de-France;02;5;19;608;Plomion;468;2;470
32;Hauts-de-France;02;2;06;609;Ployart-et-Vaurseine;21;1;22
32;Hauts-de-France;02;4;16;610;Pommiers;741;11;752
32;Hauts-de-France;02;4;05;612;Pont-Arcy;124;2;126
32;Hauts-de-France;02;2;06;613;Pontavert;603;11;614
32;Hauts-de-France;02;3;13;614;Pontru;272;7;279
32;Hauts-de-France;02;3;13;615;Pontruet;357;13;370
32;Hauts-de-France;02;2;20;616;Pont-Saint-Mard;202;3;205
32;Hauts-de-France;02;2;11;617;Pouilly-sur-Serre;507;4;511
32;Hauts-de-France;02;3;01;618;Prémont;691;11;702
32;Hauts-de-France;02;2;09;619;Prémontré;637;6;643
32;Hauts-de-France;02;4;05;620;Presles-et-Boves;341;7;348
32;Hauts-de-France;02;2;10;621;Presles-et-Thierny;386;8;394
32;Hauts-de-France;02;1;21;622;Priez;55;0;55
32;Hauts-de-France;02;5;19;623;Prisces;96;3;99
32;Hauts-de-France;02;5;07;624;Proisy;272;65;337
32;Hauts-de-France;02;5;07;625;Proix;142;2;144
32;Hauts-de-France;02;2;06;626;Prouvais;336;7;343
32;Hauts-de-France;02;2;06;627;Proviseux-et-Plesnoy;126;2;128
32;Hauts-de-France;02;4;21;628;Puiseux-en-Retz;218;6;224
32;Hauts-de-France;02;5;11;629;Puisieux-et-Clanlieu;322;12;334
32;Hauts-de-France;02;2;20;631;Quierzy;409;5;414
32;Hauts-de-France;02;2;20;632;Quincy-Basse;56;1;57
32;Hauts-de-France;02;4;05;633;Quincy-sous-le-Mont;61;2;63
32;Hauts-de-France;02;5;19;634;Raillimont;85;4;89
32;Hauts-de-France;02;3;01;635;Ramicourt;146;2;148
32;Hauts-de-France;02;3;12;636;Regny;200;5;205
32;Hauts-de-France;02;3;14;637;Remaucourt;291;10;301
32;Hauts-de-France;02;2;11;638;Remies;238;1;239
32;Hauts-de-France;02;3;12;639;Remigny;346;7;353
32;Hauts-de-France;02;3;12;640;Renansart;155;4;159
32;Hauts-de-France;02;5;19;641;Renneval;111;3;114
32;Hauts-de-France;02;5;19;642;Résigny;166;3;169
32;Hauts-de-France;02;4;20;643;Ressons-le-Long;784;8;792
32;Hauts-de-France;02;4;21;644;Retheuil;340;12;352
32;Hauts-de-France;02;1;04;645;Reuilly-Sauvigny;188;8;196
32;Hauts-de-France;02;5;07;647;Ribeauville;59;0;59
32;Hauts-de-France;02;3;12;648;Ribemont;1914;37;1951
32;Hauts-de-France;02;1;02;649;Rocourt-Saint-Martin;309;4;313
32;Hauts-de-France;02;5;19;650;Rocquigny;359;6;365
32;Hauts-de-France;02;2;18;651;Rogécourt;106;1;107
32;Hauts-de-France;02;5;11;652;Rogny;103;1;104
32;Hauts-de-France;02;1;04;653;Romeny-sur-Marne;498;13;511
32;Hauts-de-France;02;5;07;654;Romery;83;1;84
32;Hauts-de-France;02;1;05;655;Ronchères;146;0;146
32;Hauts-de-France;02;2;06;656;Roucy;394;10;404
32;Hauts-de-France;02;5;11;657;Rougeries;234;5;239
32;Hauts-de-France;02;3;13;658;Roupy;239;6;245
32;Hauts-de-France;02;3;14;659;Rouvroy;505;13;518
32;Hauts-de-France;02;5;19;660;Rouvroy-sur-Serre;37;2;39
32;Hauts-de-France;02;2;09;661;Royaucourt-et-Chailvet;245;3;248
32;Hauts-de-France;02;1;21;662;Rozet-Saint-Albin;328;9;337
32;Hauts-de-France;02;4;21;663;Rozières-sur-Crise;225;5;230
32;Hauts-de-France;02;1;04;664;Rozoy-Bellevalle;122;3;125
32;Hauts-de-France;02;4;21;665;Grand-Rozoy;299;5;304
32;Hauts-de-France;02;5;19;666;Rozoy-sur-Serre;975;13;988
32;Hauts-de-France;02;4;20;667;Saconin-et-Breuil;201;5;206
32;Hauts-de-France;02;5;11;668;Sains-Richaumont;1018;26;1044
32;Hauts-de-France;02;5;19;670;Saint-Algis;150;1;151
32;Hauts-de-France;02;2;20;671;Saint-Aubin;283;5;288
32;Hauts-de-France;02;4;20;672;Saint-Bandry;254;8;262
32;Hauts-de-France;02;4;20;673;Saint-Christophe-à-Berry;442;7;449
32;Hauts-de-France;02;5;08;674;Saint-Clément;49;0;49
32;Hauts-de-France;02;2;06;675;Sainte-Croix;134;1;135
32;Hauts-de-France;02;2;06;676;Saint-Erme-Outre-et-Ramecourt;1711;26;1737
32;Hauts-de-France;02;1;04;677;Saint-Eugène;238;3;241
32;Hauts-de-France;02;5;19;678;Sainte-Geneviève;67;0;67
32;Hauts-de-France;02;1;21;679;Saint-Gengoulph;151;4;155
32;Hauts-de-France;02;2;18;680;Saint-Gobain;2304;39;2343
32;Hauts-de-France;02;5;11;681;Saint-Gobert;280;6;286
32;Hauts-de-France;02;4;05;682;Saint-Mard;115;3;118
32;Hauts-de-France;02;5;07;683;Saint-Martin-Rivière;108;2;110
32;Hauts-de-France;02;5;08;684;Saint-Michel;3279;60;3339
32;Hauts-de-France;02;2;18;685;Saint-Nicolas-aux-Bois;121;1;122
32;Hauts-de-France;02;2;20;686;Saint-Paul-aux-Bois;368;6;374
32;Hauts-de-France;02;4;20;687;Saint-Pierre-Aigle;335;9;344
32;Hauts-de-France;02;5;11;688;Saint-Pierre-lès-Franqueville;45;4;49
32;Hauts-de-France;02;2;11;689;Saint-Pierremont;41;1;42
32;Hauts-de-France;02;2;06;690;Sainte-Preuve;76;1;77
32;Hauts-de-France;02;3;98;691;Saint-Quentin;53100;1247;54347
32;Hauts-de-France;02;4;21;693;Saint-Rémy-Blanzy;223;3;226
32;Hauts-de-France;02;3;12;694;Saint-Simon;627;14;641
32;Hauts-de-France;02;2;06;696;Saint-Thomas;74;3;77
32;Hauts-de-France;02;2;10;697;Samoussy;383;5;388
32;Hauts-de-France;02;4;05;698;Sancy-les-Cheminots;102;2;104
32;Hauts-de-France;02;1;05;699;Saponay;276;3;279
32;Hauts-de-France;02;1;04;701;Saulchery;704;7;711
32;Hauts-de-France;02;3;13;702;Savy;605;13;618
32;Hauts-de-France;02;3;01;703;Seboncourt;1082;15;1097
32;Hauts-de-France;02;2;20;704;Selens;234;3;237
32;Hauts-de-France;02;2;06;705;La Selve;206;6;212
32;Hauts-de-France;02;4;17;706;Septmonts;568;12;580
32;Hauts-de-France;02;2;20;707;Septvaux;179;0;179
32;Hauts-de-France;02;3;01;708;Sequehart;214;8;222
32;Hauts-de-France;02;3;01;709;Serain;406;8;414
32;Hauts-de-France;02;3;12;710;Seraucourt-le-Grand;729;18;747
32;Hauts-de-France;02;4;17;711;Serches;285;6;291
32;Hauts-de-France;02;1;05;712;Sergy;141;3;144
32;Hauts-de-France;02;1;05;713;Seringes-et-Nesles;267;3;270
32;Hauts-de-France;02;4;17;714;Sermoise;361;1;362
32;Hauts-de-France;02;4;05;715;Serval;42;3;45
32;Hauts-de-France;02;2;18;716;Servais;290;6;296
32;Hauts-de-France;02;3;12;717;Séry-lès-Mézières;597;13;610
32;Hauts-de-France;02;4;21;718;Silly-la-Poterie;118;3;121
32;Hauts-de-France;02;2;03;719;Sinceny;2013;41;2054
32;Hauts-de-France;02;2;06;720;Sissonne;2062;73;2135
32;Hauts-de-France;02;3;12;721;Sissy;475;2;477
32;Hauts-de-France;02;4;99;722;Soissons;28888;655;29543
32;Hauts-de-France;02;5;19;723;Soize;97;1;98
32;Hauts-de-France;02;1;21;724;Sommelans;61;1;62
32;Hauts-de-France;02;5;19;725;Sommeron;137;6;143
32;Hauts-de-France;02;3;12;726;Sommette-Eaucourt;175;2;177
32;Hauts-de-France;02;2;11;727;Sons-et-Ronchères;211;3;214
32;Hauts-de-France;02;5;19;728;Sorbais;260;4;264
32;Hauts-de-France;02;4;21;729;Soucy;79;1;80
32;Hauts-de-France;02;4;05;730;Soupir;265;7;272
32;Hauts-de-France;02;5;11;731;Le Sourd;173;2;175
32;Hauts-de-France;02;3;12;732;Surfontaine;104;0;104
32;Hauts-de-France;02;4;21;734;Taillefontaine;272;6;278
32;Hauts-de-France;02;4;05;735;Tannières;17;0;17
32;Hauts-de-France;02;4;20;736;Tartiers;166;5;171
32;Hauts-de-France;02;2;11;737;Tavaux-et-Pontséricourt;552;12;564
32;Hauts-de-France;02;2;18;738;Tergnier;13504;190;13694
32;Hauts-de-France;02;4;05;739;Terny-Sorny;336;7;343
32;Hauts-de-France;02;5;19;740;Thenailles;221;6;227
32;Hauts-de-France;02;3;12;741;Thenelles;540;5;545
32;Hauts-de-France;02;2;11;742;Thiernu;117;0;117
32;Hauts-de-France;02;5;19;743;Le Thuel;156;1;157
32;Hauts-de-France;02;1;21;744;Torcy-en-Valois;70;2;72
32;Hauts-de-France;02;2;11;745;Toulis-et-Attencourt;117;1;118
32;Hauts-de-France;02;2;18;746;Travecy;658;11;669
32;Hauts-de-France;02;3;13;747;Trefcon;84;0;84
32;Hauts-de-France;02;1;04;748;Trélou-sur-Marne;934;25;959
32;Hauts-de-France;02;4;21;749;Troësnes;216;10;226
32;Hauts-de-France;02;2;20;750;Trosly-Loire;568;8;576
32;Hauts-de-France;02;2;06;751;Trucy;143;2;145
32;Hauts-de-France;02;3;12;752;Tugny-et-Pont;284;4;288
32;Hauts-de-France;02;5;07;753;Tupigny;327;4;331
32;Hauts-de-France;02;2;03;754;Ugny-le-Gay;186;3;189
32;Hauts-de-France;02;2;09;755;Urcel;571;12;583
32;Hauts-de-France;02;3;12;756;Urvillers;689;12;701
32;Hauts-de-France;02;5;07;757;Vadencourt;521;10;531
32;Hauts-de-France;02;4;05;758;Vailly-sur-Aisne;2017;37;2054
32;Hauts-de-France;02;5;11;759;La Vallée-au-Blé;366;6;372
32;Hauts-de-France;02;5;07;760;La Vallée-Mulâtre;138;3;141
32;Hauts-de-France;02;2;06;761;Variscourt;211;4;215
32;Hauts-de-France;02;4;20;762;Vassens;150;3;153
32;Hauts-de-France;02;4;05;763;Vasseny;219;4;223
32;Hauts-de-France;02;2;06;764;Vassogne;90;3;93
32;Hauts-de-France;02;2;09;765;Vaucelles-et-Beffecourt;237;10;247
32;Hauts-de-France;02;4;05;766;Vaudesson;236;4;240
32;Hauts-de-France;02;4;16;767;Vauxrezis;321;3;324
32;Hauts-de-France;02;2;09;768;Vauxaillon;530;10;540
32;Hauts-de-France;02;5;07;769;Vaux-Andigny;906;16;922
32;Hauts-de-France;02;4;17;770;Vauxbuin;785;20;805
32;Hauts-de-France;02;3;13;772;Vaux-en-Vermandois;154;5;159
32;Hauts-de-France;02;4;05;773;Vauxtin;39;0;39
32;Hauts-de-France;02;3;13;774;Vendelles;119;1;120
32;Hauts-de-France;02;3;12;775;Vendeuil;929;17;946
32;Hauts-de-France;02;3;01;776;Vendhuile;561;12;573
32;Hauts-de-France;02;1;04;777;Vendières;137;7;144
32;Hauts-de-France;02;2;06;778;Vendresse-Beaulne;94;1;95
32;Hauts-de-France;02;5;07;779;Vénérolles;220;3;223
32;Hauts-de-France;02;4;16;780;Venizel;1363;24;1387
32;Hauts-de-France;02;1;02;781;Verdilly;451;15;466
32;Hauts-de-France;02;3;13;782;Le Verguier;221;2;223
32;Hauts-de-France;02;5;07;783;Grand-Verly;137;0;137
32;Hauts-de-France;02;5;07;784;Petit-Verly;144;2;146
32;Hauts-de-France;02;3;13;785;Vermand;1101;31;1132
32;Hauts-de-France;02;2;20;786;Verneuil-sous-Coucy;126;2;128
32;Hauts-de-France;02;2;11;787;Verneuil-sur-Serre;260;2;262
32;Hauts-de-France;02;2;18;788;Versigny;462;7;469
32;Hauts-de-France;02;5;19;789;Vervins;2600;95;2695
32;Hauts-de-France;02;2;11;790;Vesles-et-Caumont;239;3;242
32;Hauts-de-France;02;2;10;791;Veslud;261;6;267
32;Hauts-de-France;02;1;04;792;Veuilly-la-Poterie;156;7;163
32;Hauts-de-France;02;4;20;793;Vézaponin;116;1;117
32;Hauts-de-France;02;1;05;794;Vézilly;187;8;195
32;Hauts-de-France;02;4;20;795;Vic-sur-Aisne;1604;19;1623
32;Hauts-de-France;02;1;21;796;Vichel-Nanteuil;86;2;88
32;Hauts-de-France;02;4;05;797;Viel-Arcy;172;0;172
32;Hauts-de-France;02;1;04;798;Viels-Maisons;1214;19;1233
32;Hauts-de-France;02;4;21;799;Vierzy;400;10;410
32;Hauts-de-France;02;1;04;800;Viffort;313;5;318
32;Hauts-de-France;02;5;19;801;Vigneux-Hocquet;270;6;276
32;Hauts-de-France;02;5;19;802;La Ville-aux-Bois-lès-Dizy;208;2;210
32;Hauts-de-France;02;2;06;803;La Ville-aux-Bois-lès-Pontavert;145;5;150
32;Hauts-de-France;02;4;21;804;Villemontoire;191;5;196
32;Hauts-de-France;02;4;16;805;Villeneuve-Saint-Germain;2549;42;2591
32;Hauts-de-France;02;1;02;806;Villeneuve-sur-Fère;300;5;305
32;Hauts-de-France;02;2;03;807;Villequier-Aumont;661;23;684
32;Hauts-de-France;02;3;01;808;Villeret;282;7;289
32;Hauts-de-France;02;1;05;809;Villers-Agron-Aiguizy;68;3;71
32;Hauts-de-France;02;4;21;810;Villers-Cotterêts;10392;411;10803
32;Hauts-de-France;02;4;21;812;Villers-Hélon;203;6;209
32;Hauts-de-France;02;3;12;813;Villers-le-Sec;245;7;252
32;Hauts-de-France;02;5;07;814;Villers-lès-Guise;161;0;161
32;Hauts-de-France;02;3;12;815;Villers-Saint-Christophe;427;15;442
32;Hauts-de-France;02;1;05;816;Villers-sur-Fère;535;6;541
32;Hauts-de-France;02;4;05;817;Ville-Savoye;82;1;83
32;Hauts-de-France;02;1;04;818;Villiers-Saint-Denis;1161;10;1171
32;Hauts-de-France;02;5;19;819;Vincy-Reuil-et-Magny;111;4;115
32;Hauts-de-France;02;2;03;820;Viry-Noureuil;1688;43;1731
32;Hauts-de-France;02;2;09;821;Vivaise;674;21;695
32;Hauts-de-France;02;4;21;822;Vivières;397;7;404
32;Hauts-de-France;02;5;11;823;Voharies;75;0;75
32;Hauts-de-France;02;2;10;824;Vorges;374;7;381
32;Hauts-de-France;02;5;11;826;Voulpaix;348;7;355
32;Hauts-de-France;02;2;11;827;Voyenne;306;4;310
32;Hauts-de-France;02;4;16;828;Vregny;92;0;92
32;Hauts-de-France;02;4;05;829;Vuillery;41;1;42
32;Hauts-de-France;02;5;07;830;Wassigny;959;16;975
32;Hauts-de-France;02;5;08;831;Watigny;378;6;384
32;Hauts-de-France;02;5;11;832;Wiège-Faty;186;5;191
32;Hauts-de-France;02;5;08;833;Wimy;493;7;500
32;Hauts-de-France;02;2;09;834;Wissignicourt;173;6;179
84;Auvergne-Rhône-Alpes;03;3;18;001;Abrest;2899;62;2961
84;Auvergne-Rhône-Alpes;03;2;16;002;Agonges;309;12;321
84;Auvergne-Rhône-Alpes;03;1;02;003;Ainay-le-Château;983;29;1012
84;Auvergne-Rhône-Alpes;03;3;08;004;Andelaroche;241;8;249
84;Auvergne-Rhône-Alpes;03;1;07;005;Archignat;337;4;341
84;Auvergne-Rhône-Alpes;03;3;08;006;Arfeuilles;629;17;646
84;Auvergne-Rhône-Alpes;03;1;11;007;Arpheuilles-Saint-Priest;356;7;363
84;Auvergne-Rhône-Alpes;03;3;08;008;Arronnes;376;9;385
84;Auvergne-Rhône-Alpes;03;2;13;009;Aubigny;136;34;170
84;Auvergne-Rhône-Alpes;03;1;07;010;Audes;419;9;428
84;Auvergne-Rhône-Alpes;03;2;19;011;Aurouër;425;9;434
84;Auvergne-Rhône-Alpes;03;2;16;012;Autry-Issards;316;5;321
84;Auvergne-Rhône-Alpes;03;2;13;013;Avermes;4012;97;4109
84;Auvergne-Rhône-Alpes;03;3;05;014;Avrilly;136;2;138
84;Auvergne-Rhône-Alpes;03;2;13;015;Bagneux;331;11;342
84;Auvergne-Rhône-Alpes;03;2;06;016;Barberier;142;2;144
84;Auvergne-Rhône-Alpes;03;3;08;017;Barrais-Bussolles;187;6;193
84;Auvergne-Rhône-Alpes;03;2;15;018;Bayet;680;14;694
84;Auvergne-Rhône-Alpes;03;2;05;019;Beaulon;1628;24;1652
84;Auvergne-Rhône-Alpes;03;1;03;020;Beaune-d'Allier;292;6;298
84;Auvergne-Rhône-Alpes;03;3;06;021;Bègues;222;2;224
84;Auvergne-Rhône-Alpes;03;3;06;022;Bellenaves;985;17;1002
84;Auvergne-Rhône-Alpes;03;3;01;023;Bellerive-sur-Allier;8844;236;9080
84;Auvergne-Rhône-Alpes;03;3;14;024;Bert;234;4;238
84;Auvergne-Rhône-Alpes;03;2;14;025;Bessay-sur-Allier;1347;21;1368
84;Auvergne-Rhône-Alpes;03;2;16;026;Besson;761;18;779
84;Auvergne-Rhône-Alpes;03;1;03;027;Bézenet;920;28;948
84;Auvergne-Rhône-Alpes;03;3;08;028;Billezois;362;8;370
84;Auvergne-Rhône-Alpes;03;3;15;029;Billy;796;16;812
84;Auvergne-Rhône-Alpes;03;3;06;030;Biozat;879;16;895
84;Auvergne-Rhône-Alpes;03;1;07;031;Bizeneuille;293;11;304
84;Auvergne-Rhône-Alpes;03;1;03;032;Blomard;243;1;244
84;Auvergne-Rhône-Alpes;03;3;04;033;Bost;181;4;185
84;Auvergne-Rhône-Alpes;03;3;15;034;Boucé;493;12;505
84;Auvergne-Rhône-Alpes;03;3;05;035;Le Bouchaud;206;3;209
84;Auvergne-Rhône-Alpes;03;2;02;036;Bourbon-l'Archambault;2566;69;2635
84;Auvergne-Rhône-Alpes;03;1;02;037;Braize;260;2;262
84;Auvergne-Rhône-Alpes;03;2;16;038;Bransat;526;9;535
84;Auvergne-Rhône-Alpes;03;2;16;039;Bresnay;384;7;391
84;Auvergne-Rhône-Alpes;03;2;16;040;Bressolles;1132;38;1170
84;Auvergne-Rhône-Alpes;03;1;07;041;Le Brethon;321;8;329
84;Auvergne-Rhône-Alpes;03;3;08;042;Le Breuil;531;11;542
84;Auvergne-Rhône-Alpes;03;3;01;043;Broût-Vernet;1191;78;1269
84;Auvergne-Rhône-Alpes;03;3;01;044;Brugheas;1531;36;1567
84;Auvergne-Rhône-Alpes;03;3;08;045;Busset;833;18;851
84;Auvergne-Rhône-Alpes;03;2;02;046;Buxières-les-Mines;1010;24;1034
84;Auvergne-Rhône-Alpes;03;1;11;047;La Celle;405;7;412
84;Auvergne-Rhône-Alpes;03;1;02;048;Cérilly;1305;23;1328
84;Auvergne-Rhône-Alpes;03;2;16;049;Cesset;427;10;437
84;Auvergne-Rhône-Alpes;03;3;08;050;La Chabanne;177;9;186
84;Auvergne-Rhône-Alpes;03;1;07;051;Chambérat;294;8;302
84;Auvergne-Rhône-Alpes;03;1;03;052;Chamblet;1090;26;1116
84;Auvergne-Rhône-Alpes;03;2;06;053;Chantelle;1105;26;1131
84;Auvergne-Rhône-Alpes;03;2;14;054;Chapeau;237;7;244
84;Auvergne-Rhône-Alpes;03;1;07;055;La Chapelaude;945;15;960
84;Auvergne-Rhône-Alpes;03;3;08;056;La Chapelle;388;7;395
84;Auvergne-Rhône-Alpes;03;2;05;057;La Chapelle-aux-Chasses;196;6;202
84;Auvergne-Rhône-Alpes;03;1;03;058;Chappes;240;7;247
84;Auvergne-Rhône-Alpes;03;2;06;059;Chareil-Cintrat;367;8;375
84;Auvergne-Rhône-Alpes;03;3;17;060;Charmeil;1039;17;1056
84;Auvergne-Rhône-Alpes;03;3;06;061;Charmes;387;10;397
84;Auvergne-Rhône-Alpes;03;2;06;062;Charroux;346;17;363
84;Auvergne-Rhône-Alpes;03;2;05;063;Chassenard;1030;20;1050
84;Auvergne-Rhône-Alpes;03;2;02;064;Château-sur-Allier;175;4;179
84;Auvergne-Rhône-Alpes;03;2;16;065;Châtel-de-Neuvre;546;9;555
84;Auvergne-Rhône-Alpes;03;3;08;066;Châtel-Montagne;321;5;326
84;Auvergne-Rhône-Alpes;03;3;14;067;Châtelperron;134;4;138
84;Auvergne-Rhône-Alpes;03;3;08;068;Châtelus;103;1;104
84;Auvergne-Rhône-Alpes;03;2;16;069;Châtillon;311;6;317
84;Auvergne-Rhône-Alpes;03;1;03;070;Chavenon;135;4;139
84;Auvergne-Rhône-Alpes;03;3;14;071;Chavroches;250;4;254
84;Auvergne-Rhône-Alpes;03;1;07;072;Chazemais;495;10;505
84;Auvergne-Rhône-Alpes;03;2;16;073;Chemilly;621;12;633
84;Auvergne-Rhône-Alpes;03;2;05;074;Chevagnes;648;15;663
84;Auvergne-Rhône-Alpes;03;3;06;075;Chezelle;164;2;166
84;Auvergne-Rhône-Alpes;03;2;05;076;Chézy;219;7;226
84;Auvergne-Rhône-Alpes;03;3;06;077;Chirat-l'Église;128;2;130
84;Auvergne-Rhône-Alpes;03;3;06;078;Chouvigny;229;8;237
84;Auvergne-Rhône-Alpes;03;3;14;079;Cindré;296;4;300
84;Auvergne-Rhône-Alpes;03;3;01;080;Cognat-Lyonne;702;11;713
84;Auvergne-Rhône-Alpes;03;1;03;081;Colombier;323;13;336
84;Auvergne-Rhône-Alpes;03;1;03;082;Commentry;6100;185;6285
84;Auvergne-Rhône-Alpes;03;2;16;083;Contigny;575;12;587
84;Auvergne-Rhône-Alpes;03;1;07;084;Cosne-d'Allier;2031;29;2060
84;Auvergne-Rhône-Alpes;03;2;13;085;Coulandon;641;54;695
84;Auvergne-Rhône-Alpes;03;2;05;086;Coulanges;305;8;313
84;Auvergne-Rhône-Alpes;03;2;02;087;Couleuvre;597;6;603
84;Auvergne-Rhône-Alpes;03;1;07;088;Courçais;316;4;320
84;Auvergne-Rhône-Alpes;03;3;06;089;Coutansouze;154;7;161
84;Auvergne-Rhône-Alpes;03;2;02;090;Couzon;307;7;314
84;Auvergne-Rhône-Alpes;03;3;15;091;Créchy;436;9;445
84;Auvergne-Rhône-Alpes;03;2;16;092;Cressanges;629;14;643
84;Auvergne-Rhône-Alpes;03;3;04;093;Creuzier-le-Neuf;1219;28;1247
84;Auvergne-Rhône-Alpes;03;3;04;094;Creuzier-le-Vieux;3283;102;3385
84;Auvergne-Rhône-Alpes;03;3;04;095;Cusset;12677;477;13154
84;Auvergne-Rhône-Alpes;03;2;06;096;Deneuille-lès-Chantelle;89;1;90
84;Auvergne-Rhône-Alpes;03;1;03;097;Deneuille-les-Mines;359;9;368
84;Auvergne-Rhône-Alpes;03;1;10;098;Désertines;4465;100;4565
84;Auvergne-Rhône-Alpes;03;2;16;099;Deux-Chaises;388;12;400
84;Auvergne-Rhône-Alpes;03;2;05;100;Diou;1373;35;1408
84;Auvergne-Rhône-Alpes;03;1;09;101;Domérat;8698;173;8871
84;Auvergne-Rhône-Alpes;03;2;05;102;Dompierre-sur-Besbre;3010;52;3062
84;Auvergne-Rhône-Alpes;03;3;05;103;Le Donjon;1046;16;1062
84;Auvergne-Rhône-Alpes;03;1;03;104;Doyet;1167;34;1201
84;Auvergne-Rhône-Alpes;03;3;08;105;Droiturier;360;7;367
84;Auvergne-Rhône-Alpes;03;1;11;106;Durdat-Larequille;1317;103;1420
84;Auvergne-Rhône-Alpes;03;3;06;107;Ébreuil;1269;27;1296
84;Auvergne-Rhône-Alpes;03;3;06;108;Échassières;373;6;379
84;Auvergne-Rhône-Alpes;03;3;01;109;Escurolles;788;34;822
84;Auvergne-Rhône-Alpes;03;3;01;110;Espinasse-Vozelle;977;26;1003
84;Auvergne-Rhône-Alpes;03;1;07;111;Estivareilles;1117;24;1141
84;Auvergne-Rhône-Alpes;03;2;06;112;Étroussat;665;9;674
84;Auvergne-Rhône-Alpes;03;3;08;113;Ferrières-sur-Sichon;527;16;543
84;Auvergne-Rhône-Alpes;03;2;14;114;La Ferté-Hauterive;271;7;278
84;Auvergne-Rhône-Alpes;03;2;06;115;Fleuriel;344;6;350
84;Auvergne-Rhône-Alpes;03;2;06;116;Fourilles;188;5;193
84;Auvergne-Rhône-Alpes;03;2;02;117;Franchesse;479;12;491
84;Auvergne-Rhône-Alpes;03;3;06;118;Gannat;5815;197;6012
84;Auvergne-Rhône-Alpes;03;2;05;119;Gannay-sur-Loire;414;4;418
84;Auvergne-Rhône-Alpes;03;2;05;120;Garnat-sur-Engièvre;711;13;724
84;Auvergne-Rhône-Alpes;03;2;19;121;Gennetines;636;17;653
84;Auvergne-Rhône-Alpes;03;2;16;122;Gipcy;235;5;240
84;Auvergne-Rhône-Alpes;03;2;14;124;Gouise;219;4;223
84;Auvergne-Rhône-Alpes;03;3;08;125;La Guillermie;122;2;124
84;Auvergne-Rhône-Alpes;03;3;01;126;Hauterive;1176;14;1190
84;Auvergne-Rhône-Alpes;03;1;07;127;Hérisson;601;15;616
84;Auvergne-Rhône-Alpes;03;1;07;128;Huriel;2632;56;2688
84;Auvergne-Rhône-Alpes;03;1;03;129;Hyds;308;12;320
84;Auvergne-Rhône-Alpes;03;1;02;130;Isle-et-Bardais;280;6;286
84;Auvergne-Rhône-Alpes;03;3;08;131;Isserpent;553;12;565
84;Auvergne-Rhône-Alpes;03;3;14;132;Jaligny-sur-Besbre;554;16;570
84;Auvergne-Rhône-Alpes;03;3;06;133;Jenzat;524;10;534
84;Auvergne-Rhône-Alpes;03;2;16;134;Laféline;193;1;194
84;Auvergne-Rhône-Alpes;03;3;06;135;Lalizolle;412;9;421
84;Auvergne-Rhône-Alpes;03;1;12;136;Lamaids;225;9;234
84;Auvergne-Rhône-Alpes;03;3;15;137;Langy;270;6;276
84;Auvergne-Rhône-Alpes;03;3;08;138;Lapalisse;3137;73;3210
84;Auvergne-Rhône-Alpes;03;3;08;139;Laprugne;314;11;325
84;Auvergne-Rhône-Alpes;03;1;12;140;Lavault-Sainte-Anne;1147;14;1161
84;Auvergne-Rhône-Alpes;03;3;08;141;Lavoine;149;2;151
84;Auvergne-Rhône-Alpes;03;3;05;142;Lenax;242;4;246
84;Auvergne-Rhône-Alpes;03;1;02;143;Lételon;91;3;94
84;Auvergne-Rhône-Alpes;03;3;14;144;Liernolles;210;7;217
84;Auvergne-Rhône-Alpes;03;1;12;145;Lignerolles;743;12;755
84;Auvergne-Rhône-Alpes;03;2;02;146;Limoise;168;28;196
84;Auvergne-Rhône-Alpes;03;3;05;147;Loddes;167;2;169
84;Auvergne-Rhône-Alpes;03;2;15;148;Loriges;348;5;353
84;Auvergne-Rhône-Alpes;03;2;15;149;Louchy-Montfand;429;11;440
84;Auvergne-Rhône-Alpes;03;1;07;150;Louroux-Bourbonnais;202;5;207
84;Auvergne-Rhône-Alpes;03;1;03;151;Louroux-de-Beaune;157;4;161
84;Auvergne-Rhône-Alpes;03;3;06;152;Louroux-de-Bouble;230;5;235
84;Auvergne-Rhône-Alpes;03;3;05;154;Luneau;273;3;276
84;Auvergne-Rhône-Alpes;03;2;02;155;Lurcy-Lévis;1881;42;1923
84;Auvergne-Rhône-Alpes;03;2;05;156;Lusigny;1670;52;1722
84;Auvergne-Rhône-Alpes;03;3;15;157;Magnet;1035;23;1058
84;Auvergne-Rhône-Alpes;03;1;07;158;Haut-Bocage;860;15;875
84;Auvergne-Rhône-Alpes;03;1;03;159;Malicorne;776;14;790
84;Auvergne-Rhône-Alpes;03;2;15;160;Marcenat;412;4;416
84;Auvergne-Rhône-Alpes;03;1;11;161;Marcillat-en-Combraille;902;25;927
84;Auvergne-Rhône-Alpes;03;2;16;162;Marigny;201;6;207
84;Auvergne-Rhône-Alpes;03;3;08;163;Mariol;729;21;750
84;Auvergne-Rhône-Alpes;03;3;06;164;Le Mayet-d'École;283;3;286
84;Auvergne-Rhône-Alpes;03;3;08;165;Le Mayet-de-Montagne;1386;86;1472
84;Auvergne-Rhône-Alpes;03;3;06;166;Mazerier;308;5;313
84;Auvergne-Rhône-Alpes;03;1;11;167;Mazirat;287;4;291
84;Auvergne-Rhône-Alpes;03;1;02;168;Meaulne-Vitray;908;13;921
84;Auvergne-Rhône-Alpes;03;2;16;169;Meillard;323;6;329
84;Auvergne-Rhône-Alpes;03;2;16;170;Meillers;125;6;131
84;Auvergne-Rhône-Alpes;03;2;14;171;Mercy;243;6;249
84;Auvergne-Rhône-Alpes;03;1;07;172;Mesples;122;2;124
84;Auvergne-Rhône-Alpes;03;2;05;173;Molinet;1144;32;1176
84;Auvergne-Rhône-Alpes;03;3;08;174;Molles;924;25;949
84;Auvergne-Rhône-Alpes;03;3;06;175;Monestier;277;11;288
84;Auvergne-Rhône-Alpes;03;2;16;176;Monétay-sur-Allier;542;10;552
84;Auvergne-Rhône-Alpes;03;2;05;177;Monétay-sur-Loire;247;5;252
84;Auvergne-Rhône-Alpes;03;3;05;178;Montaiguët-en-Forez;290;6;296
84;Auvergne-Rhône-Alpes;03;3;15;179;Montaigu-le-Blin;298;4;302
84;Auvergne-Rhône-Alpes;03;2;14;180;Montbeugny;654;11;665
84;Auvergne-Rhône-Alpes;03;3;05;181;Montcombroux-les-Mines;295;2;297
84;Auvergne-Rhône-Alpes;03;3;06;182;Monteignet-sur-l'Andelot;262;1;263
84;Auvergne-Rhône-Alpes;03;2;16;183;Le Montet;469;4;473
84;Auvergne-Rhône-Alpes;03;2;13;184;Montilly;504;8;512
84;Auvergne-Rhône-Alpes;03;1;97;185;Montluçon;33822;1046;34868
84;Auvergne-Rhône-Alpes;03;1;03;186;Montmarault;1523;18;1541
84;Auvergne-Rhône-Alpes;03;3;15;187;Montoldre;625;9;634
84;Auvergne-Rhône-Alpes;03;2;15;188;Montord;216;4;220
84;Auvergne-Rhône-Alpes;03;1;03;189;Montvicq;709;25;734
84;Auvergne-Rhône-Alpes;03;2;98;190;Moulins;19444;553;19997
84;Auvergne-Rhône-Alpes;03;1;03;191;Murat;272;8;280
84;Auvergne-Rhône-Alpes;03;3;06;192;Nades;150;3;153
84;Auvergne-Rhône-Alpes;03;1;07;193;Nassigny;191;4;195
84;Auvergne-Rhône-Alpes;03;3;06;194;Naves;125;2;127
84;Auvergne-Rhône-Alpes;03;1;11;195;Néris-les-Bains;2588;98;2686
84;Auvergne-Rhône-Alpes;03;3;05;196;Neuilly-en-Donjon;213;5;218
84;Auvergne-Rhône-Alpes;03;2;14;197;Neuilly-le-Réal;1452;30;1482
84;Auvergne-Rhône-Alpes;03;2;02;198;Neure;192;3;195
84;Auvergne-Rhône-Alpes;03;2;13;200;Neuvy;1493;259;1752
84;Auvergne-Rhône-Alpes;03;3;08;201;Nizerolles;301;13;314
84;Auvergne-Rhône-Alpes;03;2;16;202;Noyant-d'Allier;593;15;608
84;Auvergne-Rhône-Alpes;03;2;05;203;Paray-le-Frésil;385;8;393
84;Auvergne-Rhône-Alpes;03;2;15;204;Paray-sous-Briailles;618;16;634
84;Auvergne-Rhône-Alpes;03;3;08;205;Périgny;438;11;449
84;Auvergne-Rhône-Alpes;03;1;11;206;La Petite-Marche;162;6;168
84;Auvergne-Rhône-Alpes;03;2;05;207;Pierrefitte-sur-Loire;514;13;527
84;Auvergne-Rhône-Alpes;03;3;05;208;Le Pin;425;8;433
84;Auvergne-Rhône-Alpes;03;3;06;209;Poëzat;151;3;154
84;Auvergne-Rhône-Alpes;03;2;02;210;Pouzy-Mésangy;394;4;398
84;Auvergne-Rhône-Alpes;03;1;12;211;Prémilhat;2506;47;2553
84;Auvergne-Rhône-Alpes;03;1;12;212;Quinssaines;1527;25;1552
84;Auvergne-Rhône-Alpes;03;1;07;213;Reugny;253;4;257
84;Auvergne-Rhône-Alpes;03;2;16;214;Rocles;365;5;370
84;Auvergne-Rhône-Alpes;03;3;15;215;Rongères;543;8;551
84;Auvergne-Rhône-Alpes;03;1;11;216;Ronnet;173;2;175
84;Auvergne-Rhône-Alpes;03;1;03;217;Saint-Angel;761;34;795
84;Auvergne-Rhône-Alpes;03;2;02;218;Saint-Aubin-le-Monial;270;8;278
84;Auvergne-Rhône-Alpes;03;1;03;219;Saint-Bonnet-de-Four;215;3;218
84;Auvergne-Rhône-Alpes;03;3;06;220;Saint-Bonnet-de-Rochefort;717;16;733
84;Auvergne-Rhône-Alpes;03;1;02;221;Saint-Bonnet-Tronçais;732;8;740
84;Auvergne-Rhône-Alpes;03;1;07;222;Saint-Caprais;89;5;94
84;Auvergne-Rhône-Alpes;03;3;08;223;Saint-Christophe;437;14;451
84;Auvergne-Rhône-Alpes;03;3;08;224;Saint-Clément;285;7;292
84;Auvergne-Rhône-Alpes;03;1;07;225;Saint-Désiré;441;9;450
84;Auvergne-Rhône-Alpes;03;3;05;226;Saint-Didier-en-Donjon;248;4;252
84;Auvergne-Rhône-Alpes;03;3;01;227;Saint-Didier-la-Forêt;374;7;381
84;Auvergne-Rhône-Alpes;03;1;07;228;Saint-Éloy-d'Allier;44;0;44
84;Auvergne-Rhône-Alpes;03;2;19;229;Saint-Ennemond;605;16;621
84;Auvergne-Rhône-Alpes;03;3;08;230;Saint-Étienne-de-Vicq;526;5;531
84;Auvergne-Rhône-Alpes;03;1;11;231;Saint-Fargeol;188;9;197
84;Auvergne-Rhône-Alpes;03;3;15;232;Saint-Félix;298;9;307
84;Auvergne-Rhône-Alpes;03;1;11;233;Saint-Genest;389;7;396
84;Auvergne-Rhône-Alpes;03;2;14;234;Saint-Gérand-de-Vaux;368;11;379
84;Auvergne-Rhône-Alpes;03;3;15;235;Saint-Gérand-le-Puy;964;10;974
84;Auvergne-Rhône-Alpes;03;3;17;236;Saint-Germain-des-Fossés;3653;70;3723
84;Auvergne-Rhône-Alpes;03;2;06;237;Saint-Germain-de-Salles;426;8;434
84;Auvergne-Rhône-Alpes;03;2;02;238;Saint-Hilaire;522;9;531
84;Auvergne-Rhône-Alpes;03;3;05;239;Saint-Léger-sur-Vouzance;263;12;275
84;Auvergne-Rhône-Alpes;03;3;14;240;Saint-Léon;539;10;549
84;Auvergne-Rhône-Alpes;03;2;02;241;Saint-Léopardin-d'Augy;368;45;413
84;Auvergne-Rhône-Alpes;03;3;15;242;Saint-Loup;565;13;578
84;Auvergne-Rhône-Alpes;03;1;03;243;Saint-Marcel-en-Murat;124;2;126
84;Auvergne-Rhône-Alpes;03;1;11;244;Saint-Marcel-en-Marcillat;127;1;128
84;Auvergne-Rhône-Alpes;03;2;05;245;Saint-Martin-des-Lais;124;1;125
84;Auvergne-Rhône-Alpes;03;1;07;246;Saint-Martinien;592;12;604
84;Auvergne-Rhône-Alpes;03;2;16;247;Saint-Menoux;1119;33;1152
84;Auvergne-Rhône-Alpes;03;3;08;248;Saint-Nicolas-des-Biefs;163;2;165
84;Auvergne-Rhône-Alpes;03;1;07;249;Saint-Palais;161;3;164
84;Auvergne-Rhône-Alpes;03;3;08;250;Saint-Pierre-Laval;347;7;354
84;Auvergne-Rhône-Alpes;03;2;02;251;Saint-Plaisir;392;6;398
84;Auvergne-Rhône-Alpes;03;3;01;252;Saint-Pont;698;17;715
84;Auvergne-Rhône-Alpes;03;2;05;253;Saint-Pourçain-sur-Besbre;374;10;384
84;Auvergne-Rhône-Alpes;03;2;15;254;Saint-Pourçain-sur-Sioule;5100;121;5221
84;Auvergne-Rhône-Alpes;03;3;06;255;Saint-Priest-d'Andelot;144;3;147
84;Auvergne-Rhône-Alpes;03;1;03;256;Saint-Priest-en-Murat;209;5;214
84;Auvergne-Rhône-Alpes;03;3;08;257;Saint-Prix;801;22;823
84;Auvergne-Rhône-Alpes;03;3;17;258;Saint-Rémy-en-Rollat;1758;25;1783
84;Auvergne-Rhône-Alpes;03;1;07;259;Saint-Sauvier;333;3;336
84;Auvergne-Rhône-Alpes;03;2;16;260;Saint-Sornin;223;6;229
84;Auvergne-Rhône-Alpes;03;1;11;261;Sainte-Thérence;178;7;185
84;Auvergne-Rhône-Alpes;03;1;09;262;Saint-Victor;2097;37;2134
84;Auvergne-Rhône-Alpes;03;2;14;263;Saint-Voir;197;9;206
84;Auvergne-Rhône-Alpes;03;3;18;264;Saint-Yorre;2554;56;2610
84;Auvergne-Rhône-Alpes;03;2;05;265;Saligny-sur-Roudon;665;79;744
84;Auvergne-Rhône-Alpes;03;3;15;266;Sanssat;278;8;286
84;Auvergne-Rhône-Alpes;03;2;15;267;Saulcet;658;22;680
84;Auvergne-Rhône-Alpes;03;3;06;268;Saulzet;386;3;389
84;Auvergne-Rhône-Alpes;03;1;07;269;Sauvagny;84;3;87
84;Auvergne-Rhône-Alpes;03;1;03;270;Sazeret;142;2;144
84;Auvergne-Rhône-Alpes;03;3;01;271;Serbannes;805;32;837
84;Auvergne-Rhône-Alpes;03;3;08;272;Servilly;275;7;282
84;Auvergne-Rhône-Alpes;03;3;15;273;Seuillet;484;15;499
84;Auvergne-Rhône-Alpes;03;3;14;274;Sorbier;318;6;324
84;Auvergne-Rhône-Alpes;03;2;16;275;Souvigny;1736;50;1786
84;Auvergne-Rhône-Alpes;03;3;06;276;Sussat;103;6;109
84;Auvergne-Rhône-Alpes;03;3;06;277;Target;254;4;258
84;Auvergne-Rhône-Alpes;03;2;06;278;Taxat-Senat;189;4;193
84;Auvergne-Rhône-Alpes;03;1;12;279;Teillet-Argenty;555;8;563
84;Auvergne-Rhône-Alpes;03;1;11;280;Terjat;181;9;190
84;Auvergne-Rhône-Alpes;03;2;16;281;Le Theil;389;3;392
84;Auvergne-Rhône-Alpes;03;1;02;282;Theneuille;360;6;366
84;Auvergne-Rhône-Alpes;03;2;05;283;Thiel-sur-Acolin;1035;19;1054
84;Auvergne-Rhône-Alpes;03;3;14;284;Thionne;288;9;297
84;Auvergne-Rhône-Alpes;03;1;07;285;Tortezais;180;9;189
84;Auvergne-Rhône-Alpes;03;2;14;286;Toulon-sur-Allier;1140;20;1160
84;Auvergne-Rhône-Alpes;03;2;16;287;Treban;381;8;389
84;Auvergne-Rhône-Alpes;03;1;07;288;Treignat;379;8;387
84;Auvergne-Rhône-Alpes;03;3;14;289;Treteau;510;11;521
84;Auvergne-Rhône-Alpes;03;2;19;290;Trévol;1634;56;1690
84;Auvergne-Rhône-Alpes;03;3;14;291;Trézelles;407;13;420
84;Auvergne-Rhône-Alpes;03;2;16;292;Tronget;883;9;892
84;Auvergne-Rhône-Alpes;03;1;02;293;Urçay;293;10;303
84;Auvergne-Rhône-Alpes;03;2;06;294;Ussel-d'Allier;169;1;170
84;Auvergne-Rhône-Alpes;03;3;06;295;Valignat;72;1;73
84;Auvergne-Rhône-Alpes;03;1;02;296;Valigny;373;12;385
84;Auvergne-Rhône-Alpes;03;1;07;297;Vallon-en-Sully;1514;28;1542
84;Auvergne-Rhône-Alpes;03;3;15;298;Varennes-sur-Allier;3642;71;3713
84;Auvergne-Rhône-Alpes;03;3;14;299;Varennes-sur-Tèche;225;8;233
84;Auvergne-Rhône-Alpes;03;2;05;300;Vaumas;535;12;547
84;Auvergne-Rhône-Alpes;03;1;09;301;Vaux;1163;25;1188
84;Auvergne-Rhône-Alpes;03;3;06;302;Veauce;38;1;39
84;Auvergne-Rhône-Alpes;03;1;07;303;Venas;237;10;247
84;Auvergne-Rhône-Alpes;03;3;01;304;Vendat;2262;61;2323
84;Auvergne-Rhône-Alpes;03;1;03;305;Verneix;587;12;599
84;Auvergne-Rhône-Alpes;03;3;08;306;Le Vernet;1906;51;1957
84;Auvergne-Rhône-Alpes;03;2;16;307;Verneuil-en-Bourbonnais;236;3;239
84;Auvergne-Rhône-Alpes;03;1;03;308;Vernusse;152;2;154
84;Auvergne-Rhône-Alpes;03;2;02;309;Le Veurdre;452;4;456
84;Auvergne-Rhône-Alpes;03;3;99;310;Vichy;25372;308;25680
84;Auvergne-Rhône-Alpes;03;3;06;311;Vicq;297;7;304
84;Auvergne-Rhône-Alpes;03;2;02;312;Vieure;272;11;283
84;Auvergne-Rhône-Alpes;03;1;02;313;Le Vilhain;276;8;284
84;Auvergne-Rhône-Alpes;03;1;11;314;Villebret;1330;36;1366
84;Auvergne-Rhône-Alpes;03;1;03;315;Villefranche-d'Allier;1282;39;1321
84;Auvergne-Rhône-Alpes;03;2;19;316;Villeneuve-sur-Allier;1074;16;1090
84;Auvergne-Rhône-Alpes;03;1;07;317;Viplaix;291;7;298
84;Auvergne-Rhône-Alpes;03;2;06;319;Voussac;489;10;499
84;Auvergne-Rhône-Alpes;03;2;02;320;Ygrande;777;16;793
84;Auvergne-Rhône-Alpes;03;2;19;321;Yzeure;12701;523;13224
93;Provence-Alpes-Côte d'Azur;04;3;05;001;Aiglun;1420;28;1448
93;Provence-Alpes-Côte d'Azur;04;4;15;004;Allemagne-en-Provence;544;14;558
93;Provence-Alpes-Côte d'Azur;04;2;02;005;Allons;128;3;131
93;Provence-Alpes-Côte d'Azur;04;2;02;006;Allos;837;8;845
93;Provence-Alpes-Côte d'Azur;04;2;02;007;Angles;67;0;67
93;Provence-Alpes-Côte d'Azur;04;2;02;008;Annot;1021;35;1056
93;Provence-Alpes-Côte d'Azur;04;3;13;009;Archail;14;0;14
93;Provence-Alpes-Côte d'Azur;04;4;11;012;Aubenas-les-Alpes;91;1;92
93;Provence-Alpes-Côte d'Azur;04;4;03;013;Aubignosc;616;15;631
93;Provence-Alpes-Côte d'Azur;04;4;14;016;Authon;63;0;63
93;Provence-Alpes-Côte d'Azur;04;3;13;017;Auzet;101;5;106
93;Provence-Alpes-Côte d'Azur;04;4;11;018;Banon;1057;17;1074
93;Provence-Alpes-Côte d'Azur;04;1;01;019;Barcelonnette;2561;199;2760
93;Provence-Alpes-Côte d'Azur;04;3;13;020;Barles;132;2;134
93;Provence-Alpes-Côte d'Azur;04;3;05;021;Barras;146;4;150
93;Provence-Alpes-Côte d'Azur;04;2;12;022;Barrême;410;8;418
93;Provence-Alpes-Côte d'Azur;04;4;13;023;Bayons;193;4;197
93;Provence-Alpes-Côte d'Azur;04;3;13;024;Beaujeu;125;3;128
93;Provence-Alpes-Côte d'Azur;04;2;02;025;Beauvezer;392;14;406
93;Provence-Alpes-Côte d'Azur;04;4;13;026;Bellaffaire;143;2;145
93;Provence-Alpes-Côte d'Azur;04;4;14;027;Bevons;253;53;306
93;Provence-Alpes-Côte d'Azur;04;3;12;028;Beynes;121;1;122
93;Provence-Alpes-Côte d'Azur;04;2;12;030;Blieux;55;0;55
93;Provence-Alpes-Côte d'Azur;04;3;12;031;Bras-d'Asse;554;11;565
93;Provence-Alpes-Côte d'Azur;04;2;02;032;Braux;127;0;127
93;Provence-Alpes-Côte d'Azur;04;1;01;033;Ubaye-Serre-Ponçon;782;18;800
93;Provence-Alpes-Côte d'Azur;04;4;06;034;La Brillanne;1117;15;1132
93;Provence-Alpes-Côte d'Azur;04;4;15;035;Brunet;289;6;295
93;Provence-Alpes-Côte d'Azur;04;3;13;036;Le Brusquet;966;30;996
93;Provence-Alpes-Côte d'Azur;04;4;13;037;Le Caire;74;2;76
93;Provence-Alpes-Côte d'Azur;04;2;02;039;Castellane;1462;40;1502
93;Provence-Alpes-Côte d'Azur;04;3;04;040;Le Castellard-Mélan;62;1;63
93;Provence-Alpes-Côte d'Azur;04;4;12;041;Le Castellet;298;6;304
93;Provence-Alpes-Côte d'Azur;04;2;02;042;Castellet-lès-Sausses;138;1;139
93;Provence-Alpes-Côte d'Azur;04;2;02;043;Val-de-Chalvagne;85;3;88
93;Provence-Alpes-Côte d'Azur;04;4;11;045;Céreste;1198;23;1221
93;Provence-Alpes-Côte d'Azur;04;3;12;046;Le Chaffaut-Saint-Jurson;688;103;791
93;Provence-Alpes-Côte d'Azur;04;3;05;047;Champtercier;856;21;877
93;Provence-Alpes-Côte d'Azur;04;3;03;049;Château-Arnoux-Saint-Auban;5063;109;5172
93;Provence-Alpes-Côte d'Azur;04;4;13;050;Châteaufort;26;0;26
93;Provence-Alpes-Côte d'Azur;04;4;14;051;Châteauneuf-Miravail;73;2;75
93;Provence-Alpes-Côte d'Azur;04;4;03;053;Châteauneuf-Val-Saint-Donat;502;12;514
93;Provence-Alpes-Côte d'Azur;04;3;12;054;Châteauredon;73;1;74
93;Provence-Alpes-Côte d'Azur;04;2;12;055;Chaudon-Norante;190;0;190
93;Provence-Alpes-Côte d'Azur;04;4;13;057;Clamensane;178;3;181
93;Provence-Alpes-Côte d'Azur;04;4;13;058;Claret;280;5;285
93;Provence-Alpes-Côte d'Azur;04;2;12;059;Clumanc;221;3;224
93;Provence-Alpes-Côte d'Azur;04;2;02;061;Colmars;479;5;484
93;Provence-Alpes-Côte d'Azur;04;1;01;062;La Condamine-Châtelard;151;3;154
93;Provence-Alpes-Côte d'Azur;04;4;09;063;Corbières-en-Provence;1241;36;1277
93;Provence-Alpes-Côte d'Azur;04;4;06;065;Cruis;627;6;633
93;Provence-Alpes-Côte d'Azur;04;4;13;066;Curbans;576;12;588
93;Provence-Alpes-Côte d'Azur;04;4;14;067;Curel;51;1;52
93;Provence-Alpes-Côte d'Azur;04;4;11;068;Dauphin;839;13;852
93;Provence-Alpes-Côte d'Azur;04;2;02;069;Demandolx;127;5;132
93;Provence-Alpes-Côte d'Azur;04;3;98;070;Digne-les-Bains;16864;940;17804
93;Provence-Alpes-Côte d'Azur;04;3;13;072;Draix;111;2;113
93;Provence-Alpes-Côte d'Azur;04;1;01;073;Enchastrayes;385;12;397
93;Provence-Alpes-Côte d'Azur;04;3;04;074;Entrages;100;2;102
93;Provence-Alpes-Côte d'Azur;04;4;14;075;Entrepierres;384;9;393
93;Provence-Alpes-Côte d'Azur;04;2;02;076;Entrevaux;810;21;831
93;Provence-Alpes-Côte d'Azur;04;4;12;077;Entrevennes;171;3;174
93;Provence-Alpes-Côte d'Azur;04;3;03;079;L'Escale;1378;36;1414
93;Provence-Alpes-Côte d'Azur;04;4;15;081;Esparron-de-Verdon;389;4;393
93;Provence-Alpes-Côte d'Azur;04;3;12;084;Estoublon;487;7;494
93;Provence-Alpes-Côte d'Azur;04;4;13;085;Faucon-du-Caire;59;2;61
93;Provence-Alpes-Côte d'Azur;04;1;01;086;Faucon-de-Barcelonnette;295;16;311
93;Provence-Alpes-Côte d'Azur;04;4;06;087;Fontienne;135;2;137
93;Provence-Alpes-Côte d'Azur;04;4;06;088;Forcalquier;5115;95;5210
93;Provence-Alpes-Côte d'Azur;04;2;02;090;Le Fugeret;206;4;210
93;Provence-Alpes-Côte d'Azur;04;3;03;091;Ganagobie;92;0;92
93;Provence-Alpes-Côte d'Azur;04;2;02;092;La Garde;121;4;125
93;Provence-Alpes-Côte d'Azur;04;4;13;093;Gigors;60;1;61
93;Provence-Alpes-Côte d'Azur;04;4;15;094;Gréoux-les-Bains;2790;35;2825
93;Provence-Alpes-Côte d'Azur;04;4;11;095;L'Hospitalet;90;0;90
93;Provence-Alpes-Côte d'Azur;04;1;01;096;Jausiers;1137;26;1163
93;Provence-Alpes-Côte d'Azur;04;3;13;097;La Javie;375;5;380
93;Provence-Alpes-Côte d'Azur;04;2;02;099;Lambruisse;85;5;90
93;Provence-Alpes-Côte d'Azur;04;4;06;101;Lardiers;132;3;135
93;Provence-Alpes-Côte d'Azur;04;1;01;102;Le Lauzet-Ubaye;178;3;181
93;Provence-Alpes-Côte d'Azur;04;4;06;104;Limans;390;11;401
93;Provence-Alpes-Côte d'Azur;04;4;06;106;Lurs;378;9;387
93;Provence-Alpes-Côte d'Azur;04;3;12;107;Majastres;4;0;4
93;Provence-Alpes-Côte d'Azur;04;3;05;108;Malijai;1984;31;2015
93;Provence-Alpes-Côte d'Azur;04;3;06;109;Mallefougasse-Augès;325;4;329
93;Provence-Alpes-Côte d'Azur;04;3;05;110;Mallemoisson;994;28;1022
93;Provence-Alpes-Côte d'Azur;04;4;11;111;Mane;1349;31;1380
93;Provence-Alpes-Côte d'Azur;04;4;99;112;Manosque;23018;671;23689
93;Provence-Alpes-Côte d'Azur;04;3;04;113;Marcoux;449;14;463
93;Provence-Alpes-Côte d'Azur;04;2;02;115;Méailles;120;2;122
93;Provence-Alpes-Côte d'Azur;04;3;10;116;Les Mées;3766;47;3813
93;Provence-Alpes-Côte d'Azur;04;4;13;118;Melve;123;1;124
93;Provence-Alpes-Côte d'Azur;04;1;01;120;Val d'Oronaye;117;1;118
93;Provence-Alpes-Côte d'Azur;04;3;12;121;Mézel;631;11;642
93;Provence-Alpes-Côte d'Azur;04;3;05;122;Mirabeau;512;11;523
93;Provence-Alpes-Côte d'Azur;04;4;14;123;Mison;1118;30;1148
93;Provence-Alpes-Côte d'Azur;04;4;15;124;Montagnac-Montpezat;413;7;420
93;Provence-Alpes-Côte d'Azur;04;3;13;126;Montclar;403;15;418
93;Provence-Alpes-Côte d'Azur;04;4;03;127;Montfort;325;4;329
93;Provence-Alpes-Côte d'Azur;04;4;07;128;Montfuron;226;9;235
93;Provence-Alpes-Côte d'Azur;04;4;11;129;Montjustin;59;1;60
93;Provence-Alpes-Côte d'Azur;04;4;06;130;Montlaux;207;2;209
93;Provence-Alpes-Côte d'Azur;04;4;11;132;Montsalier;152;1;153
93;Provence-Alpes-Côte d'Azur;04;2;02;133;Moriez;238;1;239
93;Provence-Alpes-Côte d'Azur;04;4;13;134;La Motte-du-Caire;550;23;573
93;Provence-Alpes-Côte d'Azur;04;3;12;135;Moustiers-Sainte-Marie;718;15;733
93;Provence-Alpes-Côte d'Azur;04;2;02;136;La Mure-Argens;309;8;317
93;Provence-Alpes-Côte d'Azur;04;4;13;137;Nibles;45;1;46
93;Provence-Alpes-Côte d'Azur;04;4;06;138;Niozelles;285;6;291
93;Provence-Alpes-Côte d'Azur;04;4;14;139;Noyers-sur-Jabron;523;9;532
93;Provence-Alpes-Côte d'Azur;04;4;14;140;Les Omergues;127;3;130
93;Provence-Alpes-Côte d'Azur;04;4;06;141;Ongles;363;7;370
93;Provence-Alpes-Côte d'Azur;04;4;11;142;Oppedette;51;0;51
93;Provence-Alpes-Côte d'Azur;04;4;10;143;Oraison;5920;115;6035
93;Provence-Alpes-Côte d'Azur;04;2;12;144;La Palud-sur-Verdon;351;1;352
93;Provence-Alpes-Côte d'Azur;04;4;14;145;Peipin;1463;33;1496
93;Provence-Alpes-Côte d'Azur;04;2;02;148;Peyroules;250;9;259
93;Provence-Alpes-Côte d'Azur;04;3;03;149;Peyruis;2801;46;2847
93;Provence-Alpes-Côte d'Azur;04;4;13;150;Piégut;204;4;208
93;Provence-Alpes-Côte d'Azur;04;4;06;151;Pierrerue;523;13;536
93;Provence-Alpes-Côte d'Azur;04;4;07;152;Pierrevert;3936;134;4070
93;Provence-Alpes-Côte d'Azur;04;1;01;154;Pontis;96;1;97
93;Provence-Alpes-Côte d'Azur;04;3;13;155;Prads-Haute-Bléone;177;1;178
93;Provence-Alpes-Côte d'Azur;04;4;12;156;Puimichel;270;1;271
93;Provence-Alpes-Côte d'Azur;04;4;12;157;Puimoisson;683;8;691
93;Provence-Alpes-Côte d'Azur;04;4;15;158;Quinson;406;8;414
93;Provence-Alpes-Côte d'Azur;04;4;11;159;Redortiers;84;0;84
93;Provence-Alpes-Côte d'Azur;04;4;11;160;Reillanne;1697;35;1732
93;Provence-Alpes-Côte d'Azur;04;1;01;161;Méolans-Revel;324;7;331
93;Provence-Alpes-Côte d'Azur;04;4;11;162;Revest-des-Brousses;259;6;265
93;Provence-Alpes-Côte d'Azur;04;4;11;163;Revest-du-Bion;507;12;519
93;Provence-Alpes-Côte d'Azur;04;4;06;164;Revest-Saint-Martin;88;1;89
93;Provence-Alpes-Côte d'Azur;04;4;12;166;Riez;1661;39;1700
93;Provence-Alpes-Côte d'Azur;04;3;04;167;La Robine-sur-Galabre;286;5;291
93;Provence-Alpes-Côte d'Azur;04;4;11;169;La Rochegiron;105;2;107
93;Provence-Alpes-Côte d'Azur;04;2;02;170;La Rochette;74;0;74
93;Provence-Alpes-Côte d'Azur;04;2;02;171;Rougon;122;0;122
93;Provence-Alpes-Côte d'Azur;04;4;12;172;Roumoules;734;11;745
93;Provence-Alpes-Côte d'Azur;04;2;02;173;Saint-André-les-Alpes;1015;21;1036
93;Provence-Alpes-Côte d'Azur;04;2;02;174;Saint-Benoît;152;1;153
93;Provence-Alpes-Côte d'Azur;04;4;11;175;Sainte-Croix-à-Lauze;90;2;92
93;Provence-Alpes-Côte d'Azur;04;3;15;176;Sainte-Croix-du-Verdon;117;4;121
93;Provence-Alpes-Côte d'Azur;04;3;04;177;Hautes-Duyes;45;0;45
93;Provence-Alpes-Côte d'Azur;04;4;06;178;Saint-Étienne-les-Orgues;1316;36;1352
93;Provence-Alpes-Côte d'Azur;04;4;14;179;Saint-Geniez;106;2;108
93;Provence-Alpes-Côte d'Azur;04;2;12;180;Saint-Jacques;81;4;85
93;Provence-Alpes-Côte d'Azur;04;3;12;181;Saint-Jeannet;48;1;49
93;Provence-Alpes-Côte d'Azur;04;3;12;182;Saint-Julien-d'Asse;215;2;217
93;Provence-Alpes-Côte d'Azur;04;2;02;183;Saint-Julien-du-Verdon;153;3;156
93;Provence-Alpes-Côte d'Azur;04;3;12;184;Saint-Jurs;136;3;139
93;Provence-Alpes-Côte d'Azur;04;4;15;186;Saint-Laurent-du-Verdon;96;1;97
93;Provence-Alpes-Côte d'Azur;04;2;12;187;Saint-Lions;40;1;41
93;Provence-Alpes-Côte d'Azur;04;4;11;188;Saint-Maime;867;12;879
93;Provence-Alpes-Côte d'Azur;04;4;15;189;Saint-Martin-de-Brômes;634;14;648
93;Provence-Alpes-Côte d'Azur;04;4;08;190;Saint-Martin-les-Eaux;124;3;127
93;Provence-Alpes-Côte d'Azur;04;3;13;191;Saint-Martin-lès-Seyne;12;2;14
93;Provence-Alpes-Côte d'Azur;04;4;11;192;Saint-Michel-l'Observatoire;1230;24;1254
93;Provence-Alpes-Côte d'Azur;04;1;01;193;Saint-Paul-sur-Ubaye;177;7;184
93;Provence-Alpes-Côte d'Azur;04;2;02;194;Saint-Pierre;97;2;99
93;Provence-Alpes-Côte d'Azur;04;1;01;195;Saint-Pons;600;13;613
93;Provence-Alpes-Côte d'Azur;04;4;09;197;Sainte-Tulle;3475;84;3559
93;Provence-Alpes-Côte d'Azur;04;4;14;199;Saint-Vincent-sur-Jabron;170;4;174
93;Provence-Alpes-Côte d'Azur;04;4;14;200;Salignac;660;22;682
93;Provence-Alpes-Côte d'Azur;04;4;11;201;Saumane;120;3;123
93;Provence-Alpes-Côte d'Azur;04;2;02;202;Sausses;130;2;132
93;Provence-Alpes-Côte d'Azur;04;3;13;203;Selonnet;472;9;481
93;Provence-Alpes-Côte d'Azur;04;2;12;204;Senez;161;4;165
93;Provence-Alpes-Côte d'Azur;04;3;13;205;Seyne;1372;28;1400
93;Provence-Alpes-Côte d'Azur;04;4;06;206;Sigonce;426;8;434
93;Provence-Alpes-Côte d'Azur;04;4;13;207;Sigoyer;101;4;105
93;Provence-Alpes-Côte d'Azur;04;4;11;208;Simiane-la-Rotonde;607;16;623
93;Provence-Alpes-Côte d'Azur;04;4;14;209;Sisteron;7669;241;7910
93;Provence-Alpes-Côte d'Azur;04;2;02;210;Soleilhas;88;4;92
93;Provence-Alpes-Côte d'Azur;04;4;14;211;Sourribes;178;3;181
93;Provence-Alpes-Côte d'Azur;04;2;12;214;Tartonne;129;2;131
93;Provence-Alpes-Côte d'Azur;04;4;13;216;Thèze;231;5;236
93;Provence-Alpes-Côte d'Azur;04;3;04;217;Thoard;738;19;757
93;Provence-Alpes-Côte d'Azur;04;2;02;218;Thorame-Basse;224;6;230
93;Provence-Alpes-Côte d'Azur;04;2;02;219;Thorame-Haute;245;6;251
93;Provence-Alpes-Côte d'Azur;04;1;01;220;Les Thuiles;370;11;381
93;Provence-Alpes-Côte d'Azur;04;4;13;222;Turriers;343;8;351
93;Provence-Alpes-Côte d'Azur;04;2;02;224;Ubraye;100;1;101
93;Provence-Alpes-Côte d'Azur;04;1;01;226;Uvernet-Fours;562;12;574
93;Provence-Alpes-Côte d'Azur;04;4;11;227;Vachères;289;7;296
93;Provence-Alpes-Côte d'Azur;04;4;13;228;Valavoire;37;0;37
93;Provence-Alpes-Côte d'Azur;04;4;14;229;Valbelle;239;4;243
93;Provence-Alpes-Côte d'Azur;04;4;15;230;Valensole;3158;66;3224
93;Provence-Alpes-Côte d'Azur;04;4;13;231;Valernes;244;6;250
93;Provence-Alpes-Côte d'Azur;04;4;13;233;Vaumeilh;267;8;275
93;Provence-Alpes-Côte d'Azur;04;4;13;234;Venterol;226;2;228
93;Provence-Alpes-Côte d'Azur;04;3;13;235;Verdaches;62;1;63
93;Provence-Alpes-Côte d'Azur;04;2;02;236;Vergons;107;0;107
93;Provence-Alpes-Côte d'Azur;04;3;13;237;Le Vernet;125;3;128
93;Provence-Alpes-Côte d'Azur;04;2;02;240;Villars-Colmars;250;5;255
93;Provence-Alpes-Côte d'Azur;04;4;11;241;Villemus;194;5;199
93;Provence-Alpes-Côte d'Azur;04;4;10;242;Villeneuve;4355;84;4439
93;Provence-Alpes-Côte d'Azur;04;3;03;244;Volonne;1639;32;1671
93;Provence-Alpes-Côte d'Azur;04;4;08;245;Volx;3212;71;3283
93;Provence-Alpes-Côte d'Azur;05;1;10;001;Abriès-Ristolas;383;6;389
93;Provence-Alpes-Côte d'Azur;05;1;10;003;Aiguilles;382;11;393
93;Provence-Alpes-Côte d'Azur;05;2;12;004;Ancelle;916;14;930
93;Provence-Alpes-Côte d'Azur;05;1;01;006;L'Argentière-la-Bessée;2238;86;2324
93;Provence-Alpes-Côte d'Azur;05;1;10;007;Arvieux;354;8;362
93;Provence-Alpes-Côte d'Azur;05;2;13;008;Aspremont;369;6;375
93;Provence-Alpes-Côte d'Azur;05;2;12;009;Aspres-lès-Corps;97;3;100
93;Provence-Alpes-Côte d'Azur;05;2;13;010;Aspres-sur-Buëch;802;11;813
93;Provence-Alpes-Côte d'Azur;05;2;14;011;Avançon;419;9;428
93;Provence-Alpes-Côte d'Azur;05;2;05;012;Baratier;627;14;641
93;Provence-Alpes-Côte d'Azur;05;2;14;013;Barcillonnette;123;5;128
93;Provence-Alpes-Côte d'Azur;05;2;11;014;Barret-sur-Méouge;181;4;185
93;Provence-Alpes-Côte d'Azur;05;2;13;016;La Bâtie-Montsaléon;257;2;259
93;Provence-Alpes-Côte d'Azur;05;2;04;017;La Bâtie-Neuve;2579;70;2649
93;Provence-Alpes-Côte d'Azur;05;2;14;018;La Bâtie-Vieille;328;10;338
93;Provence-Alpes-Côte d'Azur;05;2;13;019;La Beaume;150;4;154
93;Provence-Alpes-Côte d'Azur;05;2;13;021;Le Bersac;141;1;142
93;Provence-Alpes-Côte d'Azur;05;2;04;022;Bréziers;249;3;252
93;Provence-Alpes-Côte d'Azur;05;1;98;023;Briançon;10780;315;11095
93;Provence-Alpes-Côte d'Azur;05;2;13;024;Valdoule;218;8;226
93;Provence-Alpes-Côte d'Azur;05;2;12;025;Buissard;209;7;216
93;Provence-Alpes-Côte d'Azur;05;1;10;026;Ceillac;282;3;285
93;Provence-Alpes-Côte d'Azur;05;1;02;027;Cervières;195;4;199
93;Provence-Alpes-Côte d'Azur;05;2;13;028;Chabestan;169;4;173
93;Provence-Alpes-Côte d'Azur;05;2;12;029;Chabottes;918;26;944
93;Provence-Alpes-Côte d'Azur;05;1;01;031;Champcella;185;4;189
93;Provence-Alpes-Côte d'Azur;05;2;12;032;Champoléon;136;3;139
93;Provence-Alpes-Côte d'Azur;05;2;13;033;Chanousse;41;0;41
93;Provence-Alpes-Côte d'Azur;05;2;15;035;Châteauneuf-d'Oze;30;3;33
93;Provence-Alpes-Côte d'Azur;05;2;05;036;Châteauroux-les-Alpes;1200;35;1235
93;Provence-Alpes-Côte d'Azur;05;2;14;037;Châteauvieux;519;20;539
93;Provence-Alpes-Côte d'Azur;05;1;10;038;Château-Ville-Vieille;306;16;322
93;Provence-Alpes-Côte d'Azur;05;2;12;039;Aubessagne;716;14;730
93;Provence-Alpes-Côte d'Azur;05;2;04;040;Chorges;3077;79;3156
93;Provence-Alpes-Côte d'Azur;05;2;05;044;Crévoux;125;3;128
93;Provence-Alpes-Côte d'Azur;05;2;05;045;Crots;1125;31;1156
93;Provence-Alpes-Côte d'Azur;05;2;05;046;Embrun;6435;346;6781
93;Provence-Alpes-Côte d'Azur;05;2;11;047;Éourres;120;4;124
93;Provence-Alpes-Côte d'Azur;05;2;13;048;L'Épine;203;6;209
93;Provence-Alpes-Côte d'Azur;05;2;14;049;Esparron;58;0;58
93;Provence-Alpes-Côte d'Azur;05;2;04;050;Espinasses;823;9;832
93;Provence-Alpes-Côte d'Azur;05;2;13;051;Étoile-Saint-Cyrice;28;0;28
93;Provence-Alpes-Côte d'Azur;05;1;10;052;Eygliers;800;12;812
93;Provence-Alpes-Côte d'Azur;05;2;13;053;Garde-Colombe;525;11;536
93;Provence-Alpes-Côte d'Azur;05;2;12;054;La Fare-en-Champsaur;448;10;458
93;Provence-Alpes-Côte d'Azur;05;2;13;055;La Faurie;317;5;322
93;Provence-Alpes-Côte d'Azur;05;2;12;056;Forest-Saint-Julien;333;8;341
93;Provence-Alpes-Côte d'Azur;05;2;14;057;Fouillouse;261;6;267
93;Provence-Alpes-Côte d'Azur;05;1;01;058;Freissinières;205;3;208
93;Provence-Alpes-Côte d'Azur;05;2;14;059;La Freissinouse;933;20;953
93;Provence-Alpes-Côte d'Azur;05;2;15;060;Furmeyer;181;8;189
93;Provence-Alpes-Côte d'Azur;05;2;99;061;Gap;40111;1417;41528
93;Provence-Alpes-Côte d'Azur;05;2;12;062;Le Glaizil;166;3;169
93;Provence-Alpes-Côte d'Azur;05;1;02;063;La Grave;477;10;487
93;Provence-Alpes-Côte d'Azur;05;2;12;064;La Chapelle-en-Valgaudémar;105;3;108
93;Provence-Alpes-Côte d'Azur;05;1;10;065;Guillestre;2291;83;2374
93;Provence-Alpes-Côte d'Azur;05;2;13;066;La Haute-Beaume;8;0;8
93;Provence-Alpes-Côte d'Azur;05;2;14;068;Jarjayes;466;12;478
93;Provence-Alpes-Côte d'Azur;05;2;11;070;Laragne-Montéglin;3579;52;3631
93;Provence-Alpes-Côte d'Azur;05;2;14;071;Lardier-et-Valença;349;20;369
93;Provence-Alpes-Côte d'Azur;05;2;12;072;Laye;243;5;248
93;Provence-Alpes-Côte d'Azur;05;2;11;073;Lazer;341;14;355
93;Provence-Alpes-Côte d'Azur;05;2;14;074;Lettret;201;0;201
93;Provence-Alpes-Côte d'Azur;05;2;15;075;Manteyer;450;15;465
93;Provence-Alpes-Côte d'Azur;05;2;13;076;Méreuil;92;0;92
93;Provence-Alpes-Côte d'Azur;05;1;10;077;Molines-en-Queyras;300;2;302
93;Provence-Alpes-Côte d'Azur;05;2;11;078;Monêtier-Allemont;284;10;294
93;Provence-Alpes-Côte d'Azur;05;1;02;079;Le Monêtier-les-Bains;1062;23;1085
93;Provence-Alpes-Côte d'Azur;05;2;13;080;Montbrand;63;1;64
93;Provence-Alpes-Côte d'Azur;05;2;13;081;Montclus;50;4;54
93;Provence-Alpes-Côte d'Azur;05;1;10;082;Mont-Dauphin;173;2;175
93;Provence-Alpes-Côte d'Azur;05;2;04;084;Montgardin;465;7;472
93;Provence-Alpes-Côte d'Azur;05;1;03;085;Montgenèvre;452;14;466
93;Provence-Alpes-Côte d'Azur;05;2;13;086;Montjay;104;2;106
93;Provence-Alpes-Côte d'Azur;05;2;15;087;Montmaur;537;15;552
93;Provence-Alpes-Côte d'Azur;05;2;13;089;Montrond;87;1;88
93;Provence-Alpes-Côte d'Azur;05;2;12;090;La Motte-en-Champsaur;209;5;214
93;Provence-Alpes-Côte d'Azur;05;2;13;091;Moydans;40;4;44
93;Provence-Alpes-Côte d'Azur;05;2;14;092;Neffes;781;15;796
93;Provence-Alpes-Côte d'Azur;05;1;03;093;Névache;357;10;367
93;Provence-Alpes-Côte d'Azur;05;2;13;094;Nossage-et-Bénévent;14;1;15
93;Provence-Alpes-Côte d'Azur;05;2;12;095;Le Noyer;306;3;309
93;Provence-Alpes-Côte d'Azur;05;2;12;096;Orcières;680;16;696
93;Provence-Alpes-Côte d'Azur;05;2;13;097;Orpierre;344;33;377
93;Provence-Alpes-Côte d'Azur;05;2;05;098;Les Orres;530;13;543
93;Provence-Alpes-Côte d'Azur;05;2;13;099;Oze;103;1;104
93;Provence-Alpes-Côte d'Azur;05;2;14;100;Pelleautier;810;31;841
93;Provence-Alpes-Côte d'Azur;05;1;01;101;Vallouise-Pelvoux;1129;39;1168
93;Provence-Alpes-Côte d'Azur;05;2;13;102;La Piarre;91;2;93
93;Provence-Alpes-Côte d'Azur;05;2;11;103;Le Poët;791;21;812
93;Provence-Alpes-Côte d'Azur;05;2;12;104;Poligny;337;15;352
93;Provence-Alpes-Côte d'Azur;05;2;04;106;Prunières;300;7;307
93;Provence-Alpes-Côte d'Azur;05;1;02;107;Puy-Saint-André;459;11;470
93;Provence-Alpes-Côte d'Azur;05;2;04;108;Puy-Saint-Eusèbe;181;6;187
93;Provence-Alpes-Côte d'Azur;05;1;02;109;Puy-Saint-Pierre;515;20;535
93;Provence-Alpes-Côte d'Azur;05;1;01;110;Puy-Saint-Vincent;290;2;292
93;Provence-Alpes-Côte d'Azur;05;2;04;111;Puy-Sanières;267;9;276
93;Provence-Alpes-Côte d'Azur;05;2;15;112;Rabou;89;0;89
93;Provence-Alpes-Côte d'Azur;05;2;14;113;Rambaud;375;17;392
93;Provence-Alpes-Côte d'Azur;05;2;04;114;Réallon;248;1;249
93;Provence-Alpes-Côte d'Azur;05;2;04;115;Remollon;458;10;468
93;Provence-Alpes-Côte d'Azur;05;1;10;116;Réotier;209;2;211
93;Provence-Alpes-Côte d'Azur;05;2;13;117;Ribeyret;114;0;114
93;Provence-Alpes-Côte d'Azur;05;2;11;118;Val Buëch-Méouge;1329;27;1356
93;Provence-Alpes-Côte d'Azur;05;1;10;119;Risoul;658;18;676
93;Provence-Alpes-Côte d'Azur;05;2;04;121;Rochebrune;179;6;185
93;Provence-Alpes-Côte d'Azur;05;1;01;122;La Roche-de-Rame;837;20;857
93;Provence-Alpes-Côte d'Azur;05;2;15;123;La Roche-des-Arnauds;1578;43;1621
93;Provence-Alpes-Côte d'Azur;05;2;04;124;La Rochette;473;9;482
93;Provence-Alpes-Côte d'Azur;05;2;13;126;Rosans;469;8;477
93;Provence-Alpes-Côte d'Azur;05;2;04;127;Rousset;177;5;182
93;Provence-Alpes-Côte d'Azur;05;2;05;128;Saint-André-d'Embrun;697;22;719
93;Provence-Alpes-Côte d'Azur;05;2;13;129;Saint-André-de-Rosans;154;3;157
93;Provence-Alpes-Côte d'Azur;05;2;04;130;Saint-Apollinaire;196;5;201
93;Provence-Alpes-Côte d'Azur;05;2;13;131;Saint-Auban-d'Oze;77;4;81
93;Provence-Alpes-Côte d'Azur;05;2;12;132;Saint-Bonnet-en-Champsaur;2078;68;2146
93;Provence-Alpes-Côte d'Azur;05;1;02;133;Saint-Chaffrey;1523;46;1569
93;Provence-Alpes-Côte d'Azur;05;1;10;134;Saint-Clément-sur-Durance;321;5;326
93;Provence-Alpes-Côte d'Azur;05;2;13;135;Sainte-Colombe;55;2;57
93;Provence-Alpes-Côte d'Azur;05;1;10;136;Saint-Crépin;732;14;746
93;Provence-Alpes-Côte d'Azur;05;2;15;139;Dévoluy;904;26;930
93;Provence-Alpes-Côte d'Azur;05;2;14;140;Saint-Étienne-le-Laus;302;6;308
93;Provence-Alpes-Côte d'Azur;05;2;12;142;Saint-Firmin;446;10;456
93;Provence-Alpes-Côte d'Azur;05;2;12;144;Saint-Jacques-en-Valgodemard;134;5;139
93;Provence-Alpes-Côte d'Azur;05;2;12;145;Saint-Jean-Saint-Nicolas;1075;91;1166
93;Provence-Alpes-Côte d'Azur;05;2;13;146;Saint-Julien-en-Beauchêne;137;1;138
93;Provence-Alpes-Côte d'Azur;05;2;12;147;Saint-Julien-en-Champsaur;372;5;377
93;Provence-Alpes-Côte d'Azur;05;2;12;148;Saint-Laurent-du-Cros;548;8;556
93;Provence-Alpes-Côte d'Azur;05;2;12;149;Saint-Léger-les-Mélèzes;366;12;378
93;Provence-Alpes-Côte d'Azur;05;1;01;151;Saint-Martin-de-Queyrières;1127;37;1164
93;Provence-Alpes-Côte d'Azur;05;2;12;152;Saint-Maurice-en-Valgodemard;123;1;124
93;Provence-Alpes-Côte d'Azur;05;2;12;153;Saint-Michel-de-Chaillol;356;11;367
93;Provence-Alpes-Côte d'Azur;05;2;13;154;Saint-Pierre-d'Argençon;163;0;163
93;Provence-Alpes-Côte d'Azur;05;2;11;155;Saint-Pierre-Avez;30;1;31
93;Provence-Alpes-Côte d'Azur;05;2;05;156;Saint-Sauveur;517;11;528
93;Provence-Alpes-Côte d'Azur;05;1;10;157;Saint-Véran;171;5;176
93;Provence-Alpes-Côte d'Azur;05;2;13;158;Le Saix;121;1;122
93;Provence-Alpes-Côte d'Azur;05;2;13;159;Saléon;85;3;88
93;Provence-Alpes-Côte d'Azur;05;2;11;160;Salérans;82;0;82
93;Provence-Alpes-Côte d'Azur;05;1;02;161;La Salle-les-Alpes;931;22;953
93;Provence-Alpes-Côte d'Azur;05;2;14;162;La Saulce;1397;34;1431
93;Provence-Alpes-Côte d'Azur;05;2;04;163;Le Sauze-du-Lac;149;1;150
93;Provence-Alpes-Côte d'Azur;05;2;04;164;Savines-le-Lac;1080;55;1135
93;Provence-Alpes-Côte d'Azur;05;2;13;165;Savournon;248;6;254
93;Provence-Alpes-Côte d'Azur;05;2;13;166;Serres;1292;27;1319
93;Provence-Alpes-Côte d'Azur;05;2;13;167;Sigottier;85;2;87
93;Provence-Alpes-Côte d'Azur;05;2;14;168;Sigoyer;727;22;749
93;Provence-Alpes-Côte d'Azur;05;2;13;169;Sorbiers;40;0;40
93;Provence-Alpes-Côte d'Azur;05;2;14;170;Tallard;2295;54;2349
93;Provence-Alpes-Côte d'Azur;05;2;04;171;Théus;221;4;225
93;Provence-Alpes-Côte d'Azur;05;2;13;172;Trescléoux;306;5;311
93;Provence-Alpes-Côte d'Azur;05;2;11;173;Upaix;460;10;470
93;Provence-Alpes-Côte d'Azur;05;1;03;174;Val-des-Prés;613;22;635
93;Provence-Alpes-Côte d'Azur;05;2;14;176;Valserres;273;7;280
93;Provence-Alpes-Côte d'Azur;05;1;10;177;Vars;554;11;565
93;Provence-Alpes-Côte d'Azur;05;2;11;178;Ventavon;599;39;638
93;Provence-Alpes-Côte d'Azur;05;2;15;179;Veynes;3231;147;3378
93;Provence-Alpes-Côte d'Azur;05;1;01;180;Les Vigneaux;532;14;546
93;Provence-Alpes-Côte d'Azur;05;1;02;181;Villar-d'Arêne;287;13;300
93;Provence-Alpes-Côte d'Azur;05;2;12;182;Villar-Loubière;38;1;39
93;Provence-Alpes-Côte d'Azur;05;1;02;183;Villar-Saint-Pancrace;1466;34;1500
93;Provence-Alpes-Côte d'Azur;05;2;14;184;Vitrolles;210;8;218
93;Provence-Alpes-Côte d'Azur;06;1;26;001;Aiglun;93;0;93
93;Provence-Alpes-Côte d'Azur;06;1;11;002;Amirat;52;0;52
93;Provence-Alpes-Côte d'Azur;06;1;11;003;Andon;644;5;649
93;Provence-Alpes-Côte d'Azur;06;1;94;004;Antibes;74709;1070;75779
93;Provence-Alpes-Côte d'Azur;06;2;26;005;Ascros;177;0;177
93;Provence-Alpes-Côte d'Azur;06;2;24;006;Aspremont;2271;33;2304
93;Provence-Alpes-Côte d'Azur;06;1;13;007;Auribeau-sur-Siagne;3175;68;3243
93;Provence-Alpes-Côte d'Azur;06;2;26;008;Auvare;37;1;38
93;Provence-Alpes-Côte d'Azur;06;2;26;009;Bairols;116;1;117
93;Provence-Alpes-Côte d'Azur;06;1;25;010;Le Bar-sur-Loup;2927;62;2989
93;Provence-Alpes-Côte d'Azur;06;2;04;011;Beaulieu-sur-Mer;3762;26;3788
93;Provence-Alpes-Côte d'Azur;06;2;04;012;Beausoleil;13153;127;13280
93;Provence-Alpes-Côte d'Azur;06;2;24;013;Belvédère;658;20;678
93;Provence-Alpes-Côte d'Azur;06;2;10;014;Bendejun;940;6;946
93;Provence-Alpes-Côte d'Azur;06;2;10;015;Berre-les-Alpes;1236;23;1259
93;Provence-Alpes-Côte d'Azur;06;2;26;016;Beuil;552;4;556
93;Provence-Alpes-Côte d'Azur;06;1;26;017;Bézaudun-les-Alpes;256;4;260
93;Provence-Alpes-Côte d'Azur;06;1;03;018;Biot;9575;351;9926
93;Provence-Alpes-Côte d'Azur;06;2;10;019;Blausasc;1663;18;1681
93;Provence-Alpes-Côte d'Azur;06;2;24;020;La Bollène-Vésubie;594;8;602
93;Provence-Alpes-Côte d'Azur;06;2;26;021;Bonson;723;4;727
93;Provence-Alpes-Côte d'Azur;06;1;26;022;Bouyon;548;6;554
93;Provence-Alpes-Côte d'Azur;06;2;10;023;Breil-sur-Roya;2121;52;2173
93;Provence-Alpes-Côte d'Azur;06;1;11;024;Briançonnet;201;5;206
93;Provence-Alpes-Côte d'Azur;06;1;17;025;Le Broc;1417;7;1424
93;Provence-Alpes-Côte d'Azur;06;1;11;026;Cabris;1386;27;1413
93;Provence-Alpes-Côte d'Azur;06;1;95;027;Cagnes-sur-Mer;52100;475;52575
93;Provence-Alpes-Côte d'Azur;06;1;11;028;Caille;407;5;412
93;Provence-Alpes-Côte d'Azur;06;1;96;029;Cannes;72435;724;73159
93;Provence-Alpes-Côte d'Azur;06;1;97;030;Le Cannet;42125;399;42524
93;Provence-Alpes-Côte d'Azur;06;2;10;031;Cantaron;1293;10;1303
93;Provence-Alpes-Côte d'Azur;06;2;04;032;Cap-d'Ail;4517;68;4585
93;Provence-Alpes-Côte d'Azur;06;1;17;033;Carros;12875;135;13010
93;Provence-Alpes-Côte d'Azur;06;2;24;034;Castagniers;1674;16;1690
93;Provence-Alpes-Côte d'Azur;06;2;14;035;Castellar;1133;9;1142
93;Provence-Alpes-Côte d'Azur;06;2;14;036;Castillon;417;4;421
93;Provence-Alpes-Côte d'Azur;06;1;25;037;Caussols;302;3;305
93;Provence-Alpes-Côte d'Azur;06;1;25;038;Châteauneuf-Grasse;3690;60;3750
93;Provence-Alpes-Côte d'Azur;06;2;10;039;Châteauneuf-Villevieille;956;9;965
93;Provence-Alpes-Côte d'Azur;06;2;26;040;Châteauneuf-d'Entraunes;63;0;63
93;Provence-Alpes-Côte d'Azur;06;1;25;041;Cipières;403;6;409
93;Provence-Alpes-Côte d'Azur;06;2;24;042;Clans;670;12;682
93;Provence-Alpes-Côte d'Azur;06;2;10;043;Coaraze;821;4;825
93;Provence-Alpes-Côte d'Azur;06;1;27;044;La Colle-sur-Loup;8048;160;8208
93;Provence-Alpes-Côte d'Azur;06;1;11;045;Collongues;71;2;73
93;Provence-Alpes-Côte d'Azur;06;2;24;046;Colomars;3494;40;3534
93;Provence-Alpes-Côte d'Azur;06;1;26;047;Conségudes;95;1;96
93;Provence-Alpes-Côte d'Azur;06;2;10;048;Contes;7534;78;7612
93;Provence-Alpes-Côte d'Azur;06;1;25;049;Courmes;108;2;110
93;Provence-Alpes-Côte d'Azur;06;1;26;050;Coursegoules;529;6;535
93;Provence-Alpes-Côte d'Azur;06;2;26;051;La Croix-sur-Roudoule;98;2;100
93;Provence-Alpes-Côte d'Azur;06;2;26;052;Cuébris;164;1;165
93;Provence-Alpes-Côte d'Azur;06;2;26;053;Daluis;141;1;142
93;Provence-Alpes-Côte d'Azur;06;2;10;054;Drap;5176;19;5195
93;Provence-Alpes-Côte d'Azur;06;2;24;055;Duranus;152;3;155
93;Provence-Alpes-Côte d'Azur;06;2;26;056;Entraunes;143;2;145
93;Provence-Alpes-Côte d'Azur;06;2;10;057;L'Escarène;2562;18;2580
93;Provence-Alpes-Côte d'Azur;06;1;11;058;Escragnolles;612;15;627
93;Provence-Alpes-Côte d'Azur;06;2;04;059;Èze;2222;37;2259
93;Provence-Alpes-Côte d'Azur;06;2;24;060;Falicon;2053;45;2098
93;Provence-Alpes-Côte d'Azur;06;1;26;061;Les Ferres;91;3;94
93;Provence-Alpes-Côte d'Azur;06;2;10;062;Fontan;315;1;316
93;Provence-Alpes-Côte d'Azur;06;1;11;063;Gars;74;0;74
93;Provence-Alpes-Côte d'Azur;06;1;17;064;Gattières;4229;43;4272
93;Provence-Alpes-Côte d'Azur;06;1;06;065;La Gaude;7117;108;7225
93;Provence-Alpes-Côte d'Azur;06;2;26;066;Gilette;1598;11;1609
93;Provence-Alpes-Côte d'Azur;06;2;14;067;Gorbio;1485;13;1498
93;Provence-Alpes-Côte d'Azur;06;1;25;068;Gourdon;371;9;380
93;Provence-Alpes-Côte d'Azur;06;1;98;069;Grasse;48708;899;49607
93;Provence-Alpes-Côte d'Azur;06;1;25;070;Gréolières;564;13;577
93;Provence-Alpes-Côte d'Azur;06;2;26;071;Guillaumes;585;7;592
93;Provence-Alpes-Côte d'Azur;06;2;24;072;Ilonse;147;1;148
93;Provence-Alpes-Côte d'Azur;06;2;24;073;Isola;653;14;667
93;Provence-Alpes-Côte d'Azur;06;2;24;074;Lantosque;1206;9;1215
93;Provence-Alpes-Côte d'Azur;06;2;24;075;Levens;4963;48;5011
93;Provence-Alpes-Côte d'Azur;06;2;26;076;Lieuche;48;0;48
93;Provence-Alpes-Côte d'Azur;06;2;10;077;Lucéram;1279;12;1291
93;Provence-Alpes-Côte d'Azur;06;2;26;078;Malaussène;326;7;333
93;Provence-Alpes-Côte d'Azur;06;1;13;079;Mandelieu-la-Napoule;21772;295;22067
93;Provence-Alpes-Côte d'Azur;06;2;24;080;Marie;105;4;109
93;Provence-Alpes-Côte d'Azur;06;1;11;081;Le Mas;100;2;102
93;Provence-Alpes-Côte d'Azur;06;2;26;082;Massoins;104;1;105
93;Provence-Alpes-Côte d'Azur;06;2;14;083;Menton;30679;484;31163
93;Provence-Alpes-Côte d'Azur;06;1;12;084;Mouans-Sartoux;10215;182;10397
93;Provence-Alpes-Côte d'Azur;06;1;09;085;Mougins;20180;446;20626
93;Provence-Alpes-Côte d'Azur;06;2;10;086;Moulinet;252;2;254
93;Provence-Alpes-Côte d'Azur;06;1;11;087;Les Mujouls;41;0;41
93;Provence-Alpes-Côte d'Azur;06;2;99;088;Nice;343477;2899;346376
93;Provence-Alpes-Côte d'Azur;06;1;25;089;Opio;2375;77;2452
93;Provence-Alpes-Côte d'Azur;06;1;13;090;Pégomas;7956;91;8047
93;Provence-Alpes-Côte d'Azur;06;2;10;091;Peille;2369;17;2386
93;Provence-Alpes-Côte d'Azur;06;2;10;092;Peillon;1465;12;1477
93;Provence-Alpes-Côte d'Azur;06;2;26;093;La Penne;223;4;227
93;Provence-Alpes-Côte d'Azur;06;2;26;094;Péone;880;6;886
93;Provence-Alpes-Côte d'Azur;06;1;11;095;Peymeinade;8211;189;8400
93;Provence-Alpes-Côte d'Azur;06;2;26;096;Pierlas;103;1;104
93;Provence-Alpes-Côte d'Azur;06;2;26;097;Pierrefeu;335;0;335
93;Provence-Alpes-Côte d'Azur;06;2;26;098;Puget-Rostang;126;1;127
93;Provence-Alpes-Côte d'Azur;06;2;26;099;Puget-Théniers;1826;80;1906
93;Provence-Alpes-Côte d'Azur;06;2;26;100;Revest-les-Roches;229;1;230
93;Provence-Alpes-Côte d'Azur;06;2;26;101;Rigaud;170;2;172
93;Provence-Alpes-Côte d'Azur;06;2;24;102;Rimplas;112;1;113
93;Provence-Alpes-Côte d'Azur;06;2;24;103;Roquebillière;1822;50;1872
93;Provence-Alpes-Côte d'Azur;06;2;14;104;Roquebrune-Cap-Martin;12966;196;13162
93;Provence-Alpes-Côte d'Azur;06;1;27;105;Roquefort-les-Pins;7277;199;7476
93;Provence-Alpes-Côte d'Azur;06;2;26;106;Roquestéron;570;8;578
93;Provence-Alpes-Côte d'Azur;06;1;26;107;La Roque-en-Provence;64;1;65
93;Provence-Alpes-Côte d'Azur;06;1;13;108;La Roquette-sur-Siagne;5413;96;5509
93;Provence-Alpes-Côte d'Azur;06;2;24;109;La Roquette-sur-Var;954;5;959
93;Provence-Alpes-Côte d'Azur;06;2;24;110;Roubion;119;2;121
93;Provence-Alpes-Côte d'Azur;06;2;24;111;Roure;116;3;119
93;Provence-Alpes-Côte d'Azur;06;1;25;112;Le Rouret;4115;104;4219
93;Provence-Alpes-Côte d'Azur;06;2;14;113;Sainte-Agnès;1336;23;1359
93;Provence-Alpes-Côte d'Azur;06;2;21;114;Saint-André-de-la-Roche;5694;28;5722
93;Provence-Alpes-Côte d'Azur;06;2;26;115;Saint-Antonin;86;3;89
93;Provence-Alpes-Côte d'Azur;06;1;11;116;Saint-Auban;214;3;217
93;Provence-Alpes-Côte d'Azur;06;2;24;117;Saint-Blaise;1350;10;1360
93;Provence-Alpes-Côte d'Azur;06;1;11;118;Saint-Cézaire-sur-Siagne;3927;101;4028
93;Provence-Alpes-Côte d'Azur;06;2;24;119;Saint-Dalmas-le-Selvage;105;2;107
93;Provence-Alpes-Côte d'Azur;06;2;24;120;Saint-Étienne-de-Tinée;1413;153;1566
93;Provence-Alpes-Côte d'Azur;06;2;04;121;Saint-Jean-Cap-Ferrat;1481;8;1489
93;Provence-Alpes-Côte d'Azur;06;1;26;122;Saint-Jeannet;4317;114;4431
93;Provence-Alpes-Côte d'Azur;06;1;06;123;Saint-Laurent-du-Var;30141;192;30333
93;Provence-Alpes-Côte d'Azur;06;2;26;124;Saint-Léger;48;0;48
93;Provence-Alpes-Côte d'Azur;06;2;26;125;Saint-Martin-d'Entraunes;153;7;160
93;Provence-Alpes-Côte d'Azur;06;2;24;126;Saint-Martin-du-Var;3143;19;3162
93;Provence-Alpes-Côte d'Azur;06;2;24;127;Saint-Martin-Vésubie;1431;12;1443
93;Provence-Alpes-Côte d'Azur;06;1;27;128;Saint-Paul-de-Vence;3179;68;3247
93;Provence-Alpes-Côte d'Azur;06;2;24;129;Saint-Sauveur-sur-Tinée;307;82;389
93;Provence-Alpes-Côte d'Azur;06;1;11;130;Saint-Vallier-de-Thiey;3671;104;3775
93;Provence-Alpes-Côte d'Azur;06;1;26;131;Sallagriffon;48;2;50
93;Provence-Alpes-Côte d'Azur;06;2;10;132;Saorge;449;4;453
93;Provence-Alpes-Côte d'Azur;06;2;26;133;Sauze;72;1;73
93;Provence-Alpes-Côte d'Azur;06;1;11;134;Séranon;537;8;545
93;Provence-Alpes-Côte d'Azur;06;2;26;135;Sigale;197;2;199
93;Provence-Alpes-Côte d'Azur;06;2;10;136;Sospel;3792;87;3879
93;Provence-Alpes-Côte d'Azur;06;1;11;137;Spéracèdes;1171;24;1195
93;Provence-Alpes-Côte d'Azur;06;1;13;138;Théoule-sur-Mer;1361;16;1377
93;Provence-Alpes-Côte d'Azur;06;2;26;139;Thiéry;107;3;110
93;Provence-Alpes-Côte d'Azur;06;1;11;140;Le Tignet;3069;54;3123
93;Provence-Alpes-Côte d'Azur;06;2;26;141;Toudon;348;1;349
93;Provence-Alpes-Côte d'Azur;06;2;10;142;Touët-de-l'Escarène;308;1;309
93;Provence-Alpes-Côte d'Azur;06;2;26;143;Touët-sur-Var;690;10;700
93;Provence-Alpes-Côte d'Azur;06;2;26;144;La Tour;549;4;553
93;Provence-Alpes-Côte d'Azur;06;2;26;145;Tourette-du-Château;138;2;140
93;Provence-Alpes-Côte d'Azur;06;2;26;146;Tournefort;149;1;150
93;Provence-Alpes-Côte d'Azur;06;2;24;147;Tourrette-Levens;4887;34;4921
93;Provence-Alpes-Côte d'Azur;06;1;25;148;Tourrettes-sur-Loup;4063;101;4164
93;Provence-Alpes-Côte d'Azur;06;2;21;149;La Trinité;10103;52;10155
93;Provence-Alpes-Côte d'Azur;06;2;04;150;La Turbie;2997;55;3052
93;Provence-Alpes-Côte d'Azur;06;2;24;151;Utelle;863;1;864
93;Provence-Alpes-Côte d'Azur;06;1;25;152;Valbonne;13162;503;13665
93;Provence-Alpes-Côte d'Azur;06;2;24;153;Valdeblore;834;289;1123
93;Provence-Alpes-Côte d'Azur;06;1;11;154;Valderoure;473;8;481
93;Provence-Alpes-Côte d'Azur;06;1;01;155;Vallauris;27970;198;28168
93;Provence-Alpes-Côte d'Azur;06;2;24;156;Venanson;173;1;174
93;Provence-Alpes-Côte d'Azur;06;1;26;157;Vence;19315;270;19585
93;Provence-Alpes-Côte d'Azur;06;2;26;158;Villars-sur-Var;778;6;784
93;Provence-Alpes-Côte d'Azur;06;2;04;159;Villefranche-sur-Mer;5002;35;5037
93;Provence-Alpes-Côte d'Azur;06;2;26;160;Villeneuve-d'Entraunes;91;2;93
93;Provence-Alpes-Côte d'Azur;06;1;27;161;Villeneuve-Loubet;16329;259;16588
93;Provence-Alpes-Côte d'Azur;06;2;10;162;La Brigue;696;10;706
93;Provence-Alpes-Côte d'Azur;06;2;10;163;Tende;2144;49;2193
84;Auvergne-Rhône-Alpes;07;3;06;001;Accons;373;12;385
84;Auvergne-Rhône-Alpes;07;1;04;002;Ailhon;551;18;569
84;Auvergne-Rhône-Alpes;07;1;03;003;Aizac;170;1;171
84;Auvergne-Rhône-Alpes;07;2;10;004;Ajoux;79;1;80
84;Auvergne-Rhône-Alpes;07;2;12;005;Alba-la-Romaine;1489;44;1533
84;Auvergne-Rhône-Alpes;07;3;06;006;Albon-d'Ardèche;158;6;164
84;Auvergne-Rhône-Alpes;07;3;08;007;Alboussière;998;13;1011
84;Auvergne-Rhône-Alpes;07;2;10;008;Alissas;1447;52;1499
84;Auvergne-Rhône-Alpes;07;3;11;009;Andance;1201;22;1223
84;Auvergne-Rhône-Alpes;07;3;98;010;Annonay;16359;603;16962
84;Auvergne-Rhône-Alpes;07;1;03;011;Vallées-d'Antraigues-Asperjoc;867;18;885
84;Auvergne-Rhône-Alpes;07;3;06;012;Arcens;379;9;388
84;Auvergne-Rhône-Alpes;07;3;08;013;Ardoix;1248;22;1270
84;Auvergne-Rhône-Alpes;07;3;08;014;Arlebosc;324;7;331
84;Auvergne-Rhône-Alpes;07;3;11;015;Arras-sur-Rhône;528;24;552
84;Auvergne-Rhône-Alpes;07;1;16;017;Les Assions;764;15;779
84;Auvergne-Rhône-Alpes;07;1;13;018;Astet;48;0;48
84;Auvergne-Rhône-Alpes;07;1;99;019;Aubenas;12403;774;13177
84;Auvergne-Rhône-Alpes;07;2;12;020;Aubignas;468;11;479
84;Auvergne-Rhône-Alpes;07;2;09;022;Baix;1268;12;1280
84;Auvergne-Rhône-Alpes;07;1;15;023;Balazuc;372;6;378
84;Auvergne-Rhône-Alpes;07;1;16;024;Banne;658;21;679
84;Auvergne-Rhône-Alpes;07;1;13;025;Barnas;206;2;208
84;Auvergne-Rhône-Alpes;07;1;13;026;Le Béage;255;5;260
84;Auvergne-Rhône-Alpes;07;2;17;027;Beauchastel;1840;31;1871
84;Auvergne-Rhône-Alpes;07;1;16;028;Beaulieu;524;10;534
84;Auvergne-Rhône-Alpes;07;1;16;029;Beaumont;254;3;257
84;Auvergne-Rhône-Alpes;07;2;06;030;Beauvène;206;5;211
84;Auvergne-Rhône-Alpes;07;1;16;031;Berrias-et-Casteljau;755;18;773
84;Auvergne-Rhône-Alpes;07;1;12;032;Berzème;161;1;162
84;Auvergne-Rhône-Alpes;07;1;15;033;Bessas;225;2;227
84;Auvergne-Rhône-Alpes;07;2;05;034;Bidon;256;3;259
84;Auvergne-Rhône-Alpes;07;3;17;035;Boffres;610;19;629
84;Auvergne-Rhône-Alpes;07;3;11;036;Bogy;448;11;459
84;Auvergne-Rhône-Alpes;07;1;06;037;Borée;147;4;151
84;Auvergne-Rhône-Alpes;07;1;13;038;Borne;49;0;49
84;Auvergne-Rhône-Alpes;07;3;08;039;Bozas;256;5;261
84;Auvergne-Rhône-Alpes;07;3;14;040;Boucieu-le-Roi;254;5;259
84;Auvergne-Rhône-Alpes;07;3;01;041;Boulieu-lès-Annonay;2332;58;2390
84;Auvergne-Rhône-Alpes;07;2;05;042;Bourg-Saint-Andéol;7187;166;7353
84;Auvergne-Rhône-Alpes;07;3;11;044;Brossainc;250;8;258
84;Auvergne-Rhône-Alpes;07;1;13;045;Burzet;525;7;532
84;Auvergne-Rhône-Alpes;07;1;13;047;Cellier-du-Luc;86;2;88
84;Auvergne-Rhône-Alpes;07;2;06;048;Chalencon;338;7;345
84;Auvergne-Rhône-Alpes;07;3;06;049;Le Chambon;56;3;59
84;Auvergne-Rhône-Alpes;07;1;16;050;Chambonas;955;16;971
84;Auvergne-Rhône-Alpes;07;3;11;051;Champagne;577;18;595
84;Auvergne-Rhône-Alpes;07;3;08;052;Champis;616;10;626
84;Auvergne-Rhône-Alpes;07;1;16;053;Chandolas;535;3;538
84;Auvergne-Rhône-Alpes;07;3;06;054;Chanéac;256;10;266
84;Auvergne-Rhône-Alpes;07;3;17;055;Charmes-sur-Rhône;3044;76;3120
84;Auvergne-Rhône-Alpes;07;3;11;056;Charnas;904;18;922
84;Auvergne-Rhône-Alpes;07;1;15;058;Chassiers;1019;37;1056
84;Auvergne-Rhône-Alpes;07;3;07;059;Châteaubourg;238;8;246
84;Auvergne-Rhône-Alpes;07;2;17;060;Châteauneuf-de-Vernoux;265;5;270
84;Auvergne-Rhône-Alpes;07;1;15;061;Chauzon;419;12;431
84;Auvergne-Rhône-Alpes;07;1;15;062;Chazeaux;145;4;149
84;Auvergne-Rhône-Alpes;07;3;14;063;Cheminas;404;9;413
84;Auvergne-Rhône-Alpes;07;3;06;064;Le Cheylard;2849;155;3004
84;Auvergne-Rhône-Alpes;07;1;13;065;Chirols;234;3;237
84;Auvergne-Rhône-Alpes;07;2;10;066;Chomérac;3004;174;3178
84;Auvergne-Rhône-Alpes;07;3;11;067;Colombier-le-Cardinal;327;4;331
84;Auvergne-Rhône-Alpes;07;3;14;068;Colombier-le-Jeune;571;6;577
84;Auvergne-Rhône-Alpes;07;3;08;069;Colombier-le-Vieux;652;22;674
84;Auvergne-Rhône-Alpes;07;3;07;070;Cornas;2328;49;2377
84;Auvergne-Rhône-Alpes;07;1;13;071;Coucouron;782;10;792
84;Auvergne-Rhône-Alpes;07;2;10;072;Coux;1659;42;1701
84;Auvergne-Rhône-Alpes;07;3;08;073;Le Crestet;521;10;531
84;Auvergne-Rhône-Alpes;07;2;10;074;Creysseilles;153;6;159
84;Auvergne-Rhône-Alpes;07;1;13;075;Cros-de-Géorand;149;4;153
84;Auvergne-Rhône-Alpes;07;2;09;076;Cruas;3069;66;3135
84;Auvergne-Rhône-Alpes;07;1;12;077;Darbres;259;2;261
84;Auvergne-Rhône-Alpes;07;3;01;078;Davézieux;3144;79;3223
84;Auvergne-Rhône-Alpes;07;3;08;079;Désaignes;1156;20;1176
84;Auvergne-Rhône-Alpes;07;3;06;080;Devesset;298;9;307
84;Auvergne-Rhône-Alpes;07;1;16;081;Dompnac;64;0;64
84;Auvergne-Rhône-Alpes;07;3;06;082;Dornas;202;12;214
84;Auvergne-Rhône-Alpes;07;2;06;083;Dunière-sur-Eyrieux;436;11;447
84;Auvergne-Rhône-Alpes;07;3;11;084;Eclassan;1031;37;1068
84;Auvergne-Rhône-Alpes;07;3;08;085;Empurany;603;17;620
84;Auvergne-Rhône-Alpes;07;3;14;086;Étables;936;20;956
84;Auvergne-Rhône-Alpes;07;1;13;087;Fabras;444;8;452
84;Auvergne-Rhône-Alpes;07;1;16;088;Faugères;94;2;96
84;Auvergne-Rhône-Alpes;07;3;11;089;Félines;1754;49;1803
84;Auvergne-Rhône-Alpes;07;2;10;090;Flaviac;1240;17;1257
84;Auvergne-Rhône-Alpes;07;1;04;091;Fons;328;7;335
84;Auvergne-Rhône-Alpes;07;2;10;092;Freyssenet;46;1;47
84;Auvergne-Rhône-Alpes;07;1;03;093;Genestelle;275;8;283
84;Auvergne-Rhône-Alpes;07;2;17;094;Gilhac-et-Bruzac;178;3;181
84;Auvergne-Rhône-Alpes;07;3;08;095;Gilhoc-sur-Ormèze;464;4;468
84;Auvergne-Rhône-Alpes;07;2;06;096;Gluiras;368;3;371
84;Auvergne-Rhône-Alpes;07;3;14;097;Glun;693;18;711
84;Auvergne-Rhône-Alpes;07;2;10;098;Gourdon;80;4;84
84;Auvergne-Rhône-Alpes;07;2;05;099;Gras;618;22;640
84;Auvergne-Rhône-Alpes;07;1;16;100;Gravières;513;19;532
84;Auvergne-Rhône-Alpes;07;1;15;101;Grospierres;911;21;932
84;Auvergne-Rhône-Alpes;07;3;07;102;Guilherand-Granges;10965;189;11154
84;Auvergne-Rhône-Alpes;07;3;06;103;Saint-Julien-d'Intres;310;3;313
84;Auvergne-Rhône-Alpes;07;3;06;104;Issamoulenc;93;0;93
84;Auvergne-Rhône-Alpes;07;1;13;105;Issanlas;100;3;103
84;Auvergne-Rhône-Alpes;07;1;13;106;Issarlès;125;1;126
84;Auvergne-Rhône-Alpes;07;1;13;107;Jaujac;1291;25;1316
84;Auvergne-Rhône-Alpes;07;3;06;108;Jaunac;117;8;125
84;Auvergne-Rhône-Alpes;07;1;15;109;Joannas;295;6;301
84;Auvergne-Rhône-Alpes;07;1;16;110;Joyeuse;1741;28;1769
84;Auvergne-Rhône-Alpes;07;1;03;111;Juvinas;175;3;178
84;Auvergne-Rhône-Alpes;07;1;03;112;Labastide-sur-Bésorgues;259;5;264
84;Auvergne-Rhône-Alpes;07;1;15;113;Labastide-de-Virac;311;7;318
84;Auvergne-Rhône-Alpes;07;3;08;114;Labatie-d'Andaure;199;2;201
84;Auvergne-Rhône-Alpes;07;1;15;115;Labeaume;674;11;685
84;Auvergne-Rhône-Alpes;07;1;03;116;Labégude;1359;21;1380
84;Auvergne-Rhône-Alpes;07;1;16;117;Lablachère;2213;38;2251
84;Auvergne-Rhône-Alpes;07;1;16;118;Laboule;145;6;151
84;Auvergne-Rhône-Alpes;07;1;13;119;Le Lac-d'Issarlès;252;5;257
84;Auvergne-Rhône-Alpes;07;1;03;120;Lachamp-Raphaël;58;0;58
84;Auvergne-Rhône-Alpes;07;1;13;121;Lachapelle-Graillouse;191;0;191
84;Auvergne-Rhône-Alpes;07;1;04;122;Lachapelle-sous-Aubenas;1699;48;1747
84;Auvergne-Rhône-Alpes;07;3;06;123;Lachapelle-sous-Chanéac;163;6;169
84;Auvergne-Rhône-Alpes;07;3;08;124;Lafarre;40;1;41
84;Auvergne-Rhône-Alpes;07;1;15;126;Lagorce;1179;24;1203
84;Auvergne-Rhône-Alpes;07;1;13;127;Lalevade-d'Ardèche;1131;13;1144
84;Auvergne-Rhône-Alpes;07;3;08;128;Lalouvesc;374;6;380
84;Auvergne-Rhône-Alpes;07;3;08;129;Lamastre;2361;40;2401
84;Auvergne-Rhône-Alpes;07;1;13;130;Lanarce;207;5;212
84;Auvergne-Rhône-Alpes;07;1;04;131;Lanas;448;42;490
84;Auvergne-Rhône-Alpes;07;1;15;132;Largentière;1573;50;1623
84;Auvergne-Rhône-Alpes;07;2;05;133;Larnas;250;3;253
84;Auvergne-Rhône-Alpes;07;1;15;134;Laurac-en-Vivarais;1032;27;1059
84;Auvergne-Rhône-Alpes;07;1;13;136;Laveyrune;104;1;105
84;Auvergne-Rhône-Alpes;07;1;13;137;Lavillatte;43;0;43
84;Auvergne-Rhône-Alpes;07;1;12;138;Lavilledieu;2230;50;2280
84;Auvergne-Rhône-Alpes;07;1;03;139;Laviolle;103;0;103
84;Auvergne-Rhône-Alpes;07;3;14;140;Lemps;797;24;821
84;Auvergne-Rhône-Alpes;07;1;04;141;Lentillères;234;7;241
84;Auvergne-Rhône-Alpes;07;1;13;142;Lespéron;314;9;323
84;Auvergne-Rhône-Alpes;07;3;11;143;Limony;785;17;802
84;Auvergne-Rhône-Alpes;07;1;16;144;Loubaresse;49;2;51
84;Auvergne-Rhône-Alpes;07;1;12;145;Lussas;1154;18;1172
84;Auvergne-Rhône-Alpes;07;2;10;146;Lyas;598;16;614
84;Auvergne-Rhône-Alpes;07;1;16;147;Malarce-sur-la-Thines;242;5;247
84;Auvergne-Rhône-Alpes;07;1;16;148;Malbosc;146;6;152
84;Auvergne-Rhône-Alpes;07;2;06;149;Marcols-les-Eaux;279;5;284
84;Auvergne-Rhône-Alpes;07;3;06;150;Mariac;551;16;567
84;Auvergne-Rhône-Alpes;07;3;06;151;Mars;254;12;266
84;Auvergne-Rhône-Alpes;07;3;14;152;Mauves;1191;26;1217
84;Auvergne-Rhône-Alpes;07;1;13;153;Mayres;264;8;272
84;Auvergne-Rhône-Alpes;07;1;13;154;Mazan-l'Abbaye;122;2;124
84;Auvergne-Rhône-Alpes;07;1;04;155;Mercuer;1245;31;1276
84;Auvergne-Rhône-Alpes;07;1;13;156;Meyras;929;29;958
84;Auvergne-Rhône-Alpes;07;2;09;157;Meysse;1372;13;1385
84;Auvergne-Rhône-Alpes;07;1;03;158;Mézilhac;97;0;97
84;Auvergne-Rhône-Alpes;07;1;12;159;Mirabel;736;10;746
84;Auvergne-Rhône-Alpes;07;3;02;160;Monestier;62;1;63
84;Auvergne-Rhône-Alpes;07;1;13;161;Montpezat-sous-Bauzon;737;23;760
84;Auvergne-Rhône-Alpes;07;1;15;162;Montréal;577;13;590
84;Auvergne-Rhône-Alpes;07;1;16;163;Montselgues;83;5;88
84;Auvergne-Rhône-Alpes;07;3;06;165;Belsentes;553;22;575
84;Auvergne-Rhône-Alpes;07;3;08;166;Nozières;244;2;246
84;Auvergne-Rhône-Alpes;07;2;06;167;Les Ollières-sur-Eyrieux;1011;23;1034
84;Auvergne-Rhône-Alpes;07;1;15;168;Orgnac-l'Aven;587;9;596
84;Auvergne-Rhône-Alpes;07;3;11;169;Ozon;380;1;381
84;Auvergne-Rhône-Alpes;07;3;08;170;Pailharès;243;6;249
84;Auvergne-Rhône-Alpes;07;1;16;171;Payzac;538;8;546
84;Auvergne-Rhône-Alpes;07;3;11;172;Peaugres;2305;52;2357
84;Auvergne-Rhône-Alpes;07;1;13;173;Péreyres;50;0;50
84;Auvergne-Rhône-Alpes;07;3;11;174;Peyraud;494;8;502
84;Auvergne-Rhône-Alpes;07;1;13;175;Le Plagnal;77;2;79
84;Auvergne-Rhône-Alpes;07;1;16;176;Planzolles;158;2;160
84;Auvergne-Rhône-Alpes;07;3;14;177;Plats;843;19;862
84;Auvergne-Rhône-Alpes;07;1;13;178;Pont-de-Labeaume;583;7;590
84;Auvergne-Rhône-Alpes;07;2;10;179;Pourchères;135;1;136
84;Auvergne-Rhône-Alpes;07;2;09;181;Le Pouzin;2883;33;2916
84;Auvergne-Rhône-Alpes;07;1;13;182;Prades;1180;31;1211
84;Auvergne-Rhône-Alpes;07;1;15;183;Pradons;496;8;504
84;Auvergne-Rhône-Alpes;07;2;10;184;Pranles;510;11;521
84;Auvergne-Rhône-Alpes;07;3;08;185;Préaux;709;9;718
84;Auvergne-Rhône-Alpes;07;2;10;186;Privas;8567;259;8826
84;Auvergne-Rhône-Alpes;07;1;15;187;Prunet;136;2;138
84;Auvergne-Rhône-Alpes;07;3;08;188;Quintenas;1707;31;1738
84;Auvergne-Rhône-Alpes;07;1;16;189;Ribes;325;7;332
84;Auvergne-Rhône-Alpes;07;1;15;190;Rochecolombe;218;7;225
84;Auvergne-Rhône-Alpes;07;2;09;191;Rochemaure;2278;58;2336
84;Auvergne-Rhône-Alpes;07;3;06;192;Rochepaule;240;7;247
84;Auvergne-Rhône-Alpes;07;1;15;193;Rocher;275;4;279
84;Auvergne-Rhône-Alpes;07;2;10;194;Rochessauve;461;9;470
84;Auvergne-Rhône-Alpes;07;1;06;195;La Rochette;63;2;65
84;Auvergne-Rhône-Alpes;07;1;16;196;Rocles;257;4;261
84;Auvergne-Rhône-Alpes;07;3;02;197;Roiffieux;2724;84;2808
84;Auvergne-Rhône-Alpes;07;2;09;198;Rompon;1131;26;1157
84;Auvergne-Rhône-Alpes;07;1;16;199;Rosières;1280;26;1306
84;Auvergne-Rhône-Alpes;07;1;13;200;Le Roux;61;1;62
84;Auvergne-Rhône-Alpes;07;1;15;201;Ruoms;2281;22;2303
84;Auvergne-Rhône-Alpes;07;1;16;202;Sablières;174;4;178
84;Auvergne-Rhône-Alpes;07;1;13;203;Sagnes-et-Goudoulet;116;3;119
84;Auvergne-Rhône-Alpes;07;3;06;204;Saint-Agrève;2350;59;2409
84;Auvergne-Rhône-Alpes;07;3;08;205;Saint-Alban-d'Ay;1420;22;1442
84;Auvergne-Rhône-Alpes;07;1;13;206;Saint-Alban-en-Montagne;69;2;71
84;Auvergne-Rhône-Alpes;07;1;15;207;Saint-Alban-Auriolles;1083;16;1099
84;Auvergne-Rhône-Alpes;07;1;12;208;Saint-Andéol-de-Berg;121;3;124
84;Auvergne-Rhône-Alpes;07;3;06;209;Saint-Andéol-de-Fourchades;55;2;57
84;Auvergne-Rhône-Alpes;07;1;03;210;Saint-Andéol-de-Vals;516;11;527
84;Auvergne-Rhône-Alpes;07;1;16;211;Saint-André-de-Cruzières;462;14;476
84;Auvergne-Rhône-Alpes;07;3;06;212;Saint-André-en-Vivarais;210;1;211
84;Auvergne-Rhône-Alpes;07;1;16;213;Saint-André-Lachamp;153;4;157
84;Auvergne-Rhône-Alpes;07;2;17;214;Saint-Apollinaire-de-Rias;206;2;208
84;Auvergne-Rhône-Alpes;07;3;06;215;Saint-Barthélemy-le-Meil;201;5;206
84;Auvergne-Rhône-Alpes;07;3;08;216;Saint-Barthélemy-Grozon;497;21;518
84;Auvergne-Rhône-Alpes;07;3;14;217;Saint-Barthélemy-le-Plain;842;12;854
84;Auvergne-Rhône-Alpes;07;3;08;218;Saint-Basile;340;9;349
84;Auvergne-Rhône-Alpes;07;2;09;219;Saint-Bauzile;326;5;331
84;Auvergne-Rhône-Alpes;07;3;06;220;Saint-Christol;105;0;105
84;Auvergne-Rhône-Alpes;07;2;17;221;Saint-Cierge-la-Serre;248;9;257
84;Auvergne-Rhône-Alpes;07;3;06;222;Saint-Cierge-sous-le-Cheylard;211;5;216
84;Auvergne-Rhône-Alpes;07;1;13;223;Saint-Cirgues-de-Prades;139;2;141
84;Auvergne-Rhône-Alpes;07;1;13;224;Saint-Cirgues-en-Montagne;222;13;235
84;Auvergne-Rhône-Alpes;07;3;01;225;Saint-Clair;1225;47;1272
84;Auvergne-Rhône-Alpes;07;3;06;226;Saint-Clément;90;0;90
84;Auvergne-Rhône-Alpes;07;3;01;227;Saint-Cyr;1404;47;1451
84;Auvergne-Rhône-Alpes;07;3;11;228;Saint-Désirat;849;21;870
84;Auvergne-Rhône-Alpes;07;1;04;229;Saint-Didier-sous-Aubenas;930;25;955
84;Auvergne-Rhône-Alpes;07;1;04;230;Saint-Étienne-de-Boulogne;414;14;428
84;Auvergne-Rhône-Alpes;07;1;04;231;Saint-Étienne-de-Fontbellon;2880;83;2963
84;Auvergne-Rhône-Alpes;07;1;13;232;Saint-Étienne-de-Lugdarès;408;10;418
84;Auvergne-Rhône-Alpes;07;2;06;233;Saint-Étienne-de-Serre;207;4;211
84;Auvergne-Rhône-Alpes;07;3;11;234;Saint-Étienne-de-Valoux;296;3;299
84;Auvergne-Rhône-Alpes;07;1;13;235;Sainte-Eulalie;213;3;216
84;Auvergne-Rhône-Alpes;07;3;08;236;Saint-Félicien;1125;20;1145
84;Auvergne-Rhône-Alpes;07;2;17;237;Saint-Fortunat-sur-Eyrieux;784;13;797
84;Auvergne-Rhône-Alpes;07;1;16;238;Saint-Genest-de-Beauzon;337;7;344
84;Auvergne-Rhône-Alpes;07;3;06;239;Saint-Genest-Lachamp;113;2;115
84;Auvergne-Rhône-Alpes;07;3;17;240;Saint-Georges-les-Bains;2408;51;2459
84;Auvergne-Rhône-Alpes;07;1;12;241;Saint-Germain;710;17;727
84;Auvergne-Rhône-Alpes;07;1;12;242;Saint-Gineys-en-Coiron;114;4;118
84;Auvergne-Rhône-Alpes;07;3;11;243;Saint-Jacques-d'Atticieux;290;5;295
84;Auvergne-Rhône-Alpes;07;2;17;244;Saint-Jean-Chambre;254;4;258
84;Auvergne-Rhône-Alpes;07;3;14;245;Saint-Jean-de-Muzols;2507;70;2577
84;Auvergne-Rhône-Alpes;07;1;12;247;Saint-Jean-le-Centenier;856;10;866
84;Auvergne-Rhône-Alpes;07;3;06;248;Saint-Jean-Roure;242;11;253
84;Auvergne-Rhône-Alpes;07;3;06;249;Saint-Jeure-d'Andaure;93;2;95
84;Auvergne-Rhône-Alpes;07;3;08;250;Saint-Jeure-d'Ay;493;9;502
84;Auvergne-Rhône-Alpes;07;1;03;251;Saint-Joseph-des-Bancs;174;3;177
84;Auvergne-Rhône-Alpes;07;2;06;253;Saint-Julien-du-Gua;169;3;172
84;Auvergne-Rhône-Alpes;07;1;03;254;Saint-Julien-du-Serre;865;20;885
84;Auvergne-Rhône-Alpes;07;2;09;255;Saint-Julien-en-Saint-Alban;1434;37;1471
84;Auvergne-Rhône-Alpes;07;2;17;257;Saint-Julien-le-Roux;118;2;120
84;Auvergne-Rhône-Alpes;07;3;02;258;Saint-Julien-Vocance;223;3;226
84;Auvergne-Rhône-Alpes;07;2;05;259;Saint-Just-d'Ardèche;1681;37;1718
84;Auvergne-Rhône-Alpes;07;2;09;260;Saint-Lager-Bressac;953;20;973
84;Auvergne-Rhône-Alpes;07;2;17;261;Saint-Laurent-du-Pape;1600;33;1633
84;Auvergne-Rhône-Alpes;07;1;13;262;Saint-Laurent-les-Bains-Laval-d'Aurelle;176;3;179
84;Auvergne-Rhône-Alpes;07;1;12;263;Saint-Laurent-sous-Coiron;116;3;119
84;Auvergne-Rhône-Alpes;07;2;05;264;Saint-Marcel-d'Ardèche;2379;69;2448
84;Auvergne-Rhône-Alpes;07;3;01;265;Saint-Marcel-lès-Annonay;1383;35;1418
84;Auvergne-Rhône-Alpes;07;1;16;266;Sainte-Marguerite-Lafigère;113;2;115
84;Auvergne-Rhône-Alpes;07;1;06;267;Saint-Martial;268;4;272
84;Auvergne-Rhône-Alpes;07;2;05;268;Saint-Martin-d'Ardèche;947;12;959
84;Auvergne-Rhône-Alpes;07;3;06;269;Saint-Martin-de-Valamas;1092;39;1131
84;Auvergne-Rhône-Alpes;07;2;09;270;Saint-Martin-sur-Lavezon;433;12;445
84;Auvergne-Rhône-Alpes;07;1;15;272;Saint-Maurice-d'Ardèche;332;10;342
84;Auvergne-Rhône-Alpes;07;1;12;273;Saint-Maurice-d'Ibie;216;1;217
84;Auvergne-Rhône-Alpes;07;2;06;274;Saint-Maurice-en-Chalencon;200;5;205
84;Auvergne-Rhône-Alpes;07;1;16;275;Saint-Mélany;100;3;103
84;Auvergne-Rhône-Alpes;07;3;06;276;Saint-Michel-d'Aurance;265;20;285
84;Auvergne-Rhône-Alpes;07;1;04;277;Saint-Michel-de-Boulogne;148;5;153
84;Auvergne-Rhône-Alpes;07;2;06;278;Saint-Michel-de-Chabrillanoux;404;9;413
84;Auvergne-Rhône-Alpes;07;2;05;279;Saint-Montan;1926;44;1970
84;Auvergne-Rhône-Alpes;07;1;16;280;Saint-Paul-le-Jeune;965;19;984
84;Auvergne-Rhône-Alpes;07;3;07;281;Saint-Péray;7538;216;7754
84;Auvergne-Rhône-Alpes;07;1;13;282;Saint-Pierre-de-Colombier;440;28;468
84;Auvergne-Rhône-Alpes;07;2;09;283;Saint-Pierre-la-Roche;62;2;64
84;Auvergne-Rhône-Alpes;07;1;16;284;Saint-Pierre-Saint-Jean;181;4;185
84;Auvergne-Rhône-Alpes;07;3;08;285;Saint-Pierre-sur-Doux;112;1;113
84;Auvergne-Rhône-Alpes;07;3;06;286;Saint-Pierreville;517;2;519
84;Auvergne-Rhône-Alpes;07;1;12;287;Saint-Pons;294;13;307
84;Auvergne-Rhône-Alpes;07;2;10;288;Saint-Priest;1320;45;1365
84;Auvergne-Rhône-Alpes;07;1;04;289;Saint-Privat;1664;57;1721
84;Auvergne-Rhône-Alpes;07;3;08;290;Saint-Prix;270;7;277
84;Auvergne-Rhône-Alpes;07;1;15;291;Saint-Remèze;854;23;877
84;Auvergne-Rhône-Alpes;07;3;08;292;Saint-Romain-d'Ay;1221;30;1251
84;Auvergne-Rhône-Alpes;07;3;07;293;Saint-Romain-de-Lerps;913;18;931
84;Auvergne-Rhône-Alpes;07;1;16;294;Saint-Sauveur-de-Cruzières;544;12;556
84;Auvergne-Rhône-Alpes;07;2;06;295;Saint-Sauveur-de-Montagut;1103;24;1127
84;Auvergne-Rhône-Alpes;07;1;04;296;Saint-Sernin;1772;51;1823
84;Auvergne-Rhône-Alpes;07;3;08;297;Saint-Sylvestre;509;7;516
84;Auvergne-Rhône-Alpes;07;2;09;298;Saint-Symphorien-sous-Chomérac;787;32;819
84;Auvergne-Rhône-Alpes;07;3;08;299;Saint-Symphorien-de-Mahun;119;4;123
84;Auvergne-Rhône-Alpes;07;2;12;300;Saint-Thomé;465;16;481
84;Auvergne-Rhône-Alpes;07;3;08;301;Saint-Victor;946;14;960
84;Auvergne-Rhône-Alpes;07;2;09;302;Saint-Vincent-de-Barrès;833;22;855
84;Auvergne-Rhône-Alpes;07;2;06;303;Saint-Vincent-de-Durfort;269;3;272
84;Auvergne-Rhône-Alpes;07;1;15;304;Salavas;711;13;724
84;Auvergne-Rhône-Alpes;07;1;16;305;Les Salelles;383;13;396
84;Auvergne-Rhône-Alpes;07;1;15;306;Sampzon;240;7;247
84;Auvergne-Rhône-Alpes;07;1;15;307;Sanilhac;448;9;457
84;Auvergne-Rhône-Alpes;07;3;11;308;Sarras;2242;35;2277
84;Auvergne-Rhône-Alpes;07;3;08;309;Satillieu;1501;28;1529
84;Auvergne-Rhône-Alpes;07;3;01;310;Savas;897;24;921
84;Auvergne-Rhône-Alpes;07;1;12;311;Sceautres;151;7;158
84;Auvergne-Rhône-Alpes;07;3;14;312;Sécheras;524;16;540
84;Auvergne-Rhône-Alpes;07;3;11;313;Serrières;1117;17;1134
84;Auvergne-Rhône-Alpes;07;2;17;314;Silhac;382;12;394
84;Auvergne-Rhône-Alpes;07;1;13;315;La Souche;376;8;384
84;Auvergne-Rhône-Alpes;07;3;17;316;Soyons;2299;51;2350
84;Auvergne-Rhône-Alpes;07;3;02;317;Talencieux;1111;29;1140
84;Auvergne-Rhône-Alpes;07;1;15;318;Tauriers;200;5;205
84;Auvergne-Rhône-Alpes;07;2;12;319;Le Teil;8841;210;9051
84;Auvergne-Rhône-Alpes;07;3;02;321;Thorrenc;255;7;262
84;Auvergne-Rhône-Alpes;07;1;13;322;Thueyts;1213;12;1225
84;Auvergne-Rhône-Alpes;07;3;17;323;Toulaud;1727;52;1779
84;Auvergne-Rhône-Alpes;07;3;14;324;Tournon-sur-Rhône;10835;586;11421
84;Auvergne-Rhône-Alpes;07;1;03;325;Ucel;2056;72;2128
84;Auvergne-Rhône-Alpes;07;1;13;326;Usclades-et-Rieutord;117;0;117
84;Auvergne-Rhône-Alpes;07;1;15;327;Uzer;415;14;429
84;Auvergne-Rhône-Alpes;07;1;15;328;Vagnas;603;17;620
84;Auvergne-Rhône-Alpes;07;1;16;329;Valgorge;420;8;428
84;Auvergne-Rhône-Alpes;07;1;15;330;Vallon-Pont-d'Arc;2435;39;2474
84;Auvergne-Rhône-Alpes;07;1;03;331;Vals-les-Bains;3495;66;3561
84;Auvergne-Rhône-Alpes;07;2;12;332;Valvignères;439;12;451
84;Auvergne-Rhône-Alpes;07;3;02;333;Vanosc;952;12;964
84;Auvergne-Rhône-Alpes;07;1;16;334;Les Vans;2653;57;2710
84;Auvergne-Rhône-Alpes;07;3;08;335;Vaudevant;209;2;211
84;Auvergne-Rhône-Alpes;07;1;16;336;Vernon;223;7;230
84;Auvergne-Rhône-Alpes;07;3;02;337;Vernosc-lès-Annonay;2594;83;2677
84;Auvergne-Rhône-Alpes;07;2;17;338;Vernoux-en-Vivarais;1970;33;2003
84;Auvergne-Rhône-Alpes;07;1;04;339;Vesseaux;2020;65;2085
84;Auvergne-Rhône-Alpes;07;2;10;340;Veyras;1510;48;1558
84;Auvergne-Rhône-Alpes;07;1;12;341;Villeneuve-de-Berg;3028;107;3135
84;Auvergne-Rhône-Alpes;07;3;02;342;Villevocance;1183;26;1209
84;Auvergne-Rhône-Alpes;07;1;04;343;Vinezac;1410;40;1450
84;Auvergne-Rhône-Alpes;07;3;11;344;Vinzieux;483;3;486
84;Auvergne-Rhône-Alpes;07;3;14;345;Vion;944;19;963
84;Auvergne-Rhône-Alpes;07;2;05;346;Viviers;3667;64;3731
84;Auvergne-Rhône-Alpes;07;3;02;347;Vocance;623;11;634
84;Auvergne-Rhône-Alpes;07;1;15;348;Vogüé;1081;15;1096
84;Auvergne-Rhône-Alpes;07;2;17;349;La Voulte-sur-Rhône;4828;57;4885
44;Grand Est;08;2;11;001;Acy-Romance;469;3;472
44;Grand Est;08;1;18;003;Aiglemont;1642;36;1678
44;Grand Est;08;2;08;004;Aire;244;1;245
44;Grand Est;08;2;08;005;Alincourt;159;2;161
44;Grand Est;08;4;01;006;Alland'Huy-et-Sausseuil;252;5;257
44;Grand Est;08;2;11;008;Amagne;728;5;733
44;Grand Est;08;2;11;010;Ambly-Fleury;133;4;137
44;Grand Est;08;1;12;011;Anchamps;212;4;216
44;Grand Est;08;3;19;013;Angecourt;388;5;393
44;Grand Est;08;2;08;014;Annelles;143;6;149
44;Grand Est;08;1;17;015;Antheny;100;5;105
44;Grand Est;08;1;17;016;Aouste;207;2;209
44;Grand Est;08;4;01;017;Apremont;118;3;121
44;Grand Est;08;4;01;018;Ardeuil-et-Montfauxelles;76;2;78
44;Grand Est;08;4;19;019;Les Grandes-Armoises;59;4;63
44;Grand Est;08;4;19;020;Les Petites-Armoises;60;0;60
44;Grand Est;08;2;11;021;Arnicourt;153;4;157
44;Grand Est;08;1;05;022;Arreux;317;12;329
44;Grand Est;08;3;19;023;Artaise-le-Vivier;65;1;66
44;Grand Est;08;2;08;024;Asfeld;1079;18;1097
44;Grand Est;08;4;01;025;Attigny;1112;21;1133
44;Grand Est;08;1;17;026;Aubigny-les-Pothées;307;8;315
44;Grand Est;08;2;17;027;Auboncourt-Vauzelles;97;1;98
44;Grand Est;08;1;09;028;Aubrives;982;20;1002
44;Grand Est;08;3;03;029;Auflance;85;2;87
44;Grand Est;08;1;13;030;Auge;58;0;58
44;Grand Est;08;4;01;031;Aure;41;3;44
44;Grand Est;08;2;08;032;Aussonce;220;3;223
44;Grand Est;08;4;19;033;Authe;91;2;93
44;Grand Est;08;3;03;034;Autrecourt-et-Pourron;337;6;343
44;Grand Est;08;4;19;035;Autruche;54;4;58
44;Grand Est;08;4;01;036;Autry;108;6;114
44;Grand Est;08;1;13;037;Auvillers-les-Forges;891;10;901
44;Grand Est;08;2;08;038;Avançon;340;8;348
44;Grand Est;08;2;08;039;Avaux;480;5;485
44;Grand Est;08;1;10;040;Les Ayvelles;881;20;901
44;Grand Est;08;1;10;041;Baâlons;204;8;212
44;Grand Est;08;3;16;043;Balan;1629;32;1661
44;Grand Est;08;2;08;044;Balham;169;1;170
44;Grand Est;08;4;19;045;Ballay;257;12;269
44;Grand Est;08;2;08;046;Banogne-Recouvrance;160;3;163
44;Grand Est;08;1;17;047;Barbaise;108;0;108
44;Grand Est;08;2;11;048;Barby;407;7;414
44;Grand Est;08;4;19;049;Bar-lès-Buzancy;129;2;131
44;Grand Est;08;4;19;052;Bayonville;73;2;75
44;Grand Est;08;3;16;053;Bazeilles;2405;182;2587
44;Grand Est;08;3;03;055;Beaumont-en-Argonne;424;7;431
44;Grand Est;08;4;01;056;Beffu-et-le-Morthomme;44;0;44
44;Grand Est;08;4;19;057;Belleville-et-Châtillon-sur-Bar;244;23;267
44;Grand Est;08;1;04;058;Belval;221;6;227
44;Grand Est;08;4;19;059;Belval-Bois-des-Dames;28;1;29
44;Grand Est;08;2;08;060;Bergnicourt;298;1;299
44;Grand Est;08;4;19;061;La Berlière;37;2;39
44;Grand Est;08;2;11;062;Bertoncourt;126;5;131
44;Grand Est;08;3;19;063;La Besace;133;1;134
44;Grand Est;08;2;11;064;Biermes;310;4;314
44;Grand Est;08;3;03;065;Bièvres;46;1;47
44;Grand Est;08;2;08;066;Bignicourt;67;1;68
44;Grand Est;08;3;03;067;Blagny;1110;17;1127
44;Grand Est;08;1;17;069;Blanchefosse-et-Bay;142;2;144
44;Grand Est;08;2;08;070;Blanzy-la-Salonnaise;376;6;382
44;Grand Est;08;1;13;071;Blombay;135;2;137
44;Grand Est;08;1;17;073;Bossus-lès-Rumigny;93;2;95
44;Grand Est;08;4;01;074;Bouconville;57;2;59
44;Grand Est;08;4;19;075;Boult-aux-Bois;138;3;141
44;Grand Est;08;1;10;076;Boulzicourt;971;20;991
44;Grand Est;08;4;01;077;Bourcq;52;1;53
44;Grand Est;08;1;13;078;Bourg-Fidèle;845;10;855
44;Grand Est;08;1;10;080;Bouvellemont;125;1;126
44;Grand Est;08;1;02;081;Bogny-sur-Meuse;5011;71;5082
44;Grand Est;08;4;01;082;Brécy-Brières;79;4;83
44;Grand Est;08;3;03;083;Brévilly;359;6;365
44;Grand Est;08;2;08;084;Brienne-sur-Aisne;274;2;276
44;Grand Est;08;4;19;085;Brieulles-sur-Bar;225;5;230
44;Grand Est;08;4;19;086;Briquenay;90;8;98
44;Grand Est;08;1;13;087;Brognon;141;2;143
44;Grand Est;08;3;19;088;Bulson;133;4;137
44;Grand Est;08;4;19;089;Buzancy;372;8;380
44;Grand Est;08;3;03;090;Carignan;2875;44;2919
44;Grand Est;08;4;01;092;Cauroy;189;8;197
44;Grand Est;08;1;17;094;Cernion;56;0;56
44;Grand Est;08;1;10;095;Chagny;179;5;184
44;Grand Est;08;1;10;096;Chalandry-Elaire;715;15;730
44;Grand Est;08;4;01;097;Challerange;437;7;444
44;Grand Est;08;4;01;098;Champigneulle;54;2;56
44;Grand Est;08;1;10;099;Champigneul-sur-Vence;122;4;126
44;Grand Est;08;1;17;100;Champlin;73;0;73
44;Grand Est;08;3;15;101;La Chapelle;165;4;169
44;Grand Est;08;2;17;102;Chappes;87;5;92
44;Grand Est;08;4;01;103;Charbogne;221;4;225
44;Grand Est;08;4;01;104;Chardeny;61;0;61
44;Grand Est;08;1;98;105;Charleville-Mézières;46388;1045;47433
44;Grand Est;08;1;09;106;Charnois;71;0;71
44;Grand Est;08;2;08;107;Château-Porcien;1323;16;1339
44;Grand Est;08;4;01;109;Chatel-Chéhéry;138;3;141
44;Grand Est;08;1;13;110;Le Châtelet-sur-Sormonne;168;1;169
44;Grand Est;08;2;08;111;Le Châtelet-sur-Retourne;776;2;778
44;Grand Est;08;2;17;113;Chaumont-Porcien;506;10;516
44;Grand Est;08;3;19;115;Chémery-Chéhéry;528;4;532
44;Grand Est;08;4;19;116;Bairon et ses environs;1026;18;1044
44;Grand Est;08;2;17;117;Chesnois-Auboncourt;160;0;160
44;Grand Est;08;3;14;119;Cheveuges;456;7;463
44;Grand Est;08;4;01;120;Chevières;45;2;47
44;Grand Est;08;1;13;121;Chilly;135;5;140
44;Grand Est;08;1;09;122;Chooz;756;15;771
44;Grand Est;08;4;01;123;Chuffilly-Roche;70;1;71
44;Grand Est;08;1;17;124;Clavy-Warby;344;9;353
44;Grand Est;08;1;04;125;Cliron;407;9;416
44;Grand Est;08;2;08;126;Condé-lès-Herpy;222;4;226
44;Grand Est;08;4;01;128;Condé-lès-Autry;63;3;66
44;Grand Est;08;4;01;130;Contreuve;83;1;84
44;Grand Est;08;4;01;131;Cornay;65;3;68
44;Grand Est;08;2;11;132;Corny-Machéroménil;193;2;195
44;Grand Est;08;2;11;133;Coucy;518;5;523
44;Grand Est;08;4;01;134;Coulommes-et-Marqueny;75;0;75
44;Grand Est;08;4;19;135;La Croix-aux-Bois;153;3;156
44;Grand Est;08;3;16;136;Daigny;347;9;356
44;Grand Est;08;1;05;137;Damouzy;448;11;459
44;Grand Est;08;3;03;138;Les Deux-Villes;253;8;261
44;Grand Est;08;1;02;139;Deville;1042;9;1051
44;Grand Est;08;1;10;140;Dom-le-Mesnil;1064;20;1084
44;Grand Est;08;1;17;141;Dommery;183;5;188
44;Grand Est;08;3;14;142;Donchery;2008;27;2035
44;Grand Est;08;2;17;143;Doumely-Bégny;73;0;73
44;Grand Est;08;2;11;144;Doux;103;1;104
44;Grand Est;08;3;03;145;Douzy;2182;39;2221
44;Grand Est;08;2;17;146;Draize;91;2;93
44;Grand Est;08;4;01;147;Dricourt;80;8;88
44;Grand Est;08;2;08;148;L'Écaille;272;4;276
44;Grand Est;08;1;17;149;L'Échelle;142;5;147
44;Grand Est;08;2;08;150;Écly;169;5;174
44;Grand Est;08;4;01;151;Écordal;297;11;308
44;Grand Est;08;3;03;153;Escombres-et-le-Chesnois;344;4;348
44;Grand Est;08;1;17;154;Estrebay;82;3;85
44;Grand Est;08;1;13;155;Étalle;99;1;100
44;Grand Est;08;1;13;156;Éteignières;495;7;502
44;Grand Est;08;1;10;158;Étrépigny;290;5;295
44;Grand Est;08;3;03;159;Euilly-et-Lombut;110;3;113
44;Grand Est;08;1;10;160;Évigny;189;4;193
44;Grand Est;08;4;01;161;Exermont;36;1;37
44;Grand Est;08;1;04;162;Fagnon;344;6;350
44;Grand Est;08;2;17;163;Faissault;260;3;263
44;Grand Est;08;4;01;164;Falaise;340;7;347
44;Grand Est;08;2;17;165;Faux;59;3;62
44;Grand Est;08;1;12;166;Fépin;258;9;267
44;Grand Est;08;1;17;167;La Férée;73;2;75
44;Grand Est;08;3;03;168;La Ferté-sur-Chiers;175;4;179
44;Grand Est;08;1;17;169;Flaignes-Havys;96;7;103
44;Grand Est;08;3;15;170;Fleigneux;222;3;225
44;Grand Est;08;4;01;171;Fléville;94;4;98
44;Grand Est;08;1;13;172;Fligny;177;1;178
44;Grand Est;08;1;10;173;Flize;1708;47;1755
44;Grand Est;08;3;15;174;Floing;2293;54;2347
44;Grand Est;08;1;09;175;Foisches;242;8;250
44;Grand Est;08;4;19;176;Fossé;56;1;57
44;Grand Est;08;2;17;178;Fraillicourt;184;5;189
44;Grand Est;08;3;16;179;Francheval;589;13;602
44;Grand Est;08;1;07;180;La Francheville;1664;40;1704
44;Grand Est;08;1;17;182;Le Fréty;57;1;58
44;Grand Est;08;1;09;183;Fromelennes;1046;24;1070
44;Grand Est;08;3;03;184;Fromy;84;2;86
44;Grand Est;08;1;12;185;Fumay;3181;47;3228
44;Grand Est;08;4;19;186;Germont;49;0;49
44;Grand Est;08;1;18;187;Gernelle;312;8;320
44;Grand Est;08;1;18;188;Gespunsart;995;17;1012
44;Grand Est;08;1;17;189;Girondelle;165;2;167
44;Grand Est;08;1;09;190;Givet;6343;144;6487
44;Grand Est;08;3;15;191;Givonne;1056;27;1083
44;Grand Est;08;2;17;192;Givron;89;0;89
44;Grand Est;08;4;01;193;Givry;271;6;277
44;Grand Est;08;3;15;194;Glaire;832;12;844
44;Grand Est;08;2;08;195;Gomont;324;3;327
44;Grand Est;08;2;17;196;Grandchamp;99;3;102
44;Grand Est;08;4;01;197;Grandham;37;3;40
44;Grand Est;08;4;01;198;Grandpré;514;17;531
44;Grand Est;08;1;18;199;La Grandville;790;17;807
44;Grand Est;08;4;01;200;Grivy-Loisy;184;4;188
44;Grand Est;08;1;17;201;Gruyères;103;2;105
44;Grand Est;08;1;13;202;Gué-d'Hossus;513;10;523
44;Grand Est;08;1;10;203;Guignicourt-sur-Vence;274;6;280
44;Grand Est;08;4;01;204;Guincourt;78;1;79
44;Grand Est;08;2;17;205;Hagnicourt;70;0;70
44;Grand Est;08;1;13;206;Ham-les-Moines;367;10;377
44;Grand Est;08;1;09;207;Ham-sur-Meuse;228;4;232
44;Grand Est;08;1;17;208;Hannappes;134;1;135
44;Grand Est;08;1;10;209;Hannogne-Saint-Martin;463;8;471
44;Grand Est;08;2;08;210;Hannogne-Saint-Rémy;113;4;117
44;Grand Est;08;3;19;211;Haraucourt;720;4;724
44;Grand Est;08;1;13;212;Harcy;504;10;514
44;Grand Est;08;1;12;214;Hargnies;489;3;492
44;Grand Est;08;4;19;215;Harricourt;44;2;46
44;Grand Est;08;1;04;216;Haudrecy;314;13;327
44;Grand Est;08;1;02;217;Haulmé;87;0;87
44;Grand Est;08;1;02;218;Les Hautes-Rivières;1382;24;1406
44;Grand Est;08;2;08;219;Hauteville;118;1;119
44;Grand Est;08;4;01;220;Hauviné;338;8;346
44;Grand Est;08;1;12;222;Haybes;1829;45;1874
44;Grand Est;08;3;03;223;Herbeuval;123;2;125
44;Grand Est;08;2;08;225;Herpy-l'Arlésienne;207;6;213
44;Grand Est;08;1;09;226;Hierges;167;4;171
44;Grand Est;08;1;10;228;La Horgne;161;5;166
44;Grand Est;08;2;08;229;Houdilcourt;130;7;137
44;Grand Est;08;1;05;230;Houldizy;392;6;398
44;Grand Est;08;3;15;232;Illy;413;9;422
44;Grand Est;08;4;19;233;Imécourt;45;1;46
44;Grand Est;08;2;08;234;Inaumont;115;0;115
44;Grand Est;08;1;18;235;Issancourt-et-Rumel;382;4;386
44;Grand Est;08;1;17;236;Jandun;301;10;311
44;Grand Est;08;1;02;237;Joigny-sur-Meuse;643;18;661
44;Grand Est;08;4;01;238;Jonval;98;3;101
44;Grand Est;08;2;08;239;Juniville;1247;28;1275
44;Grand Est;08;2;17;240;Justine-Herbigny;169;4;173
44;Grand Est;08;1;02;242;Laifour;423;7;430
44;Grand Est;08;1;17;243;Lalobbe;164;3;167
44;Grand Est;08;4;01;244;Lametz;73;3;76
44;Grand Est;08;4;01;245;Lançon;31;2;33
44;Grand Est;08;4;19;246;Landres-et-Saint-Georges;72;2;74
44;Grand Est;08;1;09;247;Landrichamps;135;2;137
44;Grand Est;08;1;17;248;Launois-sur-Vence;685;8;693
44;Grand Est;08;1;13;249;Laval-Morency;237;10;247
44;Grand Est;08;4;01;250;Leffincourt;187;1;188
44;Grand Est;08;1;17;251;Lépron-les-Vallées;73;2;75
44;Grand Est;08;3;03;252;Létanne;113;2;115
44;Grand Est;08;1;17;254;Liart;618;10;628
44;Grand Est;08;3;03;255;Linay;222;3;225
44;Grand Est;08;4;01;256;Liry;84;3;87
44;Grand Est;08;1;17;257;Logny-Bogny;154;3;157
44;Grand Est;08;4;01;259;Longwé;71;2;73
44;Grand Est;08;1;13;260;Lonny;619;8;627
44;Grand Est;08;2;17;262;Lucquy;571;34;605
44;Grand Est;08;1;18;263;Lumes;1114;26;1140
44;Grand Est;08;4;01;264;Machault;513;14;527
44;Grand Est;08;3;19;268;Maisoncelle-et-Villers;69;4;73
44;Grand Est;08;3;03;269;Malandry;78;1;79
44;Grand Est;08;4;01;271;Manre;102;1;103
44;Grand Est;08;1;17;272;Maranwez;56;0;56
44;Grand Est;08;1;17;273;Marby;73;1;74
44;Grand Est;08;4;01;274;Marcq;96;4;100
44;Grand Est;08;3;03;275;Margny;213;4;217
44;Grand Est;08;3;03;276;Margut;725;13;738
44;Grand Est;08;1;17;277;Marlemont;129;4;133
44;Grand Est;08;4;01;278;Marquigny;80;0;80
44;Grand Est;08;4;01;279;Mars-sous-Bourcq;62;2;64
44;Grand Est;08;4;01;280;Marvaux-Vieux;73;2;75
44;Grand Est;08;3;03;281;Matton-et-Clémency;469;10;479
44;Grand Est;08;1;13;282;Maubert-Fontaine;1031;72;1103
44;Grand Est;08;1;10;283;Mazerny;127;1;128
44;Grand Est;08;1;02;284;Les Mazures;878;23;901
44;Grand Est;08;2;08;286;Ménil-Annelles;116;5;121
44;Grand Est;08;2;08;287;Ménil-Lépinois;137;3;140
44;Grand Est;08;2;17;288;Mesmont;90;1;91
44;Grand Est;08;3;03;289;Messincourt;605;9;614
44;Grand Est;08;3;03;291;Mogues;240;5;245
44;Grand Est;08;3;03;293;Moiry;140;5;145
44;Grand Est;08;3;16;294;La Moncelle;132;2;134
44;Grand Est;08;1;10;295;Mondigny;187;4;191
44;Grand Est;08;4;01;296;Montcheutin;113;7;120
44;Grand Est;08;1;02;297;Montcornet;300;8;308
44;Grand Est;08;1;06;298;Montcy-Notre-Dame;1589;47;1636
44;Grand Est;08;3;19;300;Le Mont-Dieu;14;1;15
44;Grand Est;08;4;19;301;Montgon;69;3;72
44;Grand Est;08;1;02;302;Monthermé;2191;77;2268
44;Grand Est;08;4;01;303;Monthois;388;8;396
44;Grand Est;08;1;12;304;Montigny-sur-Meuse;80;2;82
44;Grand Est;08;1;10;305;Montigny-sur-Vence;244;2;246
44;Grand Est;08;2;11;306;Mont-Laurent;53;3;56
44;Grand Est;08;2;17;307;Montmeillant;83;1;84
44;Grand Est;08;4;01;308;Mont-Saint-Martin;89;0;89
44;Grand Est;08;4;01;309;Mont-Saint-Remy;58;1;59
44;Grand Est;08;4;01;310;Mouron;70;7;77
44;Grand Est;08;3;03;311;Mouzon;2227;39;2266
44;Grand Est;08;1;13;312;Murtin-et-Bogny;190;7;197
44;Grand Est;08;2;11;313;Nanteuil-sur-Aisne;146;2;148
44;Grand Est;08;2;08;314;Neuflize;843;25;868
44;Grand Est;08;1;17;315;Neufmaison;75;2;77
44;Grand Est;08;1;18;316;Neufmanil;993;14;1007
44;Grand Est;08;3;19;317;La Neuville-à-Maire;110;4;114
44;Grand Est;08;1;13;318;La Neuville-aux-Joûtes;355;2;357
44;Grand Est;08;1;13;319;Neuville-lez-Beaulieu;336;8;344
44;Grand Est;08;2;08;320;La Neuville-en-Tourne-à-Fuy;543;16;559
44;Grand Est;08;4;01;321;Neuville-Day;173;4;177
44;Grand Est;08;1;13;322;Neuville-lès-This;359;13;372
44;Grand Est;08;2;17;323;La Neuville-lès-Wasigny;160;0;160
44;Grand Est;08;2;17;324;Neuvizy;114;2;116
44;Grand Est;08;4;19;325;Noirval;25;2;27
44;Grand Est;08;4;19;326;Nouart;117;2;119
44;Grand Est;08;1;10;327;Nouvion-sur-Meuse;2241;36;2277
44;Grand Est;08;1;05;328;Nouzonville;5635;67;5702
44;Grand Est;08;2;17;329;Novion-Porcien;502;10;512
44;Grand Est;08;2;11;330;Novy-Chevrières;792;8;800
44;Grand Est;08;3;14;331;Noyers-Pont-Maugis;665;14;679
44;Grand Est;08;4;19;332;Oches;41;4;45
44;Grand Est;08;4;01;333;Olizy-Primat;235;8;243
44;Grand Est;08;1;10;334;Omicourt;40;3;43
44;Grand Est;08;1;10;335;Omont;79;1;80
44;Grand Est;08;3;03;336;Osnes;229;3;232
44;Grand Est;08;4;01;338;Pauvres;195;3;198
44;Grand Est;08;2;08;339;Perthes;306;4;310
44;Grand Est;08;2;08;340;Poilcourt-Sydney;174;4;178
44;Grand Est;08;1;10;341;Poix-Terron;870;40;910
44;Grand Est;08;3;16;342;Pouru-aux-Bois;239;5;244
44;Grand Est;08;3;16;343;Pouru-Saint-Remy;1144;22;1166
44;Grand Est;08;1;17;344;Prez;132;2;134
44;Grand Est;08;1;04;346;Prix-lès-Mézières;1355;34;1389
44;Grand Est;08;3;03;347;Puilly-et-Charbeaux;217;5;222
44;Grand Est;08;2;17;348;Puiseux;112;3;115
44;Grand Est;08;3;03;349;Pure;562;7;569
44;Grand Est;08;4;19;350;Quatre-Champs;238;3;241
44;Grand Est;08;4;01;351;Quilly;78;2;80
44;Grand Est;08;1;17;352;Raillicourt;208;2;210
44;Grand Est;08;1;09;353;Rancennes;720;19;739
44;Grand Est;08;3;19;354;Raucourt-et-Flaba;821;14;835
44;Grand Est;08;1;13;355;Regniowez;387;7;394
44;Grand Est;08;2;17;356;Remaucourt;178;1;179
44;Grand Est;08;3;19;357;Remilly-Aillicourt;779;21;800
44;Grand Est;08;1;13;358;Remilly-les-Pothées;255;3;258
44;Grand Est;08;2;17;360;Renneville;198;5;203
44;Grand Est;08;1;02;361;Renwez;1636;57;1693
44;Grand Est;08;2;11;362;Rethel;7445;294;7739
44;Grand Est;08;1;12;363;Revin;5825;122;5947
44;Grand Est;08;4;01;364;Rilly-sur-Aisne;128;0;128
44;Grand Est;08;1;13;365;Rimogne;1330;20;1350
44;Grand Est;08;2;17;366;Rocquigny;672;6;678
44;Grand Est;08;1;13;367;Rocroi;2266;29;2295
44;Grand Est;08;2;08;368;Roizy;221;3;224
44;Grand Est;08;2;17;369;La Romagne;131;3;134
44;Grand Est;08;1;17;370;Rouvroy-sur-Audry;571;6;577
44;Grand Est;08;2;17;372;Rubigny;66;0;66
44;Grand Est;08;1;17;373;Rumigny;284;4;288
44;Grand Est;08;4;01;374;La Sabotterie;125;0;125
44;Grand Est;08;3;03;375;Sachy;178;4;182
44;Grand Est;08;3;03;376;Sailly;250;5;255
44;Grand Est;08;3;14;377;Saint-Aignan;154;2;156
44;Grand Est;08;4;01;378;Saint-Clément-à-Arnes;108;0;108
44;Grand Est;08;4;01;379;Saint-Étienne-à-Arnes;243;10;253
44;Grand Est;08;2;08;380;Saint-Fergeux;216;4;220
44;Grand Est;08;2;08;381;Saint-Germainmont;818;12;830
44;Grand Est;08;2;17;382;Saint-Jean-aux-Bois;96;3;99
44;Grand Est;08;4;01;383;Saint-Juvin;101;4;105
44;Grand Est;08;4;01;384;Saint-Lambert-et-Mont-de-Jeux;143;3;146
44;Grand Est;08;1;18;385;Saint-Laurent;1066;170;1236
44;Grand Est;08;2;08;386;Saint-Loup-en-Champagne;343;3;346
44;Grand Est;08;4;01;387;Saint-Loup-Terrier;182;6;188
44;Grand Est;08;1;10;388;Saint-Marceau;344;11;355
44;Grand Est;08;1;13;389;Saint-Marcel;327;7;334
44;Grand Est;08;4;01;390;Sainte-Marie;79;3;82
44;Grand Est;08;3;15;391;Saint-Menges;941;15;956
44;Grand Est;08;4;01;392;Saint-Morel;190;11;201
44;Grand Est;08;4;01;393;Saint-Pierre-à-Arnes;66;0;66
44;Grand Est;08;4;19;394;Saint-Pierremont;72;3;75
44;Grand Est;08;1;10;395;Saint-Pierre-sur-Vence;144;4;148
44;Grand Est;08;2;08;396;Saint-Quentin-le-Petit;122;0;122
44;Grand Est;08;2;08;397;Saint-Remy-le-Petit;54;0;54
44;Grand Est;08;4;01;398;Sainte-Vaubourg;91;2;93
44;Grand Est;08;3;03;399;Sapogne-sur-Marche;138;3;141
44;Grand Est;08;1;10;400;Sapogne-et-Feuchères;515;12;527
44;Grand Est;08;4;01;401;Saulces-Champenoises;225;3;228
44;Grand Est;08;2;17;402;Saulces-Monclin;835;17;852
44;Grand Est;08;2;11;403;Sault-lès-Rethel;1928;15;1943
44;Grand Est;08;2;08;404;Sault-Saint-Remy;214;5;219
44;Grand Est;08;4;19;405;Sauville;235;9;244
44;Grand Est;08;4;01;406;Savigny-sur-Aisne;373;13;386
44;Grand Est;08;4;01;407;Séchault;59;0;59
44;Grand Est;08;1;05;408;Sécheval;561;10;571
44;Grand Est;08;3;99;409;Sedan;16376;354;16730
44;Grand Est;08;4;01;410;Semide;177;17;194
44;Grand Est;08;4;01;411;Semuy;88;0;88
44;Grand Est;08;4;01;412;Senuc;156;3;159
44;Grand Est;08;2;08;413;Seraincourt;257;3;260
44;Grand Est;08;2;17;415;Sery;329;13;342
44;Grand Est;08;2;11;416;Seuil;173;6;179
44;Grand Est;08;1;13;417;Sévigny-la-Forêt;281;8;289
44;Grand Est;08;2;08;418;Sévigny-Waleppe;223;3;226
44;Grand Est;08;1;17;419;Signy-l'Abbaye;1351;18;1369
44;Grand Est;08;1;13;420;Signy-le-Petit;1186;21;1207
44;Grand Est;08;3;03;421;Signy-Montlibert;94;1;95
44;Grand Est;08;1;10;422;Singly;135;4;139
44;Grand Est;08;4;19;424;Sommauthe;128;3;131
44;Grand Est;08;4;01;425;Sommerance;46;0;46
44;Grand Est;08;2;08;426;Son;95;3;98
44;Grand Est;08;2;11;427;Sorbon;211;1;212
44;Grand Est;08;2;17;428;Sorcy-Bauthémont;144;2;146
44;Grand Est;08;1;13;429;Sormonne;529;14;543
44;Grand Est;08;3;19;430;Stonne;39;2;41
44;Grand Est;08;4;01;431;Sugny;100;7;107
44;Grand Est;08;1;13;432;Sury;105;3;108
44;Grand Est;08;4;01;433;Suzanne;59;2;61
44;Grand Est;08;4;19;434;Sy;52;2;54
44;Grand Est;08;2;08;435;Tagnon;873;14;887
44;Grand Est;08;1;13;436;Taillette;402;7;409
44;Grand Est;08;4;19;437;Tailly;174;6;180
44;Grand Est;08;2;08;438;Taizy;105;2;107
44;Grand Est;08;4;19;439;Tannay;147;10;157
44;Grand Est;08;1;13;440;Tarzy;129;2;131
44;Grand Est;08;3;03;444;Tétaigne;128;4;132
44;Grand Est;08;3;14;445;Thelonne;414;6;420
44;Grand Est;08;4;19;446;Thénorgues;81;2;83
44;Grand Est;08;1;02;448;Thilay;1032;11;1043
44;Grand Est;08;1;17;449;Thin-le-Moutier;648;14;662
44;Grand Est;08;1;13;450;This;224;9;233
44;Grand Est;08;2;08;451;Le Thour;375;8;383
44;Grand Est;08;2;11;452;Thugny-Trugny;265;7;272
44;Grand Est;08;4;19;453;Toges;104;3;107
44;Grand Est;08;1;10;454;Touligny;84;0;84
44;Grand Est;08;4;01;455;Tourcelles-Chaumont;91;1;92
44;Grand Est;08;1;02;456;Tournavaux;228;4;232
44;Grand Est;08;1;04;457;Tournes;1063;28;1091
44;Grand Est;08;4;01;458;Tourteron;180;5;185
44;Grand Est;08;3;03;459;Tremblois-lès-Carignan;140;3;143
44;Grand Est;08;1;13;460;Tremblois-lès-Rocroi;152;0;152
44;Grand Est;08;4;19;461;Vandy;204;1;205
44;Grand Est;08;4;01;462;Vaux-Champagne;128;4;132
44;Grand Est;08;4;19;463;Vaux-en-Dieulet;55;1;56
44;Grand Est;08;4;01;464;Vaux-lès-Mouron;79;0;79
44;Grand Est;08;2;17;465;Vaux-lès-Rubigny;43;3;46
44;Grand Est;08;3;03;466;Vaux-lès-Mouzon;69;2;71
44;Grand Est;08;2;17;467;Vaux-Montreuil;107;0;107
44;Grand Est;08;1;17;468;Vaux-Villaine;194;0;194
44;Grand Est;08;1;10;469;Vendresse;477;12;489
44;Grand Est;08;4;19;470;Verpel;66;1;67
44;Grand Est;08;4;19;471;Verrières;32;1;33
44;Grand Est;08;2;17;472;Viel-Saint-Remy;297;2;299
44;Grand Est;08;2;08;473;Vieux-lès-Asfeld;302;7;309
44;Grand Est;08;2;08;476;Villers-devant-le-Thour;418;7;425
44;Grand Est;08;3;03;477;Villers-devant-Mouzon;109;0;109
44;Grand Est;08;1;10;478;Villers-le-Tilleul;238;3;241
44;Grand Est;08;2;17;479;Villers-le-Tourneur;202;3;205
44;Grand Est;08;1;18;480;Villers-Semeuse;3588;65;3653
44;Grand Est;08;3;14;481;Villers-sur-Bar;253;5;258
44;Grand Est;08;1;10;482;Villers-sur-le-Mont;103;3;106
44;Grand Est;08;1;18;483;Ville-sur-Lumes;526;13;539
44;Grand Est;08;2;08;484;Ville-sur-Retourne;79;0;79
44;Grand Est;08;3;03;485;Villy;199;11;210
44;Grand Est;08;1;09;486;Vireux-Molhain;1465;31;1496
44;Grand Est;08;1;09;487;Vireux-Wallerand;1940;54;1994
44;Grand Est;08;1;18;488;Vivier-au-Court;2901;83;2984
44;Grand Est;08;4;01;489;Voncq;216;2;218
44;Grand Est;08;4;19;490;Vouziers;4169;136;4305
44;Grand Est;08;3;14;491;Vrigne aux Bois;3556;52;3608
44;Grand Est;08;1;10;492;Vrigne-Meuse;329;8;337
44;Grand Est;08;3;14;494;Wadelincourt;455;7;462
44;Grand Est;08;2;17;496;Wagnon;124;1;125
44;Grand Est;08;1;04;497;Warcq;1227;25;1252
44;Grand Est;08;1;10;498;Warnécourt;381;15;396
44;Grand Est;08;2;17;499;Wasigny;316;3;319
44;Grand Est;08;2;17;500;Wignicourt;56;1;57
44;Grand Est;08;3;03;501;Williers;41;2;43
44;Grand Est;08;3;03;502;Yoncq;91;3;94
44;Grand Est;08;1;10;503;Yvernaumont;121;1;122
76;Occitanie;09;3;03;001;Aigues-Juntes;57;1;58
76;Occitanie;09;2;06;002;Aigues-Vives;634;20;654
76;Occitanie;09;2;09;003;L'Aiguillon;381;9;390
76;Occitanie;09;1;01;004;Albiès;120;0;120
76;Occitanie;09;3;03;005;Aleu;128;2;130
76;Occitanie;09;1;12;006;Alliat;56;0;56
76;Occitanie;09;3;03;007;Allières;73;0;73
76;Occitanie;09;3;03;008;Alos;120;2;122
76;Occitanie;09;3;03;009;Alzen;267;6;273
76;Occitanie;09;3;04;011;Antras;74;1;75
76;Occitanie;09;1;01;012;Appy;28;2;30
76;Occitanie;09;1;13;013;Arabaux;81;1;82
76;Occitanie;09;3;04;014;Argein;192;5;197
76;Occitanie;09;1;12;015;Arignac;702;19;721
76;Occitanie;09;1;12;016;Arnave;217;8;225
76;Occitanie;09;3;04;017;Arrien-en-Bethmale;112;1;113
76;Occitanie;09;3;04;018;Arrout;90;4;94
76;Occitanie;09;3;02;019;Artigat;560;9;569
76;Occitanie;09;1;01;020;Artigues;35;0;35
76;Occitanie;09;1;07;021;Artix;118;3;121
76;Occitanie;09;2;08;022;Arvigna;222;2;224
76;Occitanie;09;1;01;023;Ascou;119;1;120
76;Occitanie;09;1;01;024;Aston;203;5;208
76;Occitanie;09;3;04;025;Aucazein;53;4;57
76;Occitanie;09;3;04;026;Audressein;151;0;151
76;Occitanie;09;3;04;027;Augirein;79;0;79
76;Occitanie;09;3;03;029;Aulus-les-Bains;159;6;165
76;Occitanie;09;1;12;030;Auzat;501;5;506
76;Occitanie;09;1;01;031;Axiat;43;1;44
76;Occitanie;09;1;01;032;Ax-les-Thermes;1285;65;1350
76;Occitanie;09;3;11;033;Bagert;36;1;37
76;Occitanie;09;3;04;034;Balacet;38;0;38
76;Occitanie;09;3;04;035;Balaguères;198;3;201
76;Occitanie;09;3;11;037;Barjac;42;0;42
76;Occitanie;09;3;02;038;La Bastide-de-Besplas;381;5;386
76;Occitanie;09;2;06;039;La Bastide-de-Bousignac;339;13;352
76;Occitanie;09;2;10;040;La Bastide-de-Lordat;289;7;296
76;Occitanie;09;3;11;041;La Bastide-du-Salat;205;7;212
76;Occitanie;09;3;03;042;La Bastide-de-Sérou;992;12;1004
76;Occitanie;09;2;06;043;La Bastide-sur-l'Hers;672;19;691
76;Occitanie;09;1;13;044;Baulou;167;2;169
76;Occitanie;09;1;12;045;Bédeilhac-et-Aynat;197;1;198
76;Occitanie;09;3;11;046;Bédeille;66;4;70
76;Occitanie;09;2;09;047;Bélesta;1072;18;1090
76;Occitanie;09;2;06;048;Belloc;82;0;82
76;Occitanie;09;1;13;049;Bénac;177;3;180
76;Occitanie;09;2;07;050;Benagues;529;7;536
76;Occitanie;09;2;09;051;Bénaix;151;4;155
76;Occitanie;09;2;06;052;Besset;166;8;174
76;Occitanie;09;1;01;053;Bestiac;19;3;22
76;Occitanie;09;3;11;054;Betchat;354;5;359
76;Occitanie;09;3;04;055;Bethmale;92;1;93
76;Occitanie;09;2;07;056;Bézac;413;11;424
76;Occitanie;09;3;03;057;Biert;315;5;320
76;Occitanie;09;1;12;058;Bompas;193;5;198
76;Occitanie;09;3;04;059;Bonac-Irazein;122;4;126
76;Occitanie;09;2;10;060;Bonnac;761;10;771
76;Occitanie;09;3;02;061;Les Bordes-sur-Arize;499;5;504
76;Occitanie;09;3;04;062;Bordes-Uchentein;212;6;218
76;Occitanie;09;1;13;063;Le Bosc;115;2;117
76;Occitanie;09;1;01;064;Bouan;40;0;40
76;Occitanie;09;3;03;065;Boussenac;223;3;226
76;Occitanie;09;1;13;066;Brassac;622;10;632
76;Occitanie;09;2;10;067;Brie;211;3;214
76;Occitanie;09;1;13;068;Burret;44;0;44
76;Occitanie;09;3;04;069;Buzan;25;0;25
76;Occitanie;09;1;01;070;Les Cabannes;332;8;340
76;Occitanie;09;3;03;071;Cadarcet;220;8;228
76;Occitanie;09;1;13;072;Calzan;37;1;38
76;Occitanie;09;3;02;073;Camarade;200;1;201
76;Occitanie;09;2;06;074;Camon;149;1;150
76;Occitanie;09;3;02;075;Campagne-sur-Arize;283;5;288
76;Occitanie;09;2;10;076;Canté;202;7;209
76;Occitanie;09;1;12;077;Capoulet-et-Junac;190;1;191
76;Occitanie;09;1;01;078;Carcanières;73;0;73
76;Occitanie;09;3;02;079;Carla-Bayle;797;14;811
76;Occitanie;09;2;09;080;Carla-de-Roquefort;172;5;177
76;Occitanie;09;2;08;081;Le Carlaret;275;11;286
76;Occitanie;09;3;03;082;Castelnau-Durban;453;9;462
76;Occitanie;09;3;02;083;Castéras;21;0;21
76;Occitanie;09;3;02;084;Castex;97;1;98
76;Occitanie;09;3;04;085;Castillon-en-Couserans;412;3;415
76;Occitanie;09;3;11;086;Caumont;334;8;342
76;Occitanie;09;1;01;087;Caussou;45;0;45
76;Occitanie;09;1;01;088;Caychax;15;0;15
76;Occitanie;09;2;06;089;Cazals-des-Baylès;56;2;58
76;Occitanie;09;1;13;090;Cazaux;38;7;45
76;Occitanie;09;3;11;091;Cazavet;200;3;203
76;Occitanie;09;1;12;092;Cazenave-Serres-et-Allens;61;3;64
76;Occitanie;09;1;12;093;Celles;151;1;152
76;Occitanie;09;3;11;094;Cérizols;138;4;142
76;Occitanie;09;3;04;095;Cescau;154;3;157
76;Occitanie;09;1;01;096;Château-Verdun;41;3;44
76;Occitanie;09;3;03;097;Clermont;116;0;116
76;Occitanie;09;3;11;098;Contrazy;67;1;68
76;Occitanie;09;1;05;099;Cos;379;14;393
76;Occitanie;09;3;03;100;Couflens;95;1;96
76;Occitanie;09;1;13;101;Coussa;287;3;290
76;Occitanie;09;2;06;102;Coutens;174;7;181
76;Occitanie;09;1;13;103;Crampagna;895;16;911
76;Occitanie;09;1;13;104;Dalou;775;18;793
76;Occitanie;09;3;02;105;Daumazan-sur-Arize;741;9;750
76;Occitanie;09;2;09;106;Dreuilhe;359;16;375
76;Occitanie;09;2;06;107;Dun;625;17;642
76;Occitanie;09;3;03;108;Durban-sur-Arize;174;4;178
76;Occitanie;09;3;02;109;Durfort;184;3;187
76;Occitanie;09;3;03;110;Encourtiech;93;3;96
76;Occitanie;09;3;04;111;Engomer;307;4;311
76;Occitanie;09;3;03;113;Ercé;569;3;572
76;Occitanie;09;3;03;114;Erp;132;2;134
76;Occitanie;09;2;06;115;Esclagne;126;1;127
76;Occitanie;09;2;07;116;Escosse;370;3;373
76;Occitanie;09;2;10;117;Esplas;106;0;106
76;Occitanie;09;3;03;118;Esplas-de-Sérou;179;2;181
76;Occitanie;09;3;04;119;Eycheil;540;12;552
76;Occitanie;09;3;11;120;Fabas;348;4;352
76;Occitanie;09;1;05;121;Ferrières-sur-Ariège;749;100;849
76;Occitanie;09;1;05;122;Foix;9515;326;9841
76;Occitanie;09;3;02;123;Fornex;114;1;115
76;Occitanie;09;3;02;124;Le Fossat;1041;12;1053
76;Occitanie;09;2;09;125;Fougax-et-Barrineuf;429;6;435
76;Occitanie;09;2;09;126;Freychenet;82;3;85
76;Occitanie;09;3;02;127;Gabre;125;3;128
76;Occitanie;09;3;11;128;Gajan;316;10;326
76;Occitanie;09;3;04;129;Galey;114;3;117
76;Occitanie;09;1;05;130;Ganac;730;9;739
76;Occitanie;09;1;01;131;Garanou;147;0;147
76;Occitanie;09;2;10;132;Gaudiès;245;3;248
76;Occitanie;09;1;12;133;Génat;23;1;24
76;Occitanie;09;1;12;134;Gestiès;33;1;34
76;Occitanie;09;1;12;136;Gourbit;72;3;75
76;Occitanie;09;1;13;137;Gudas;201;4;205
76;Occitanie;09;1;13;138;L'Herm;194;28;222
76;Occitanie;09;1;01;139;L'Hospitalet-près-l'Andorre;103;0;103
76;Occitanie;09;1;01;140;Ignaux;122;6;128
76;Occitanie;09;3;04;141;Illartein;73;0;73
76;Occitanie;09;2;09;142;Ilhat;125;0;125
76;Occitanie;09;1;12;143;Illier-et-Laramade;37;0;37
76;Occitanie;09;2;08;145;Les Issards;247;10;257
76;Occitanie;09;2;10;146;Justiniac;58;0;58
76;Occitanie;09;2;10;147;Labatut;177;2;179
76;Occitanie;09;3;11;148;Lacave;121;5;126
76;Occitanie;09;3;03;149;Lacourt;192;4;196
76;Occitanie;09;2;06;150;Lagarde;200;6;206
76;Occitanie;09;3;02;151;Lanoux;55;0;55
76;Occitanie;09;1;12;152;Lapège;20;1;21
76;Occitanie;09;2;06;153;Lapenne;119;4;123
76;Occitanie;09;3;03;154;Larbont;61;2;63
76;Occitanie;09;1;01;155;Larcat;48;0;48
76;Occitanie;09;1;01;156;Larnat;20;0;20
76;Occitanie;09;2;06;157;Laroque-d'Olmes;2391;44;2435
76;Occitanie;09;3;11;158;Lasserre;254;7;261
76;Occitanie;09;1;01;159;Lassur;91;2;93
76;Occitanie;09;2;09;160;Lavelanet;6052;125;6177
76;Occitanie;09;2;06;161;Léran;618;16;634
76;Occitanie;09;1;12;162;Lercoul;15;0;15
76;Occitanie;09;2;07;163;Lescousse;81;0;81
76;Occitanie;09;3;03;164;Lescure;489;17;506
76;Occitanie;09;2;09;165;Lesparrou;233;0;233
76;Occitanie;09;2;09;166;Leychert;105;2;107
76;Occitanie;09;3;02;167;Lézat-sur-Lèze;2360;40;2400
76;Occitanie;09;2;09;168;Lieurac;183;8;191
76;Occitanie;09;2;06;169;Limbrassac;121;3;124
76;Occitanie;09;2;10;170;Lissac;250;9;259
76;Occitanie;09;1;01;171;Lordat;70;0;70
76;Occitanie;09;3;02;172;Loubaut;24;0;24
76;Occitanie;09;1;13;173;Loubens;283;5;288
76;Occitanie;09;1;13;174;Loubières;358;13;371
76;Occitanie;09;2;08;175;Ludiès;93;4;97
76;Occitanie;09;1;01;176;Luzenac;513;9;522
76;Occitanie;09;2;07;177;Madière;246;6;252
76;Occitanie;09;2;06;178;Malegoude;43;2;45
76;Occitanie;09;1;13;179;Malléon;79;1;80
76;Occitanie;09;2;06;180;Manses;119;1;120
76;Occitanie;09;3;02;181;Le Mas-d'Azil;1181;18;1199
76;Occitanie;09;3;03;182;Massat;734;10;744
76;Occitanie;09;3;11;183;Mauvezin-de-Prat;102;4;106
76;Occitanie;09;3;11;184;Mauvezin-de-Sainte-Croix;49;1;50
76;Occitanie;09;2;10;185;Mazères;3872;83;3955
76;Occitanie;09;3;02;186;Méras;101;0;101
76;Occitanie;09;3;11;187;Mercenac;351;10;361
76;Occitanie;09;1;12;188;Mercus-Garrabet;1203;24;1227
76;Occitanie;09;1;01;189;Mérens-les-Vals;168;4;172
76;Occitanie;09;3;11;190;Mérigon;112;1;113
76;Occitanie;09;1;12;192;Miglos;112;3;115
76;Occitanie;09;1;01;193;Mijanès;60;0;60
76;Occitanie;09;2;06;194;Mirepoix;3114;122;3236
76;Occitanie;09;3;02;195;Monesple;29;0;29
76;Occitanie;09;3;03;196;Montagagne;79;1;80
76;Occitanie;09;1;01;197;Montaillou;17;0;17
76;Occitanie;09;3;11;198;Montardit;216;5;221
76;Occitanie;09;2;10;199;Montaut;695;17;712
76;Occitanie;09;2;06;200;Montbel;97;3;100
76;Occitanie;09;3;04;201;Montégut-en-Couserans;78;1;79
76;Occitanie;09;1;13;202;Montégut-Plantaurel;335;9;344
76;Occitanie;09;3;03;203;Montels;154;9;163
76;Occitanie;09;3;11;204;Montesquieu-Avantès;253;11;264
76;Occitanie;09;3;02;205;Montfa;85;1;86
76;Occitanie;09;2;09;206;Montferrier;553;13;566
76;Occitanie;09;1;05;207;Montgailhard;1476;30;1506
76;Occitanie;09;3;11;208;Montgauch;120;1;121
76;Occitanie;09;3;11;209;Montjoie-en-Couserans;1010;21;1031
76;Occitanie;09;1;12;210;Montoulieu;411;7;418
76;Occitanie;09;2;09;211;Montségur;117;2;119
76;Occitanie;09;3;03;212;Montseron;107;1;108
76;Occitanie;09;2;06;213;Moulin-Neuf;240;2;242
76;Occitanie;09;3;04;214;Moulis;768;16;784
76;Occitanie;09;2;09;215;Nalzen;119;2;121
76;Occitanie;09;3;03;216;Nescus;63;1;64
76;Occitanie;09;1;12;217;Niaux;154;2;156
76;Occitanie;09;1;01;218;Orgeix;92;1;93
76;Occitanie;09;3;04;219;Orgibet;185;4;189
76;Occitanie;09;1;01;220;Orlu;165;3;168
76;Occitanie;09;1;01;221;Ornolac-Ussat-les-Bains;248;3;251
76;Occitanie;09;1;12;222;Orus;27;0;27
76;Occitanie;09;3;03;223;Oust;562;8;570
76;Occitanie;09;3;02;224;Pailhès;486;1;487
76;Occitanie;09;2;99;225;Pamiers;15938;483;16421
76;Occitanie;09;1;01;226;Pech;37;0;37
76;Occitanie;09;2;09;227;Péreille;194;1;195
76;Occitanie;09;1;01;228;Perles-et-Castelet;226;5;231
76;Occitanie;09;2;06;229;Le Peyrat;476;12;488
76;Occitanie;09;1;01;230;Le Pla;62;0;62
76;Occitanie;09;3;03;231;Le Port;165;1;166
76;Occitanie;09;1;01;232;Prades;31;0;31
76;Occitanie;09;2;06;233;Pradettes;45;1;46
76;Occitanie;09;1;13;234;Pradières;121;3;124
76;Occitanie;09;3;11;235;Prat-Bonrepaux;861;16;877
76;Occitanie;09;1;12;236;Prayols;368;16;384
76;Occitanie;09;1;01;237;Le Puch;30;1;31
76;Occitanie;09;2;08;238;Les Pujols;840;17;857
76;Occitanie;09;1;01;239;Quérigut;138;2;140
76;Occitanie;09;1;12;240;Quié;295;3;298
76;Occitanie;09;1;12;241;Rabat-les-Trois-Seigneurs;368;6;374
76;Occitanie;09;2;09;242;Raissac;54;1;55
76;Occitanie;09;2;06;243;Régat;85;3;88
76;Occitanie;09;2;06;244;Rieucros;720;12;732
76;Occitanie;09;1;07;245;Rieux-de-Pelleport;1270;36;1306
76;Occitanie;09;3;03;246;Rimont;532;20;552
76;Occitanie;09;3;03;247;Rivèrenert;160;10;170
76;Occitanie;09;2;09;249;Roquefixade;146;4;150
76;Occitanie;09;2;09;250;Roquefort-les-Cascades;90;2;92
76;Occitanie;09;2;06;251;Roumengoux;165;7;172
76;Occitanie;09;1;01;252;Rouze;90;0;90
76;Occitanie;09;3;02;253;Sabarat;391;6;397
76;Occitanie;09;2;08;254;Saint-Amadou;249;4;253
76;Occitanie;09;2;07;255;Saint-Amans;41;0;41
76;Occitanie;09;1;07;256;Saint-Bauzeil;59;0;59
76;Occitanie;09;3;11;257;Sainte-Croix-Volvestre;631;9;640
76;Occitanie;09;1;13;258;Saint-Félix-de-Rieutord;466;10;476
76;Occitanie;09;2;06;259;Saint-Félix-de-Tournegat;153;4;157
76;Occitanie;09;2;06;260;Sainte-Foi;30;0;30
76;Occitanie;09;3;04;261;Saint-Girons;6415;397;6812
76;Occitanie;09;2;09;262;Saint-Jean-d'Aigues-Vives;378;5;383
76;Occitanie;09;3;04;263;Saint-Jean-du-Castillonnais;23;0;23
76;Occitanie;09;1;13;264;Saint-Jean-de-Verges;1285;17;1302
76;Occitanie;09;2;07;265;Saint-Jean-du-Falga;2855;59;2914
76;Occitanie;09;2;06;266;Saint-Julien-de-Gras-Capou;72;2;74
76;Occitanie;09;3;04;267;Saint-Lary;125;2;127
76;Occitanie;09;3;11;268;Saint-Lizier;1367;32;1399
76;Occitanie;09;1;13;269;Saint-Martin-de-Caralp;365;11;376
76;Occitanie;09;2;07;270;Saint-Martin-d'Oydes;230;4;234
76;Occitanie;09;2;07;271;Saint-Michel;85;2;87
76;Occitanie;09;1;12;272;Saint-Paul-de-Jarrat;1337;25;1362
76;Occitanie;09;1;05;273;Saint-Pierre-de-Rivière;668;23;691
76;Occitanie;09;2;06;274;Saint-Quentin-la-Tour;338;5;343
76;Occitanie;09;2;10;275;Saint-Quirc;370;10;380
76;Occitanie;09;2;07;276;Saint-Victor-Rouzaud;221;10;231
76;Occitanie;09;3;02;277;Saint-Ybars;690;11;701
76;Occitanie;09;3;04;279;Salsein;48;2;50
76;Occitanie;09;1;12;280;Saurat;659;12;671
76;Occitanie;09;2;09;281;Sautel;123;2;125
76;Occitanie;09;2;10;282;Saverdun;4815;151;4966
76;Occitanie;09;1;01;283;Savignac-les-Ormeaux;398;16;414
76;Occitanie;09;1;13;284;Ségura;188;6;194
76;Occitanie;09;3;03;285;Seix;704;14;718
76;Occitanie;09;1;01;287;Senconac;11;0;11
76;Occitanie;09;3;11;289;Lorp-Sentaraille;1461;23;1484
76;Occitanie;09;3;04;290;Sentein;158;3;161
76;Occitanie;09;3;03;291;Sentenac-d'Oust;105;3;108
76;Occitanie;09;3;03;292;Sentenac-de-Sérou;58;0;58
76;Occitanie;09;1;13;293;Serres-sur-Arget;678;10;688
76;Occitanie;09;3;02;294;Sieuras;101;2;103
76;Occitanie;09;1;12;295;Siguer;96;1;97
76;Occitanie;09;1;01;296;Aulos-Sinsat;150;2;152
76;Occitanie;09;3;04;297;Sor;27;0;27
76;Occitanie;09;1;01;298;Sorgeat;83;1;84
76;Occitanie;09;3;03;299;Soueix-Rogalle;430;7;437
76;Occitanie;09;1;09;300;Soula;176;7;183
76;Occitanie;09;3;03;301;Soulan;372;2;374
76;Occitanie;09;1;12;303;Surba;319;8;327
76;Occitanie;09;3;03;304;Suzan;17;0;17
76;Occitanie;09;2;06;305;Tabre;352;7;359
76;Occitanie;09;1;12;306;Tarascon-sur-Ariège;3013;31;3044
76;Occitanie;09;3;11;307;Taurignan-Castet;154;2;156
76;Occitanie;09;3;11;308;Taurignan-Vieux;207;8;215
76;Occitanie;09;2;06;309;Teilhet;156;5;161
76;Occitanie;09;3;02;310;Thouars-sur-Arize;44;2;46
76;Occitanie;09;1;01;311;Tignac;21;0;21
76;Occitanie;09;2;08;312;La Tour-du-Crieu;3232;71;3303
76;Occitanie;09;3;11;313;Tourtouse;158;4;162
76;Occitanie;09;2;06;314;Tourtrol;262;14;276
76;Occitanie;09;2;10;315;Trémoulet;121;1;122
76;Occitanie;09;2;06;316;Troye-d'Ariège;109;1;110
76;Occitanie;09;1;01;318;Unac;126;1;127
76;Occitanie;09;2;07;319;Unzent;114;4;118
76;Occitanie;09;1;01;320;Urs;28;1;29
76;Occitanie;09;1;01;321;Ussat;310;4;314
76;Occitanie;09;3;03;322;Ustou;268;10;278
76;Occitanie;09;2;06;323;Vals;90;1;91
76;Occitanie;09;1;13;324;Varilhes;3495;57;3552
76;Occitanie;09;1;01;325;Vaychis;32;0;32
76;Occitanie;09;1;01;326;Vèbre;121;3;124
76;Occitanie;09;1;13;327;Ventenac;235;2;237
76;Occitanie;09;1;01;328;Verdun;213;9;222
76;Occitanie;09;1;13;329;Vernajoul;698;20;718
76;Occitanie;09;1;01;330;Vernaux;29;0;29
76;Occitanie;09;2;10;331;Le Vernet;727;6;733
76;Occitanie;09;1;13;332;Verniolle;2295;49;2344
76;Occitanie;09;1;12;334;Val-de-Sos;554;63;617
76;Occitanie;09;3;04;335;Villeneuve;41;0;41
76;Occitanie;09;2;09;336;Villeneuve-d'Olmes;957;21;978
76;Occitanie;09;3;02;338;Villeneuve-du-Latou;154;3;157
76;Occitanie;09;2;10;339;Villeneuve-du-Paréage;778;14;792
76;Occitanie;09;1;13;340;Vira;156;4;160
76;Occitanie;09;2;06;341;Viviès;153;0;153
76;Occitanie;09;3;02;342;Sainte-Suzanne;238;2;240
44;Grand Est;10;1;03;002;Ailleville;232;5;237
44;Grand Est;10;3;01;003;Aix-Villemaur-Pâlis;3537;39;3576
44;Grand Est;10;3;02;004;Allibaudières;207;2;209
44;Grand Est;10;1;17;005;Amance;250;12;262
44;Grand Est;10;3;02;006;Arcis-sur-Aube;2767;78;2845
44;Grand Est;10;1;03;007;Arconville;104;2;106
44;Grand Est;10;1;17;008;Argançon;113;1;114
44;Grand Est;10;3;08;009;Arrelles;86;2;88
44;Grand Est;10;1;05;010;Arrembécourt;46;2;48
44;Grand Est;10;1;03;011;Arrentières;208;1;209
44;Grand Est;10;1;03;012;Arsonval;300;5;305
44;Grand Est;10;3;08;013;Assenay;143;5;148
44;Grand Est;10;3;05;014;Assencières;186;1;187
44;Grand Est;10;3;02;015;Aubeterre;379;6;385
44;Grand Est;10;1;05;017;Aulnay;123;3;126
44;Grand Est;10;3;01;018;Auxon;1030;10;1040
44;Grand Est;10;3;05;019;Val-d'Auzon;380;5;385
44;Grand Est;10;2;11;020;Avant-lès-Marcilly;503;10;513
44;Grand Est;10;3;02;021;Avant-lès-Ramerupt;156;4;160
44;Grand Est;10;3;08;022;Avirey-Lingey;200;11;211
44;Grand Est;10;2;11;023;Avon-la-Pèze;193;4;197
44;Grand Est;10;3;08;024;Avreuil;170;3;173
44;Grand Est;10;3;08;025;Bagneux-la-Fosse;172;4;176
44;Grand Est;10;1;05;026;Bailly-le-Franc;37;0;37
44;Grand Est;10;1;05;027;Balignicourt;59;2;61
44;Grand Est;10;3;08;028;Balnot-la-Grange;117;2;119
44;Grand Est;10;3;08;029;Balnot-sur-Laignes;154;2;156
44;Grand Est;10;3;11;030;Barberey-Saint-Sulpice;1568;29;1597
44;Grand Est;10;2;07;031;Barbuise;475;8;483
44;Grand Est;10;1;03;032;Baroville;301;9;310
44;Grand Est;10;1;03;033;Bar-sur-Aube;4774;194;4968
44;Grand Est;10;3;04;034;Bar-sur-Seine;2932;196;3128
44;Grand Est;10;1;03;035;Bayel;747;9;756
44;Grand Est;10;3;01;037;Bercenay-en-Othe;432;10;442
44;Grand Est;10;2;11;038;Bercenay-le-Hayer;197;2;199
44;Grand Est;10;1;03;039;Bergères;114;5;119
44;Grand Est;10;3;08;040;Bernon;165;8;173
44;Grand Est;10;3;04;041;Bertignolles;51;0;51
44;Grand Est;10;3;01;042;Bérulle;201;4;205
44;Grand Est;10;2;06;043;Bessy;121;3;124
44;Grand Est;10;1;05;044;Bétignicourt;34;0;34
44;Grand Est;10;1;17;045;Beurey;180;9;189
44;Grand Est;10;1;05;046;Blaincourt-sur-Aube;109;2;111
44;Grand Est;10;1;05;047;Blignicourt;42;1;43
44;Grand Est;10;1;03;048;Bligny;162;4;166
44;Grand Est;10;3;08;049;Les Bordes-Aumont;525;9;534
44;Grand Est;10;1;17;050;Bossancourt;194;3;197
44;Grand Est;10;3;08;051;Bouilly;1078;47;1125
44;Grand Est;10;2;06;052;Boulages;220;5;225
44;Grand Est;10;3;17;053;Bouranton;603;9;612
44;Grand Est;10;2;11;054;Bourdenay;110;1;111
44;Grand Est;10;3;04;055;Bourguignons;261;11;272
44;Grand Est;10;3;05;056;Bouy-Luxembourg;247;1;248
44;Grand Est;10;2;07;057;Bouy-sur-Orvin;53;1;54
44;Grand Est;10;3;08;058;Bragelogne-Beauvoir;235;4;239
44;Grand Est;10;1;05;059;Braux;112;5;117
44;Grand Est;10;3;17;060;Bréviandes;2933;56;2989
44;Grand Est;10;3;05;061;Brévonnes;667;12;679
44;Grand Est;10;3;04;062;Briel-sur-Barse;199;3;202
44;Grand Est;10;1;05;063;Brienne-la-Vieille;402;13;415
44;Grand Est;10;1;05;064;Brienne-le-Château;2754;25;2779
44;Grand Est;10;3;02;065;Brillecourt;84;1;85
44;Grand Est;10;3;01;066;Bucey-en-Othe;437;10;447
44;Grand Est;10;3;17;067;Buchères;1889;29;1918
44;Grand Est;10;3;04;068;Buxeuil;121;3;124
44;Grand Est;10;3;04;069;Buxières-sur-Arce;115;0;115
44;Grand Est;10;3;04;070;Celles-sur-Ource;482;19;501
44;Grand Est;10;3;04;071;Chacenay;52;1;53
44;Grand Est;10;1;03;072;La Chaise;34;0;34
44;Grand Est;10;1;05;073;Chalette-sur-Voire;125;2;127
44;Grand Est;10;3;01;074;Chamoy;504;8;512
44;Grand Est;10;2;06;075;Champfleury;100;1;101
44;Grand Est;10;1;03;076;Champignol-lez-Mondeville;257;7;264
44;Grand Est;10;3;02;077;Champigny-sur-Aube;105;1;106
44;Grand Est;10;1;17;078;Champ-sur-Barse;27;0;27
44;Grand Est;10;3;08;079;Channes;133;2;135
44;Grand Est;10;3;08;080;Chaource;1017;12;1029
44;Grand Est;10;3;14;081;La Chapelle-Saint-Luc;12324;87;12411
44;Grand Est;10;2;06;082;Chapelle-Vallon;240;5;245
44;Grand Est;10;3;04;083;Chappes;344;5;349
44;Grand Est;10;3;02;084;Charmont-sous-Barbuise;1011;29;1040
44;Grand Est;10;2;11;085;Charmoy;65;0;65
44;Grand Est;10;2;06;086;Charny-le-Bachot;257;8;265
44;Grand Est;10;3;08;087;Chaserey;51;0;51
44;Grand Est;10;2;06;089;Châtres;701;7;708
44;Grand Est;10;2;06;090;Chauchigny;228;3;231
44;Grand Est;10;3;02;091;Chaudrey;139;5;144
44;Grand Est;10;3;04;092;Chauffour-lès-Bailly;129;0;129
44;Grand Est;10;1;03;093;Chaumesnil;103;2;105
44;Grand Est;10;1;05;094;Chavanges;593;11;604
44;Grand Est;10;3;02;095;Le Chêne;287;5;292
44;Grand Est;10;3;01;096;Chennegy;444;11;455
44;Grand Est;10;3;04;097;Chervey;157;2;159
44;Grand Est;10;3;08;098;Chesley;312;5;317
44;Grand Est;10;3;01;099;Chessy-les-Prés;527;14;541
44;Grand Est;10;3;17;100;Clérey;1134;24;1158
44;Grand Est;10;3;02;101;Coclois;172;2;174
44;Grand Est;10;1;03;102;Colombé-la-Fosse;181;1;182
44;Grand Est;10;1;03;103;Colombé-le-Sec;154;1;155
44;Grand Est;10;3;08;104;Cormost;306;3;309
44;Grand Est;10;1;05;105;Courcelles-sur-Voire;26;1;27
44;Grand Est;10;2;07;106;Courceroy;141;5;146
44;Grand Est;10;3;01;107;Coursan-en-Othe;102;0;102
44;Grand Est;10;3;01;108;Courtaoult;81;0;81
44;Grand Est;10;3;04;109;Courtenot;226;2;228
44;Grand Est;10;3;17;110;Courteranges;568;18;586
44;Grand Est;10;3;04;111;Courteron;103;5;108
44;Grand Est;10;3;08;112;Coussegrey;178;2;180
44;Grand Est;10;1;03;113;Couvignon;198;2;200
44;Grand Est;10;2;09;114;Crancey;706;15;721
44;Grand Est;10;3;06;115;Creney-près-Troyes;1997;34;2031
44;Grand Est;10;3;08;116;Crésantignes;317;4;321
44;Grand Est;10;1;03;117;Crespy-le-Neuf;147;1;148
44;Grand Est;10;3;01;118;Les Croûtes;92;4;96
44;Grand Est;10;3;04;119;Cunfin;174;4;178
44;Grand Est;10;3;08;120;Cussangy;200;2;202
44;Grand Est;10;3;02;121;Dampierre;328;8;336
44;Grand Est;10;3;01;122;Davrey;223;4;227
44;Grand Est;10;1;05;123;Dienville;847;25;872
44;Grand Est;10;2;11;124;Dierrey-Saint-Julien;266;4;270
44;Grand Est;10;3;11;125;Dierrey-Saint-Pierre;312;5;317
44;Grand Est;10;1;17;126;Dolancourt;129;4;133
44;Grand Est;10;3;02;127;Dommartin-le-Coq;57;0;57
44;Grand Est;10;1;05;128;Donnement;74;1;75
44;Grand Est;10;3;05;129;Dosches;307;8;315
44;Grand Est;10;3;02;130;Dosnon;98;6;104
44;Grand Est;10;2;06;131;Droupt-Saint-Basle;354;6;360
44;Grand Est;10;2;06;132;Droupt-Sainte-Marie;241;0;241
44;Grand Est;10;3;01;133;Eaux-Puiseaux;257;6;263
44;Grand Est;10;2;11;134;Échemines;86;6;92
44;Grand Est;10;1;03;135;Éclance;96;3;99
44;Grand Est;10;3;04;136;Éguilly-sous-Bois;117;1;118
44;Grand Est;10;1;03;137;Engente;33;0;33
44;Grand Est;10;1;05;138;Épagne;142;2;144
44;Grand Est;10;1;03;139;Épothémont;160;4;164
44;Grand Est;10;3;01;140;Ervy-le-Châtel;1125;9;1134
44;Grand Est;10;3;04;141;Essoyes;718;12;730
44;Grand Est;10;3;01;142;Estissac;1849;18;1867
44;Grand Est;10;3;08;143;Étourvy;161;4;165
44;Grand Est;10;2;06;144;Étrelles-sur-Aube;155;6;161
44;Grand Est;10;2;11;145;Faux-Villecerf;207;7;214
44;Grand Est;10;2;11;146;Fay-lès-Marcilly;92;3;95
44;Grand Est;10;3;08;147;Fays-la-Chapelle;129;4;133
44;Grand Est;10;2;07;148;Ferreux-Quincey;409;6;415
44;Grand Est;10;3;02;149;Feuges;333;5;338
44;Grand Est;10;1;03;150;Fontaine;250;5;255
44;Grand Est;10;2;06;151;Fontaine-les-Grès;884;9;893
44;Grand Est;10;2;07;153;Fontaine-Mâcon;611;14;625
44;Grand Est;10;2;07;154;Fontenay-de-Bossery;71;1;72
44;Grand Est;10;3;04;155;Fontette;182;6;188
44;Grand Est;10;3;01;156;Fontvannes;707;8;715
44;Grand Est;10;2;11;157;La Fosse-Corduan;214;6;220
44;Grand Est;10;3;04;158;Fouchères;526;7;533
44;Grand Est;10;3;04;159;Fralignes;86;1;87
44;Grand Est;10;1;03;160;Fravaux;39;1;40
44;Grand Est;10;1;03;161;Fresnay;49;3;52
44;Grand Est;10;3;17;162;Fresnoy-le-Château;295;6;301
44;Grand Est;10;1;03;163;Fuligny;41;2;43
44;Grand Est;10;2;09;164;Gélannes;734;10;744
44;Grand Est;10;3;05;165;Géraudot;336;6;342
44;Grand Est;10;2;06;166;Les Grandes-Chapelles;397;6;403
44;Grand Est;10;3;02;167;Grandville;90;1;91
44;Grand Est;10;3;08;168;Les Granges;81;1;82
44;Grand Est;10;2;07;169;Gumery;219;8;227
44;Grand Est;10;3;04;170;Gyé-sur-Seine;476;9;485
44;Grand Est;10;1;05;171;Hampigny;227;7;234
44;Grand Est;10;3;02;172;Herbisse;154;1;155
44;Grand Est;10;3;17;173;Isle-Aumont;460;8;468
44;Grand Est;10;3;02;174;Isle-Aubigny;168;3;171
44;Grand Est;10;1;05;175;Jasseines;171;4;175
44;Grand Est;10;1;03;176;Jaucourt;156;6;162
44;Grand Est;10;3;08;177;Javernant;150;7;157
44;Grand Est;10;1;17;178;Jessains;257;6;263
44;Grand Est;10;3;08;179;Jeugny;471;10;481
44;Grand Est;10;1;05;180;Joncreuil;96;3;99
44;Grand Est;10;3;04;181;Jully-sur-Sarce;214;12;226
44;Grand Est;10;1;03;182;Juvancourt;119;1;120
44;Grand Est;10;1;05;183;Juvanzé;35;1;36
44;Grand Est;10;1;03;184;Juzanvigny;127;1;128
44;Grand Est;10;3;08;185;Lagesse;209;4;213
44;Grand Est;10;3;08;186;Laines-aux-Bois;529;16;545
44;Grand Est;10;3;04;187;Landreville;391;10;401
44;Grand Est;10;3;08;188;Lantages;210;7;217
44;Grand Est;10;1;05;189;Lassicourt;58;0;58
44;Grand Est;10;3;17;190;Laubressel;576;6;582
44;Grand Est;10;3;06;191;Lavau;896;9;905
44;Grand Est;10;1;05;192;Lentilles;129;1;130
44;Grand Est;10;1;05;193;Lesmont;302;4;306
44;Grand Est;10;1;03;194;Lévigny;94;2;96
44;Grand Est;10;3;02;195;Lhuître;287;6;293
44;Grand Est;10;3;08;196;Lignières;219;4;223
44;Grand Est;10;1;03;197;Lignol-le-Château;170;10;180
44;Grand Est;10;3;08;198;Lirey;104;2;106
44;Grand Est;10;3;04;199;Loches-sur-Ource;347;6;353
44;Grand Est;10;1;17;200;La Loge-aux-Chèvres;95;3;98
44;Grand Est;10;3;08;201;La Loge-Pomblin;69;0;69
44;Grand Est;10;3;08;202;Les Loges-Margueron;216;80;296
44;Grand Est;10;1;03;203;Longchamp-sur-Aujon;374;13;387
44;Grand Est;10;3;08;204;Longeville-sur-Mogne;141;3;144
44;Grand Est;10;1;17;205;Longpré-le-Sec;85;2;87
44;Grand Est;10;3;02;206;Longsols;128;1;129
44;Grand Est;10;2;06;207;Longueville-sur-Aube;130;1;131
44;Grand Est;10;2;07;208;La Louptière-Thénard;290;12;302
44;Grand Est;10;3;17;209;Lusigny-sur-Barse;2225;57;2282
44;Grand Est;10;3;02;210;Luyères;457;13;470
44;Grand Est;10;3;11;211;Macey;997;16;1013
44;Grand Est;10;3;08;212;Machy;113;3;116
44;Grand Est;10;3;04;213;Magnant;159;3;162
44;Grand Est;10;1;05;214;Magnicourt;90;1;91
44;Grand Est;10;1;17;215;Magny-Fouchard;261;2;263
44;Grand Est;10;3;02;216;Mailly-le-Camp;2038;26;2064
44;Grand Est;10;1;17;217;Maison-des-Champs;33;0;33
44;Grand Est;10;3;08;218;Maisons-lès-Chaource;168;1;169
44;Grand Est;10;1;03;219;Maisons-lès-Soulaines;69;3;72
44;Grand Est;10;2;09;220;Maizières-la-Grande-Paroisse;1505;43;1548
44;Grand Est;10;1;05;221;Maizières-lès-Brienne;160;0;160
44;Grand Est;10;3;01;222;Maraye-en-Othe;434;7;441
44;Grand Est;10;2;11;223;Marcilly-le-Hayer;726;9;735
44;Grand Est;10;2;11;224;Marigny-le-Châtel;1761;32;1793
44;Grand Est;10;2;07;225;Marnay-sur-Seine;235;7;242
44;Grand Est;10;3;04;226;Marolles-lès-Bailly;113;2;115
44;Grand Est;10;3;01;227;Marolles-sous-Lignières;340;4;344
44;Grand Est;10;1;05;228;Mathaux;204;2;206
44;Grand Est;10;3;08;229;Maupas;102;2;104
44;Grand Est;10;3;06;230;Mergey;674;9;683
44;Grand Est;10;2;07;231;Le Mériot;624;10;634
44;Grand Est;10;3;04;232;Merrey-sur-Arce;325;3;328
44;Grand Est;10;2;06;233;Méry-sur-Seine;1488;43;1531
44;Grand Est;10;2;06;234;Mesgrigny;271;0;271
44;Grand Est;10;3;02;235;Mesnil-la-Comtesse;50;0;50
44;Grand Est;10;3;02;236;Mesnil-Lettre;56;1;57
44;Grand Est;10;2;11;237;Mesnil-Saint-Loup;590;29;619
44;Grand Est;10;3;17;238;Mesnil-Saint-Père;439;9;448
44;Grand Est;10;3;05;239;Mesnil-Sellières;589;24;613
44;Grand Est;10;3;01;240;Messon;467;10;477
44;Grand Est;10;3;08;241;Metz-Robert;61;0;61
44;Grand Est;10;1;03;242;Meurville;158;3;161
44;Grand Est;10;1;05;243;Molins-sur-Aube;104;5;109
44;Grand Est;10;3;17;245;Montaulin;812;27;839
44;Grand Est;10;3;08;246;Montceaux-lès-Vaudes;256;20;276
44;Grand Est;10;3;01;247;Montfey;120;4;124
44;Grand Est;10;3;11;248;Montgueux;393;11;404
44;Grand Est;10;3;17;249;Montiéramey;403;8;411
44;Grand Est;10;1;03;250;Montier-en-l'Isle;222;6;228
44;Grand Est;10;3;01;251;Montigny-les-Monts;254;8;262
44;Grand Est;10;1;17;252;Montmartin-le-Haut;61;2;63
44;Grand Est;10;1;05;253;Montmorency-Beaufort;143;1;144
44;Grand Est;10;2;07;254;Montpothier;329;9;338
44;Grand Est;10;3;17;255;Montreuil-sur-Barse;287;5;292
44;Grand Est;10;3;02;256;Montsuzain;405;4;409
44;Grand Est;10;3;02;257;Morembert;29;0;29
44;Grand Est;10;1;03;258;Morvilliers;277;7;284
44;Grand Est;10;2;07;259;La Motte-Tilly;361;3;364
44;Grand Est;10;3;17;260;Moussey;652;16;668
44;Grand Est;10;3;04;261;Mussy-sur-Seine;1021;15;1036
44;Grand Est;10;3;04;262;Neuville-sur-Seine;395;8;403
44;Grand Est;10;3;01;263;Neuville-sur-Vanne;446;6;452
44;Grand Est;10;3;04;264;Noé-les-Mallets;113;3;116
44;Grand Est;10;3;13;265;Les Noës-près-Troyes;3279;32;3311
44;Grand Est;10;3;01;266;Nogent-en-Othe;46;0;46
44;Grand Est;10;3;02;267;Nogent-sur-Aube;297;6;303
44;Grand Est;10;2;07;268;Nogent-sur-Seine;5946;116;6062
44;Grand Est;10;3;02;269;Nozay;153;4;157
44;Grand Est;10;3;05;270;Onjon;265;6;271
44;Grand Est;10;2;11;271;Origny-le-Sec;598;7;605
44;Grand Est;10;3;02;272;Ormes;179;3;182
44;Grand Est;10;3;02;273;Ortillon;23;0;23
44;Grand Est;10;2;11;274;Orvilliers-Saint-Julien;310;4;314
44;Grand Est;10;2;11;275;Ossey-les-Trois-Maisons;596;7;603
44;Grand Est;10;3;01;276;Paisy-Cosdon;335;6;341
44;Grand Est;10;3;08;278;Pargues;136;4;140
44;Grand Est;10;1;05;279;Pars-lès-Chavanges;47;1;48
44;Grand Est;10;2;09;280;Pars-lès-Romilly;816;8;824
44;Grand Est;10;3;11;281;Le Pavillon-Sainte-Julie;287;5;292
44;Grand Est;10;3;11;282;Payns;1375;19;1394
44;Grand Est;10;1;05;283;Pel-et-Der;129;2;131
44;Grand Est;10;2;07;284;Périgny-la-Rose;150;3;153
44;Grand Est;10;1;05;285;Perthes-lès-Brienne;69;0;69
44;Grand Est;10;1;03;286;Petit-Mesnil;206;7;213
44;Grand Est;10;3;05;287;Piney;1477;16;1493
44;Grand Est;10;3;04;288;Plaines-Saint-Lange;265;4;269
44;Grand Est;10;2;06;289;Plancy-l'Abbaye;966;16;982
44;Grand Est;10;3;01;290;Planty;232;3;235
44;Grand Est;10;2;07;291;Plessis-Barbuise;180;7;187
44;Grand Est;10;3;02;293;Poivres;159;2;161
44;Grand Est;10;3;04;294;Poligny;61;2;63
44;Grand Est;10;3;04;295;Polisot;324;6;330
44;Grand Est;10;3;04;296;Polisy;182;2;184
44;Grand Est;10;3;15;297;Pont-Sainte-Marie;5146;91;5237
44;Grand Est;10;2;07;298;Pont-sur-Seine;1160;20;1180
44;Grand Est;10;3;02;299;Pouan-les-Vallées;513;17;530
44;Grand Est;10;3;02;300;Pougy;289;2;291
44;Grand Est;10;2;11;301;Pouy-sur-Vannes;176;4;180
44;Grand Est;10;3;08;302;Praslin;85;2;87
44;Grand Est;10;1;05;303;Précy-Notre-Dame;77;1;78
44;Grand Est;10;1;05;304;Précy-Saint-Martin;183;2;185
44;Grand Est;10;2;06;305;Prémierfait;87;1;88
44;Grand Est;10;1;03;306;Proverville;236;6;242
44;Grand Est;10;3;01;307;Prugny;365;10;375
44;Grand Est;10;2;11;308;Prunay-Belleville;209;8;217
44;Grand Est;10;3;08;309;Prusy;96;2;98
44;Grand Est;10;1;17;310;Puits-et-Nuisement;211;7;218
44;Grand Est;10;3;01;312;Racines;169;4;173
44;Grand Est;10;1;05;313;Radonvilliers;356;4;360
44;Grand Est;10;3;02;314;Ramerupt;410;4;414
44;Grand Est;10;1;05;315;Rances;45;2;47
44;Grand Est;10;2;06;316;Rhèges;216;3;219
44;Grand Est;10;3;08;317;Les Riceys;1207;23;1230
44;Grand Est;10;2;11;318;Rigny-la-Nonneuse;156;2;158
44;Grand Est;10;3;01;319;Rigny-le-Ferron;322;9;331
44;Grand Est;10;2;06;320;Rilly-Sainte-Syre;230;5;235
44;Grand Est;10;3;10;321;La Rivière-de-Corps;3621;66;3687
44;Grand Est;10;2;09;323;Romilly-sur-Seine;14623;336;14959
44;Grand Est;10;3;08;324;Roncenay;159;3;162
44;Grand Est;10;3;10;325;Rosières-près-Troyes;4633;328;4961
44;Grand Est;10;1;05;326;Rosnay-l'Hôpital;169;8;177
44;Grand Est;10;1;03;327;La Rothière;116;1;117
44;Grand Est;10;3;05;328;Rouilly-Sacey;389;4;393
44;Grand Est;10;3;17;329;Rouilly-Saint-Loup;521;38;559
44;Grand Est;10;1;03;330;Rouvres-les-Vignes;112;1;113
44;Grand Est;10;3;04;331;Rumilly-lès-Vaudes;568;10;578
44;Grand Est;10;3;17;332;Ruvigny;495;11;506
44;Grand Est;10;3;10;333;Saint-André-les-Vergers;12701;179;12880
44;Grand Est;10;2;07;334;Saint-Aubin;590;8;598
44;Grand Est;10;3;01;335;Saint-Benoist-sur-Vanne;237;5;242
44;Grand Est;10;3;06;336;Saint-Benoît-sur-Seine;391;5;396
44;Grand Est;10;1;05;337;Saint-Christophe-Dodinicourt;33;1;34
44;Grand Est;10;3;02;338;Saint-Étienne-sous-Barbuise;177;3;180
44;Grand Est;10;2;11;339;Saint-Flavy;294;6;300
44;Grand Est;10;3;10;340;Saint-Germain;2305;48;2353
44;Grand Est;10;2;09;341;Saint-Hilaire-sous-Romilly;355;9;364
44;Grand Est;10;3;08;342;Saint-Jean-de-Bonneval;404;8;412
44;Grand Est;10;3;15;343;Saint-Julien-les-Villas;6738;145;6883
44;Grand Est;10;3;17;344;Saint-Léger-près-Troyes;912;15;927
44;Grand Est;10;1;05;345;Saint-Léger-sous-Brienne;383;11;394
44;Grand Est;10;1;05;346;Saint-Léger-sous-Margerie;51;1;52
44;Grand Est;10;2;11;347;Saint-Loup-de-Buffigny;207;6;213
44;Grand Est;10;2;11;348;Saint-Lupien;228;4;232
44;Grand Est;10;3;11;349;Saint-Lyé;2889;62;2951
44;Grand Est;10;3;01;350;Saint-Mards-en-Othe;638;14;652
44;Grand Est;10;2;11;351;Saint-Martin-de-Bossenay;365;5;370
44;Grand Est;10;3;06;352;Sainte-Maure;1752;294;2046
44;Grand Est;10;2;06;353;Saint-Mesmin;891;11;902
44;Grand Est;10;3;02;354;Saint-Nabord-sur-Aube;137;4;141
44;Grand Est;10;2;07;355;Saint-Nicolas-la-Chapelle;69;0;69
44;Grand Est;10;2;06;356;Saint-Oulph;311;7;318
44;Grand Est;10;3;15;357;Saint-Parres-aux-Tertres;3179;48;3227
44;Grand Est;10;3;04;358;Saint-Parres-lès-Vaudes;1062;18;1080
44;Grand Est;10;3;01;359;Saint-Phal;510;11;521
44;Grand Est;10;3;08;360;Saint-Pouange;972;231;1203
44;Grand Est;10;3;02;361;Saint-Remy-sous-Barbuise;246;4;250
44;Grand Est;10;3;13;362;Sainte-Savine;10496;351;10847
44;Grand Est;10;3;17;363;Saint-Thibault;547;3;550
44;Grand Est;10;3;04;364;Saint-Usage;72;2;74
44;Grand Est;10;2;06;365;Salon;125;0;125
44;Grand Est;10;1;03;366;Saulcy;63;2;65
44;Grand Est;10;2;07;367;La Saulsotte;681;9;690
44;Grand Est;10;2;06;368;Savières;1025;17;1042
44;Grand Est;10;3;02;369;Semoine;202;4;206
44;Grand Est;10;2;07;370;Soligny-les-Étangs;250;6;256
44;Grand Est;10;3;08;371;Sommeval;308;5;313
44;Grand Est;10;1;03;372;Soulaines-Dhuys;419;6;425
44;Grand Est;10;3;08;373;Souligny;378;20;398
44;Grand Est;10;1;03;374;Spoy;153;1;154
44;Grand Est;10;3;17;375;Thennelières;334;10;344
44;Grand Est;10;3;04;376;Thieffrain;154;3;157
44;Grand Est;10;1;03;377;Thil;111;9;120
44;Grand Est;10;1;03;378;Thors;68;3;71
44;Grand Est;10;3;02;379;Torcy-le-Grand;457;9;466
44;Grand Est;10;3;02;380;Torcy-le-Petit;77;2;79
44;Grand Est;10;3;10;381;Torvilliers;995;18;1013
44;Grand Est;10;2;07;382;Traînel;1036;13;1049
44;Grand Est;10;2;11;383;Trancault;184;3;187
44;Grand Est;10;1;17;384;Trannes;204;7;211
44;Grand Est;10;3;02;386;Trouans;217;6;223
44;Grand Est;10;3;99;387;Troyes;62597;1111;63708
44;Grand Est;10;3;08;388;Turgy;43;1;44
44;Grand Est;10;1;05;389;Unienville;112;4;116
44;Grand Est;10;1;03;390;Urville;120;2;122
44;Grand Est;10;3;06;391;Vailly;298;1;299
44;Grand Est;10;2;06;392;Vallant-Saint-Georges;402;9;411
44;Grand Est;10;1;05;393;Vallentigny;180;1;181
44;Grand Est;10;3;08;394;Vallières;166;1;167
44;Grand Est;10;3;08;395;Vanlay;293;4;297
44;Grand Est;10;3;01;396;Vauchassis;499;7;506
44;Grand Est;10;1;17;397;Vauchonvilliers;167;2;169
44;Grand Est;10;3;02;398;Vaucogne;74;1;75
44;Grand Est;10;3;04;399;Vaudes;721;8;729
44;Grand Est;10;3;02;400;Vaupoisson;116;5;121
44;Grand Est;10;1;17;401;Vendeuvre-sur-Barse;2317;41;2358
44;Grand Est;10;3;08;402;La Vendue-Mignot;244;5;249
44;Grand Est;10;1;03;403;Vernonvilliers;52;1;53
44;Grand Est;10;3;04;404;Verpillières-sur-Ource;111;2;113
44;Grand Est;10;3;02;405;Verricourt;58;0;58
44;Grand Est;10;3;17;406;Verrières;1858;37;1895
44;Grand Est;10;2;06;408;Viâpres-le-Petit;134;5;139
44;Grand Est;10;3;06;409;Villacerf;611;4;615
44;Grand Est;10;2;11;410;Villadin;105;4;109
44;Grand Est;10;1;03;411;La Ville-aux-Bois;28;0;28
44;Grand Est;10;3;06;412;Villechétif;949;20;969
44;Grand Est;10;3;11;414;Villeloup;125;5;130
44;Grand Est;10;3;08;416;Villemereuil;243;4;247
44;Grand Est;10;3;01;417;Villemoiron-en-Othe;207;6;213
44;Grand Est;10;3;04;418;Villemorien;198;10;208
44;Grand Est;10;3;04;419;Villemoyenne;739;13;752
44;Grand Est;10;2;07;420;Villenauxe-la-Grande;2685;44;2729
44;Grand Est;10;2;07;421;La Villeneuve-au-Châtelot;147;4;151
44;Grand Est;10;3;01;422;Villeneuve-au-Chemin;185;2;187
44;Grand Est;10;1;17;423;La Villeneuve-au-Chêne;408;15;423
44;Grand Est;10;1;05;424;Villeret;63;2;65
44;Grand Est;10;3;08;425;Villery;270;3;273
44;Grand Est;10;1;03;426;Ville-sous-la-Ferté;907;12;919
44;Grand Est;10;3;04;427;Ville-sur-Arce;200;7;207
44;Grand Est;10;1;03;428;Ville-sur-Terre;99;5;104
44;Grand Est;10;3;02;429;Villette-sur-Aube;249;3;252
44;Grand Est;10;3;02;430;Villiers-Herbisse;84;2;86
44;Grand Est;10;3;08;431;Villiers-le-Bois;102;1;103
44;Grand Est;10;3;08;432;Villiers-sous-Praslin;71;1;72
44;Grand Est;10;3;04;433;Villy-en-Trodes;253;8;261
44;Grand Est;10;3;08;434;Villy-le-Bois;57;1;58
44;Grand Est;10;3;08;435;Villy-le-Maréchal;190;4;194
44;Grand Est;10;3;02;436;Vinets;176;5;181
44;Grand Est;10;3;04;437;Virey-sous-Bar;600;10;610
44;Grand Est;10;3;04;438;Vitry-le-Croisé;222;2;224
44;Grand Est;10;3;04;439;Viviers-sur-Artaut;123;3;126
44;Grand Est;10;1;03;440;Voigny;144;6;150
44;Grand Est;10;3;01;441;Vosnon;231;1;232
44;Grand Est;10;3;02;442;Voué;699;9;708
44;Grand Est;10;3;08;443;Vougrey;43;1;44
44;Grand Est;10;3;01;444;Vulaines;226;3;229
44;Grand Est;10;1;05;445;Yèvres-le-Petit;54;9;63
76;Occitanie;11;1;15;001;Aigues-Vives;550;11;561
76;Occitanie;11;1;05;002;Airoux;170;2;172
76;Occitanie;11;2;09;003;Ajac;201;3;204
76;Occitanie;11;2;01;004;Alaigne;337;5;342
76;Occitanie;11;1;04;005;Alairac;1338;32;1370
76;Occitanie;11;3;07;006;Albas;78;2;80
76;Occitanie;11;3;07;007;Albières;119;4;123
76;Occitanie;11;2;09;008;Alet-les-Bains;388;3;391
76;Occitanie;11;1;10;009;Alzonne;1592;23;1615
76;Occitanie;11;2;14;010;Antugnac;270;4;274
76;Occitanie;11;1;19;011;Aragon;467;14;481
76;Occitanie;11;3;16;012;Argeliers;2155;36;2191
76;Occitanie;11;3;08;013;Argens-Minervois;355;6;361
76;Occitanie;11;3;06;014;Armissan;1495;30;1525
76;Occitanie;11;2;14;015;Arques;261;3;264
76;Occitanie;11;1;18;016;Arquettes-en-Val;80;3;83
76;Occitanie;11;2;14;017;Artigues;75;1;76
76;Occitanie;11;1;10;018;Arzens;1211;33;1244
76;Occitanie;11;2;14;019;Aunat;62;0;62
76;Occitanie;11;3;07;020;Auriac;35;0;35
76;Occitanie;11;2;14;021;Axat;513;9;522
76;Occitanie;11;1;15;022;Azille;1123;23;1146
76;Occitanie;11;1;18;023;Badens;745;14;759
76;Occitanie;11;3;12;024;Bages;782;15;797
76;Occitanie;11;1;15;025;Bagnoles;308;3;311
76;Occitanie;11;1;01;026;Baraigne;172;3;175
76;Occitanie;11;1;18;027;Barbaira;793;22;815
76;Occitanie;11;2;14;028;Belcaire;376;7;383
76;Occitanie;11;2;09;029;Belcastel-et-Buc;61;3;64
76;Occitanie;11;1;01;030;Belflou;114;6;120
76;Occitanie;11;2;14;031;Belfort-sur-Rebenty;21;2;23
76;Occitanie;11;2;01;032;Bellegarde-du-Razès;247;2;249
76;Occitanie;11;1;01;033;Belpech;1339;28;1367
76;Occitanie;11;2;01;034;Belvèze-du-Razès;853;6;859
76;Occitanie;11;2;14;035;Belvianes-et-Cavirac;238;9;247
76;Occitanie;11;2;14;036;Belvis;161;3;164
76;Occitanie;11;1;18;037;Berriac;950;10;960
76;Occitanie;11;2;14;038;Bessède-de-Sault;46;0;46
76;Occitanie;11;2;09;039;La Bezole;47;1;48
76;Occitanie;11;3;11;040;Bizanet;1754;28;1782
76;Occitanie;11;3;16;041;Bize-Minervois;1243;15;1258
76;Occitanie;11;1;18;042;Blomac;235;7;242
76;Occitanie;11;1;18;043;Bouilhonnac;221;6;227
76;Occitanie;11;3;07;044;Bouisse;104;0;104
76;Occitanie;11;2;09;045;Bouriège;144;1;145
76;Occitanie;11;2;09;046;Bourigeole;55;0;55
76;Occitanie;11;2;14;047;Le Bousquet;48;0;48
76;Occitanie;11;3;07;048;Boutenac;722;15;737
76;Occitanie;11;1;01;049;Bram;3226;78;3304
76;Occitanie;11;1;01;051;Brézilhac;184;4;188
76;Occitanie;11;1;10;052;Brousses-et-Villaret;340;5;345
76;Occitanie;11;2;01;053;Brugairolles;287;5;292
76;Occitanie;11;1;10;054;Les Brunels;269;11;280
76;Occitanie;11;2;14;055;Bugarach;240;4;244
76;Occitanie;11;1;15;056;Cabrespine;167;4;171
76;Occitanie;11;1;01;057;Cahuzac;28;0;28
76;Occitanie;11;2;01;058;Cailhau;251;10;261
76;Occitanie;11;2;01;059;Cailhavel;144;1;145
76;Occitanie;11;2;14;060;Cailla;50;1;51
76;Occitanie;11;2;01;061;Cambieure;313;4;317
76;Occitanie;11;2;14;062;Campagna-de-Sault;19;0;19
76;Occitanie;11;2;14;063;Campagne-sur-Aude;606;6;612
76;Occitanie;11;3;07;064;Camplong-d'Aude;373;4;377
76;Occitanie;11;2;14;065;Camps-sur-l'Agly;51;0;51
76;Occitanie;11;2;14;066;Camurac;104;1;105
76;Occitanie;11;3;16;067;Canet;1832;18;1850
76;Occitanie;11;1;18;068;Capendu;1473;39;1512
76;Occitanie;11;1;98;069;Carcassonne;46673;1181;47854
76;Occitanie;11;1;10;070;Carlipa;338;6;344
76;Occitanie;11;3;07;071;Cascastel-des-Corbières;223;7;230
76;Occitanie;11;1;01;072;La Cassaigne;163;8;171
76;Occitanie;11;2;14;073;Cassaignes;59;0;59
76;Occitanie;11;1;05;074;Les Cassés;307;10;317
76;Occitanie;11;1;15;075;Castans;134;2;136
76;Occitanie;11;1;05;076;Castelnaudary;12467;511;12978
76;Occitanie;11;3;08;077;Castelnau-d'Aude;500;12;512
76;Occitanie;11;2;09;078;Castelreng;206;7;213
76;Occitanie;11;1;19;079;Caudebronde;215;3;218
76;Occitanie;11;2;14;080;Val de Lambronne;167;2;169
76;Occitanie;11;1;15;081;Caunes-Minervois;1601;29;1630
76;Occitanie;11;2;09;082;Caunette-sur-Lauquet;10;0;10
76;Occitanie;11;1;18;083;Caunettes-en-Val;56;0;56
76;Occitanie;11;1;10;084;Caux-et-Sauzens;1005;23;1028
76;Occitanie;11;1;03;085;Cavanac;960;41;1001
76;Occitanie;11;3;17;086;Caves;897;11;908
76;Occitanie;11;1;01;087;Cazalrenoux;93;1;94
76;Occitanie;11;1;03;088;Cazilhac;1640;50;1690
76;Occitanie;11;1;10;089;Cenne-Monestiés;408;10;418
76;Occitanie;11;2;09;090;Cépie;615;17;632
76;Occitanie;11;2;14;091;Chalabre;1139;12;1151
76;Occitanie;11;1;15;092;Citou;91;3;94
76;Occitanie;11;2;14;093;Le Clat;28;1;29
76;Occitanie;11;2;09;094;Clermont-sur-Lauquet;27;0;27
76;Occitanie;11;1;18;095;Comigne;312;5;317
76;Occitanie;11;2;14;096;Comus;32;0;32
76;Occitanie;11;3;08;098;Conilhac-Corbières;899;19;918
76;Occitanie;11;1;19;099;Conques-sur-Orbiel;2585;56;2641
76;Occitanie;11;2;14;100;Corbières;29;1;30
76;Occitanie;11;2;14;101;Coudons;52;2;54
76;Occitanie;11;1;03;102;Couffoulens;571;14;585
76;Occitanie;11;2;14;103;Couiza;1122;21;1143
76;Occitanie;11;2;14;104;Counozouls;52;0;52
76;Occitanie;11;2;09;105;Cournanel;706;23;729
76;Occitanie;11;3;06;106;Coursan;5785;95;5880
76;Occitanie;11;2;14;107;Courtauly;77;1;78
76;Occitanie;11;2;01;108;La Courtète;46;1;47
76;Occitanie;11;2;14;109;Coustaussa;52;1;53
76;Occitanie;11;3;07;110;Coustouge;116;0;116
76;Occitanie;11;3;08;111;Cruscades;921;9;930
76;Occitanie;11;2;14;112;Cubières-sur-Cinoble;83;1;84
76;Occitanie;11;3;07;113;Cucugnan;113;5;118
76;Occitanie;11;1;01;114;Cumiès;41;0;41
76;Occitanie;11;1;10;115;Cuxac-Cabardès;916;12;928
76;Occitanie;11;3;06;116;Cuxac-d'Aude;4044;71;4115
76;Occitanie;11;3;07;117;Davejean;114;2;116
76;Occitanie;11;3;07;118;Dernacueillette;46;0;46
76;Occitanie;11;2;09;119;La Digne-d'Amont;293;4;297
76;Occitanie;11;2;09;120;La Digne-d'Aval;527;13;540
76;Occitanie;11;2;01;121;Donazac;111;1;112
76;Occitanie;11;1;18;122;Douzens;771;13;784
76;Occitanie;11;3;07;123;Duilhac-sous-Peyrepertuse;148;3;151
76;Occitanie;11;3;07;124;Durban-Corbières;651;11;662
76;Occitanie;11;3;07;125;Embres-et-Castelmaure;152;0;152
76;Occitanie;11;3;08;126;Escales;477;5;482
76;Occitanie;11;2;14;127;Escouloubre;71;4;75
76;Occitanie;11;2;01;128;Escueillens-et-Saint-Just-de-Bélengard;146;2;148
76;Occitanie;11;2;14;129;Espéraza;1712;30;1742
76;Occitanie;11;2;14;130;Espezel;229;4;233
76;Occitanie;11;2;14;131;Val-du-Faby;582;13;595
76;Occitanie;11;3;07;132;Fabrezan;1256;15;1271
76;Occitanie;11;1;18;133;Fajac-en-Val;45;0;45
76;Occitanie;11;1;01;134;Fajac-la-Relenque;50;4;54
76;Occitanie;11;2;14;135;La Fajolle;12;0;12
76;Occitanie;11;1;01;136;Fanjeaux;859;86;945
76;Occitanie;11;3;07;137;Félines-Termenès;129;5;134
76;Occitanie;11;1;05;138;Fendeille;523;16;539
76;Occitanie;11;1;01;139;Fenouillet-du-Razès;77;0;77
76;Occitanie;11;3;07;140;Ferrals-les-Corbières;1256;21;1277
76;Occitanie;11;1;01;141;Ferran;124;1;125
76;Occitanie;11;2;09;142;Festes-et-Saint-André;194;5;199
76;Occitanie;11;3;17;143;Feuilla;110;0;110
76;Occitanie;11;3;17;144;Fitou;1096;15;1111
76;Occitanie;11;3;06;145;Fleury;3713;60;3773
76;Occitanie;11;1;18;146;Floure;412;8;420
76;Occitanie;11;2;14;147;Fontanès-de-Sault;5;0;5
76;Occitanie;11;3;07;148;Fontcouverte;559;7;566
76;Occitanie;11;1;01;149;Fonters-du-Razès;79;1;80
76;Occitanie;11;1;10;150;Fontiers-Cabardès;449;50;499
76;Occitanie;11;1;18;151;Fontiès-d'Aude;523;11;534
76;Occitanie;11;3;07;152;Fontjoncouse;131;3;134
76;Occitanie;11;1;01;153;La Force;250;7;257
76;Occitanie;11;1;19;154;Fournes-Cabardès;51;0;51
76;Occitanie;11;2;14;155;Fourtou;79;1;80
76;Occitanie;11;1;10;156;Fraisse-Cabardès;105;1;106
76;Occitanie;11;3;07;157;Fraissé-des-Corbières;212;5;217
76;Occitanie;11;2;09;158;Gaja-et-Villedieu;297;4;301
76;Occitanie;11;1;01;159;Gaja-la-Selve;137;2;139
76;Occitanie;11;2;14;160;Galinagues;35;0;35
76;Occitanie;11;2;09;161;Gardie;127;4;131
76;Occitanie;11;1;01;162;Generville;57;1;58
76;Occitanie;11;2;14;163;Gincla;46;1;47
76;Occitanie;11;3;16;164;Ginestas;1515;21;1536
76;Occitanie;11;2;14;165;Ginoles;303;9;312
76;Occitanie;11;1;01;166;Gourvieille;77;2;79
76;Occitanie;11;2;01;167;Gramazie;125;5;130
76;Occitanie;11;2;14;168;Granès;102;3;105
76;Occitanie;11;2;09;169;Greffeil;90;5;95
76;Occitanie;11;3;12;170;Gruissan;5131;84;5215
76;Occitanie;11;3;08;172;Homps;597;11;608
76;Occitanie;11;1;01;173;Hounoux;129;3;132
76;Occitanie;11;1;19;174;Les Ilhes;56;0;56
76;Occitanie;11;1;05;175;Issel;479;9;488
76;Occitanie;11;3;07;176;Jonquières;56;0;56
76;Occitanie;11;2;14;177;Joucou;31;0;31
76;Occitanie;11;1;05;178;Labastide-d'Anjou;1278;15;1293
76;Occitanie;11;1;18;179;Labastide-en-Val;90;2;92
76;Occitanie;11;1;19;180;Labastide-Esparbairenque;61;0;61
76;Occitanie;11;1;10;181;Labécède-Lauragais;406;8;414
76;Occitanie;11;1;10;182;Lacombe;175;3;178
76;Occitanie;11;2;09;183;Ladern-sur-Lauquet;268;9;277
76;Occitanie;11;1;01;184;Lafage;93;3;96
76;Occitanie;11;3;07;185;Lagrasse;544;9;553
76;Occitanie;11;3;07;186;Lairière;54;0;54
76;Occitanie;11;3;07;187;Lanet;60;1;61
76;Occitanie;11;3;17;188;La Palme;1712;30;1742
76;Occitanie;11;1;10;189;Laprade;108;1;109
76;Occitanie;11;1;15;190;La Redorte;1243;20;1263
76;Occitanie;11;3;07;191;Laroque-de-Fa;150;7;157
76;Occitanie;11;1;05;192;Lasbordes;783;31;814
76;Occitanie;11;1;01;193;Lasserre-de-Prouille;282;5;287
76;Occitanie;11;1;19;194;Lastours;155;3;158
76;Occitanie;11;1;01;195;Laurabuc;393;10;403
76;Occitanie;11;1;01;196;Laurac;181;7;188
76;Occitanie;11;2;01;197;Lauraguel;608;13;621
76;Occitanie;11;1;15;198;Laure-Minervois;1013;15;1028
76;Occitanie;11;1;04;199;Lavalette;1517;28;1545
76;Occitanie;11;1;15;200;Lespinassière;134;3;137
76;Occitanie;11;1;03;201;Leuc;851;18;869
76;Occitanie;11;3;17;202;Leucate;4581;54;4635
76;Occitanie;11;3;08;203;Lézignan-Corbières;11112;226;11338
76;Occitanie;11;2;01;204;Lignairolles;43;0;43
76;Occitanie;11;1;15;205;Limousis;131;1;132
76;Occitanie;11;2;09;206;Limoux;10161;520;10681
76;Occitanie;11;2;09;207;Loupia;241;5;246
76;Occitanie;11;1;01;208;La Louvière-Lauragais;81;3;84
76;Occitanie;11;2;14;209;Luc-sur-Aude;244;8;252
76;Occitanie;11;3;07;210;Luc-sur-Orbieu;1132;10;1142
76;Occitanie;11;2;09;211;Magrie;537;5;542
76;Occitanie;11;3;16;212;Mailhac;577;11;588
76;Occitanie;11;3;07;213;Maisons;47;0;47
76;Occitanie;11;2;09;214;Malras;426;13;439
76;Occitanie;11;1;19;215;Malves-en-Minervois;863;26;889
76;Occitanie;11;2;01;216;Malviès;365;12;377
76;Occitanie;11;3;16;217;Marcorignan;1309;28;1337
76;Occitanie;11;1;01;218;Marquein;82;0;82
76;Occitanie;11;2;14;219;Marsa;19;0;19
76;Occitanie;11;1;18;220;Marseillette;702;13;715
76;Occitanie;11;1;19;221;Les Martys;302;5;307
76;Occitanie;11;1;19;222;Mas-Cabardès;176;5;181
76;Occitanie;11;1;03;223;Mas-des-Cours;25;1;26
76;Occitanie;11;3;07;224;Massac;27;1;28
76;Occitanie;11;1;05;225;Mas-Saintes-Puelles;929;18;947
76;Occitanie;11;1;01;226;Mayreville;84;1;85
76;Occitanie;11;1;18;227;Mayronnes;40;1;41
76;Occitanie;11;2;01;228;Mazerolles-du-Razès;148;4;152
76;Occitanie;11;2;14;229;Mazuby;26;1;27
76;Occitanie;11;2;14;230;Mérial;32;0;32
76;Occitanie;11;1;01;231;Mézerville;98;3;101
76;Occitanie;11;1;19;232;Miraval-Cabardès;46;0;46
76;Occitanie;11;3;16;233;Mirepeisset;752;13;765
76;Occitanie;11;1;01;234;Mireval-Lauragais;185;5;190
76;Occitanie;11;2;14;235;Missègre;58;2;60
76;Occitanie;11;1;01;236;Molandier;245;2;247
76;Occitanie;11;1;01;238;Molleville;141;6;147
76;Occitanie;11;1;01;239;Montauriol;81;2;83
76;Occitanie;11;2;14;240;Montazels;556;9;565
76;Occitanie;11;3;08;241;Montbrun-des-Corbières;339;1;340
76;Occitanie;11;1;04;242;Montclar;175;0;175
76;Occitanie;11;1;05;243;Montferrand;625;10;635
76;Occitanie;11;2;14;244;Montfort-sur-Boulzane;90;3;93
76;Occitanie;11;3;07;245;Montgaillard;38;0;38
76;Occitanie;11;2;01;246;Montgradail;45;0;45
76;Occitanie;11;2;01;247;Monthaut;38;0;38
76;Occitanie;11;1;18;248;Montirat;69;1;70
76;Occitanie;11;2;14;249;Montjardin;83;1;84
76;Occitanie;11;3;07;250;Montjoi;35;1;36
76;Occitanie;11;1;18;251;Val-de-Dagne;737;14;751
76;Occitanie;11;1;05;252;Montmaur;320;1;321
76;Occitanie;11;1;10;253;Montolieu;833;14;847
76;Occitanie;11;1;10;254;Montréal;1980;191;2171
76;Occitanie;11;3;11;255;Montredon-des-Corbières;1482;20;1502
76;Occitanie;11;3;07;256;Montséret;621;12;633
76;Occitanie;11;1;18;257;Monze;234;3;237
76;Occitanie;11;3;16;258;Moussan;2041;47;2088
76;Occitanie;11;1;10;259;Moussoulens;1003;31;1034
76;Occitanie;11;3;07;260;Mouthoumet;109;1;110
76;Occitanie;11;3;18;261;Moux;707;8;715
76;Occitanie;11;3;99;262;Narbonne;56123;1197;57320
76;Occitanie;11;2;14;263;Nébias;261;8;269
76;Occitanie;11;3;11;264;Névian;1277;33;1310
76;Occitanie;11;2;14;265;Niort-de-Sault;41;1;42
76;Occitanie;11;3;17;266;Port-la-Nouvelle;5905;70;5975
76;Occitanie;11;3;08;267;Ornaisons;1113;25;1138
76;Occitanie;11;1;01;268;Orsans;117;0;117
76;Occitanie;11;3;16;269;Ouveillan;2554;51;2605
76;Occitanie;11;3;07;270;Padern;140;0;140
76;Occitanie;11;3;07;271;Palairac;32;0;32
76;Occitanie;11;1;03;272;Palaja;2496;71;2567
76;Occitanie;11;3;16;273;Paraza;698;11;709
76;Occitanie;11;2;09;274;Pauligne;374;15;389
76;Occitanie;11;1;01;275;Payra-sur-l'Hers;205;3;208
76;Occitanie;11;3;07;276;Paziols;525;17;542
76;Occitanie;11;1;01;277;Pécharic-et-le-Py;29;2;31
76;Occitanie;11;1;01;278;Pech-Luna;75;2;77
76;Occitanie;11;1;19;279;Pennautier;2714;50;2764
76;Occitanie;11;1;15;280;Pépieux;1087;29;1116
76;Occitanie;11;1;01;281;Pexiora;1241;33;1274
76;Occitanie;11;2;14;282;Peyrefitte-du-Razès;53;2;55
76;Occitanie;11;1;01;283;Peyrefitte-sur-l'Hers;78;5;83
76;Occitanie;11;1;05;284;Peyrens;466;16;482
76;Occitanie;11;3;17;285;Peyriac-de-Mer;1143;22;1165
76;Occitanie;11;1;15;286;Peyriac-Minervois;1177;20;1197
76;Occitanie;11;2;14;287;Peyrolles;87;2;89
76;Occitanie;11;1;10;288;Pezens;1584;153;1737
76;Occitanie;11;2;09;289;Pieusse;968;17;985
76;Occitanie;11;1;01;290;Plaigne;117;2;119
76;Occitanie;11;1;01;291;Plavilla;120;1;121
76;Occitanie;11;1;05;292;La Pomarède;177;1;178
76;Occitanie;11;2;09;293;Pomas;920;23;943
76;Occitanie;11;2;01;294;Pomy;56;1;57
76;Occitanie;11;3;17;295;Portel-des-Corbières;1322;21;1343
76;Occitanie;11;3;16;296;Pouzols-Minervois;576;5;581
76;Occitanie;11;1;19;297;Pradelles-Cabardès;148;1;149
76;Occitanie;11;1;04;299;Preixan;625;14;639
76;Occitanie;11;1;05;300;Puginier;155;0;155
76;Occitanie;11;1;15;301;Puichéric;1186;17;1203
76;Occitanie;11;2;14;302;Puilaurens;263;9;272
76;Occitanie;11;2;14;303;Puivert;436;16;452
76;Occitanie;11;2;14;304;Quillan;3141;96;3237
76;Occitanie;11;3;07;305;Quintillan;48;0;48
76;Occitanie;11;2;14;306;Quirbajou;51;1;52
76;Occitanie;11;3;16;307;Raissac-d'Aude;258;6;264
76;Occitanie;11;1;10;308;Raissac-sur-Lampy;462;9;471
76;Occitanie;11;2;14;309;Rennes-le-Château;91;1;92
76;Occitanie;11;2;14;310;Rennes-les-Bains;197;2;199
76;Occitanie;11;3;07;311;Ribaute;267;3;270
76;Occitanie;11;1;01;312;Ribouisse;109;5;114
76;Occitanie;11;1;05;313;Ricaud;310;6;316
76;Occitanie;11;1;18;314;Rieux-en-Val;85;7;92
76;Occitanie;11;1;15;315;Rieux-Minervois;1937;25;1962
76;Occitanie;11;2;14;316;Rivel;212;3;215
76;Occitanie;11;2;14;317;Rodome;107;2;109
76;Occitanie;11;3;18;318;Roquecourbe-Minervois;131;6;137
76;Occitanie;11;1;19;319;Roquefère;77;2;79
76;Occitanie;11;2;14;320;Roquefeuil;291;10;301
76;Occitanie;11;2;14;321;Roquefort-de-Sault;83;0;83
76;Occitanie;11;3;17;322;Roquefort-des-Corbières;1005;18;1023
76;Occitanie;11;2;14;323;Roquetaillade-et-Conilhac;273;3;276
76;Occitanie;11;3;16;324;Roubia;503;13;516
76;Occitanie;11;1;04;325;Rouffiac-d'Aude;453;11;464
76;Occitanie;11;3;07;326;Rouffiac-des-Corbières;76;1;77
76;Occitanie;11;1;04;327;Roullens;508;11;519
76;Occitanie;11;2;01;328;Routier;238;3;241
76;Occitanie;11;1;15;330;Rustiques;509;11;520
76;Occitanie;11;1;01;331;Saint-Amans;60;3;63
76;Occitanie;11;3;07;332;Saint-André-de-Roquelongue;1377;17;1394
76;Occitanie;11;2;14;333;Saint-Benoît;107;3;110
76;Occitanie;11;1;01;334;Sainte-Camelle;118;2;120
76;Occitanie;11;2;14;335;Sainte-Colombe-sur-Guette;45;0;45
76;Occitanie;11;2;14;336;Sainte-Colombe-sur-l'Hers;438;5;443
76;Occitanie;11;3;18;337;Saint-Couat-d'Aude;381;4;385
76;Occitanie;11;2;09;338;Saint-Couat-du-Razès;40;1;41
76;Occitanie;11;1;10;339;Saint-Denis;500;12;512
76;Occitanie;11;1;10;340;Sainte-Eulalie;518;10;528
76;Occitanie;11;2;14;341;Saint-Ferriol;110;2;112
76;Occitanie;11;1;15;342;Saint-Frichoux;236;4;240
76;Occitanie;11;1;01;343;Saint-Gaudéric;116;2;118
76;Occitanie;11;2;09;344;Saint-Hilaire;713;14;727
76;Occitanie;11;3;07;345;Saint-Jean-de-Barrou;263;0;263
76;Occitanie;11;2;14;346;Saint-Jean-de-Paracol;131;4;135
76;Occitanie;11;2;14;347;Saint-Julia-de-Bec;104;2;106
76;Occitanie;11;1;01;348;Saint-Julien-de-Briola;85;2;87
76;Occitanie;11;2;14;350;Saint-Just-et-le-Bézu;51;3;54
76;Occitanie;11;3;07;351;Saint-Laurent-de-la-Cabrerisse;735;15;750
76;Occitanie;11;2;14;352;Saint-Louis-et-Parahou;51;2;53
76;Occitanie;11;3;16;353;Saint-Marcel-sur-Aude;2028;46;2074
76;Occitanie;11;3;07;354;Saint-Martin-des-Puits;28;1;29
76;Occitanie;11;2;09;355;Saint-Martin-de-Villereglan;370;8;378
76;Occitanie;11;1;05;356;Saint-Martin-Lalande;1117;24;1141
76;Occitanie;11;1;10;357;Saint-Martin-le-Vieil;212;7;219
76;Occitanie;11;2;14;358;Saint-Martin-Lys;24;0;24
76;Occitanie;11;1;01;359;Saint-Michel-de-Lanès;481;6;487
76;Occitanie;11;3;16;360;Saint-Nazaire-d'Aude;2076;37;2113
76;Occitanie;11;1;05;361;Saint-Papoul;866;14;880
76;Occitanie;11;1;05;362;Saint-Paulet;204;4;208
76;Occitanie;11;3;07;363;Saint-Pierre-des-Champs;182;5;187
76;Occitanie;11;2;09;364;Saint-Polycarpe;141;2;143
76;Occitanie;11;1;01;365;Saint-Sernin;41;2;43
76;Occitanie;11;3;16;366;Sainte-Valière;536;10;546
76;Occitanie;11;1;10;367;Saissac;919;23;942
76;Occitanie;11;1;15;368;Sallèles-Cabardès;121;2;123
76;Occitanie;11;3;16;369;Sallèles-d'Aude;3039;43;3082
76;Occitanie;11;3;06;370;Salles-d'Aude;3251;76;3327
76;Occitanie;11;1;01;371;Salles-sur-l'Hers;715;13;728
76;Occitanie;11;1;19;372;Salsigne;378;4;382
76;Occitanie;11;2;14;373;Salvezines;69;1;70
76;Occitanie;11;3;07;374;Salza;20;0;20
76;Occitanie;11;2;01;375;Seignalens;29;1;30
76;Occitanie;11;2;14;376;La Serpent;95;4;99
76;Occitanie;11;2;14;377;Serres;81;0;81
76;Occitanie;11;1;18;378;Serviès-en-Val;198;6;204
76;Occitanie;11;3;17;379;Sigean;5542;98;5640
76;Occitanie;11;2;14;380;Sonnac-sur-l'Hers;133;1;134
76;Occitanie;11;2;14;381;Sougraigne;124;4;128
76;Occitanie;11;1;05;382;Souilhanels;359;58;417
76;Occitanie;11;1;05;383;Souilhe;333;11;344
76;Occitanie;11;3;07;384;Soulatgé;128;1;129
76;Occitanie;11;1;05;385;Soupex;234;7;241
76;Occitanie;11;3;07;386;Talairan;467;8;475
76;Occitanie;11;1;18;387;Taurize;110;1;111
76;Occitanie;11;3;07;388;Termes;47;0;47
76;Occitanie;11;2;14;389;Terroles;15;0;15
76;Occitanie;11;3;07;390;Thézan-des-Corbières;554;10;564
76;Occitanie;11;1;19;391;La Tourette-Cabardès;24;2;26
76;Occitanie;11;3;07;392;Tournissan;268;4;272
76;Occitanie;11;3;08;393;Tourouzelle;489;7;496
76;Occitanie;11;2;09;394;Tourreilles;130;0;130
76;Occitanie;11;1;15;395;Trassanel;28;0;28
76;Occitanie;11;1;15;396;Trausse;598;3;601
76;Occitanie;11;1;18;397;Trèbes;5438;122;5560
76;Occitanie;11;3;17;398;Treilles;255;5;260
76;Occitanie;11;1;05;399;Tréville;106;5;111
76;Occitanie;11;2;14;400;Tréziers;105;1;106
76;Occitanie;11;3;07;401;Tuchan;790;12;802
76;Occitanie;11;2;14;402;Valmigère;24;0;24
76;Occitanie;11;1;19;404;Ventenac-Cabardès;955;31;986
76;Occitanie;11;3;16;405;Ventenac-en-Minervois;575;10;585
76;Occitanie;11;2;09;406;Véraza;32;2;34
76;Occitanie;11;1;10;407;Verdun-en-Lauragais;286;6;292
76;Occitanie;11;1;03;408;Verzeille;489;14;503
76;Occitanie;11;3;07;409;Vignevieille;105;1;106
76;Occitanie;11;1;19;410;Villalier;970;17;987
76;Occitanie;11;1;19;411;Villanière;137;3;140
76;Occitanie;11;2;09;412;Villardebelle;56;0;56
76;Occitanie;11;1;19;413;Villardonnel;500;10;510
76;Occitanie;11;1;18;414;Villar-en-Val;24;1;25
76;Occitanie;11;2;09;415;Villar-Saint-Anselme;125;0;125
76;Occitanie;11;1;15;416;Villarzel-Cabardès;257;5;262
76;Occitanie;11;2;01;417;Villarzel-du-Razès;98;0;98
76;Occitanie;11;1;01;418;Villasavary;1212;40;1252
76;Occitanie;11;1;01;419;Villautou;64;0;64
76;Occitanie;11;2;09;420;Villebazy;139;3;142
76;Occitanie;11;3;11;421;Villedaigne;554;8;562
76;Occitanie;11;1;18;422;Villedubert;345;15;360
76;Occitanie;11;1;03;423;Villefloure;156;4;160
76;Occitanie;11;2;14;424;Villefort;85;1;86
76;Occitanie;11;1;19;425;Villegailhenc;1658;53;1711
76;Occitanie;11;1;15;426;Villegly;1196;24;1220
76;Occitanie;11;2;09;427;Villelongue-d'Aude;299;8;307
76;Occitanie;11;1;10;428;Villemagne;247;7;254
76;Occitanie;11;1;19;429;Villemoustaussou;4501;82;4583
76;Occitanie;11;1;05;430;Villeneuve-la-Comptal;1380;41;1421
76;Occitanie;11;3;07;431;Villeneuve-les-Corbières;251;7;258
76;Occitanie;11;1;10;432;Villeneuve-lès-Montréal;335;11;346
76;Occitanie;11;1;15;433;Villeneuve-Minervois;955;17;972
76;Occitanie;11;1;01;434;Villepinte;1260;27;1287
76;Occitanie;11;3;07;435;Villerouge-Termenès;157;6;163
76;Occitanie;11;3;07;436;Villesèque-des-Corbières;370;2;372
76;Occitanie;11;1;10;437;Villesèquelande;899;26;925
76;Occitanie;11;1;01;438;Villesiscle;381;10;391
76;Occitanie;11;1;10;439;Villespy;408;8;416
76;Occitanie;11;1;18;440;Villetritouls;34;0;34
76;Occitanie;11;3;06;441;Vinassan;2662;54;2716
76;Occitanie;12;1;03;001;Agen-d'Aveyron;1086;26;1112
76;Occitanie;12;1;12;002;Aguessac;887;29;916
76;Occitanie;12;3;08;003;Les Albres;342;5;347
76;Occitanie;12;3;07;004;Almont-les-Junies;441;19;460
76;Occitanie;12;1;15;006;Alrance;345;10;355
76;Occitanie;12;3;23;007;Ambeyrac;177;8;185
76;Occitanie;12;3;06;008;Anglars-Saint-Félix;918;20;938
76;Occitanie;12;1;04;009;Arnac-sur-Dourdou;36;1;37
76;Occitanie;12;1;15;010;Arques;158;2;160
76;Occitanie;12;1;13;011;Arvieu;764;27;791
76;Occitanie;12;3;08;012;Asprières;755;9;764
76;Occitanie;12;3;06;013;Aubin;3640;137;3777
76;Occitanie;12;1;13;015;Auriac-Lagast;229;5;234
76;Occitanie;12;3;06;016;Auzits;817;21;838
76;Occitanie;12;1;15;017;Ayssènes;218;5;223
76;Occitanie;12;3;08;018;Balaguier-d'Olt;180;7;187
76;Occitanie;12;1;04;019;Balaguier-sur-Rance;88;4;92
76;Occitanie;12;3;02;021;Le Bas Ségala;1576;30;1606
76;Occitanie;12;1;19;022;La Bastide-Pradines;113;0;113
76;Occitanie;12;1;04;023;La Bastide-Solages;104;1;105
76;Occitanie;12;3;06;024;Belcastel;193;3;196
76;Occitanie;12;1;04;025;Belmont-sur-Rance;970;12;982
76;Occitanie;12;2;09;026;Bertholène;1060;21;1081
76;Occitanie;12;2;10;027;Bessuéjouls;209;7;216
76;Occitanie;12;3;07;028;Boisse-Penchot;520;10;530
76;Occitanie;12;3;02;029;Bor-et-Bar;200;5;205
76;Occitanie;12;3;08;030;Bouillac;376;17;393
76;Occitanie;12;3;06;031;Bournazel;346;15;361
76;Occitanie;12;3;05;032;Boussac;598;18;616
76;Occitanie;12;2;03;033;Bozouls;2951;86;3037
76;Occitanie;12;3;23;034;Brandonnet;295;8;303
76;Occitanie;12;1;04;035;Brasc;173;7;180
76;Occitanie;12;2;01;036;Brommat;637;8;645
76;Occitanie;12;1;15;037;Broquiès;609;15;624
76;Occitanie;12;1;15;038;Brousse-le-Château;165;4;169
76;Occitanie;12;1;04;039;Brusque;261;4;265
76;Occitanie;12;3;05;041;Cabanès;268;6;274
76;Occitanie;12;1;19;042;Calmels-et-le-Viala;201;7;208
76;Occitanie;12;3;13;043;Calmont;2184;77;2261
76;Occitanie;12;1;04;044;Camarès;1025;30;1055
76;Occitanie;12;3;05;045;Camboulazet;380;13;393
76;Occitanie;12;3;05;046;Camjac;574;10;584
76;Occitanie;12;2;20;047;Campagnac;450;5;455
76;Occitanie;12;2;01;048;Campouriez;341;8;349
76;Occitanie;12;2;10;049;Campuac;457;10;467
76;Occitanie;12;1;15;050;Canet-de-Salars;447;12;459
76;Occitanie;12;2;01;051;Cantoin;310;4;314
76;Occitanie;12;3;08;052;Capdenac-Gare;4400;116;4516
76;Occitanie;12;3;23;053;La Capelle-Balaguier;337;6;343
76;Occitanie;12;3;02;054;La Capelle-Bleys;347;8;355
76;Occitanie;12;2;20;055;La Capelle-Bonance;83;0;83
76;Occitanie;12;3;05;056;Baraqueville;3158;101;3259
76;Occitanie;12;3;13;057;Cassagnes-Bégonhès;936;33;969
76;Occitanie;12;2;01;058;Cassuéjouls;105;5;110
76;Occitanie;12;3;05;059;Castanet;516;24;540
76;Occitanie;12;3;02;060;Castelmary;113;4;117
76;Occitanie;12;2;09;061;Castelnau-de-Mandailles;570;11;581
76;Occitanie;12;1;20;062;Castelnau-Pégayrols;348;2;350
76;Occitanie;12;1;04;063;La Cavalerie;2188;31;2219
76;Occitanie;12;2;10;064;Le Cayrol;274;6;280
76;Occitanie;12;3;05;065;Centrès;464;15;479
76;Occitanie;12;2;21;066;Clairvaux-d'Aveyron;1146;26;1172
76;Occitanie;12;1;04;067;Le Clapier;75;0;75
76;Occitanie;12;3;05;068;Colombiès;872;27;899
76;Occitanie;12;1;04;069;Combret;261;7;268
76;Occitanie;12;1;12;070;Compeyre;518;26;544
76;Occitanie;12;3;23;071;Compolibat;337;7;344
76;Occitanie;12;1;11;072;Comprégnac;228;7;235
76;Occitanie;12;1;13;073;Comps-la-Grand-Ville;628;19;647
76;Occitanie;12;2;01;074;Condom-d'Aubrac;292;14;306
76;Occitanie;12;1;13;075;Connac;104;2;106
76;Occitanie;12;2;07;076;Conques-en-Rouergue;1586;54;1640
76;Occitanie;12;1;04;077;Cornus;514;12;526
76;Occitanie;12;1;15;078;Les Costes-Gozon;180;4;184
76;Occitanie;12;2;10;079;Coubisou;488;19;507
76;Occitanie;12;1;04;080;Coupiac;363;9;372
76;Occitanie;12;1;04;082;La Couvertoirade;191;2;193
76;Occitanie;12;3;06;083;Cransac;1472;43;1515
76;Occitanie;12;1;11;084;Creissels;1558;55;1613
76;Occitanie;12;3;02;085;Crespin;315;0;315
76;Occitanie;12;1;20;086;La Cresse;323;16;339
76;Occitanie;12;2;01;088;Curières;223;4;227
76;Occitanie;12;3;07;089;Decazeville;5196;212;5408
76;Occitanie;12;2;21;090;Druelle Balsac;3196;93;3289
76;Occitanie;12;3;23;091;Drulhe;458;11;469
76;Occitanie;12;1;13;092;Durenque;523;10;533
76;Occitanie;12;2;10;093;Le Fel;181;4;185
76;Occitanie;12;2;10;094;Entraygues-sur-Truyère;981;18;999
76;Occitanie;12;3;06;095;Escandolières;242;6;248
76;Occitanie;12;2;10;096;Espalion;4643;155;4798
76;Occitanie;12;2;10;097;Espeyrac;250;3;253
76;Occitanie;12;2;10;098;Estaing;476;16;492
76;Occitanie;12;1;04;099;Fayet;238;4;242
76;Occitanie;12;3;06;100;Firmi;2363;64;2427
76;Occitanie;12;3;07;101;Flagnac;1081;32;1113
76;Occitanie;12;1;14;102;Flavin;2365;76;2441
76;Occitanie;12;2;01;103;Florentin-la-Capelle;283;8;291
76;Occitanie;12;3;08;104;Foissac;487;10;497
76;Occitanie;12;3;02;105;La Fouillade;1108;30;1138
76;Occitanie;12;2;03;106;Gabriac;549;11;560
76;Occitanie;12;2;09;107;Gaillac-d'Aveyron;318;5;323
76;Occitanie;12;3;08;108;Galgan;374;6;380
76;Occitanie;12;1;04;109;Gissac;98;2;100
76;Occitanie;12;2;10;110;Golinhac;340;12;352
76;Occitanie;12;3;06;111;Goutrens;488;18;506
76;Occitanie;12;3;05;113;Gramond;517;11;528
76;Occitanie;12;1;04;115;L'Hospitalet-du-Larzac;308;5;313
76;Occitanie;12;2;01;116;Huparlac;261;6;267
76;Occitanie;12;2;01;118;Lacroix-Barrez;525;9;534
76;Occitanie;12;2;01;119;Laguiole;1230;27;1257
76;Occitanie;12;2;09;120;Laissac-Sévérac l'Église;2153;103;2256
76;Occitanie;12;3;23;121;Lanuéjouls;726;16;742
76;Occitanie;12;1;04;122;Lapanouse-de-Cernon;124;8;132
76;Occitanie;12;2;09;124;Lassouts;315;9;324
76;Occitanie;12;1;04;125;Laval-Roquecezière;277;4;281
76;Occitanie;12;1;13;127;Lédergues;638;20;658
76;Occitanie;12;3;02;128;Lescure-Jaoul;219;7;226
76;Occitanie;12;1;15;129;Lestrade-et-Thouels;448;13;461
76;Occitanie;12;3;07;130;Livinhac-le-Haut;1123;30;1153
76;Occitanie;12;2;03;131;La Loubière;1518;43;1561
76;Occitanie;12;2;14;133;Luc-la-Primaube;5962;164;6126
76;Occitanie;12;3;08;134;Lugan;351;7;358
76;Occitanie;12;3;02;135;Lunac;439;7;446
76;Occitanie;12;3;23;136;Maleville;936;18;954
76;Occitanie;12;3;05;137;Manhac;841;11;852
76;Occitanie;12;2;21;138;Marcillac-Vallon;1724;54;1778
76;Occitanie;12;1;04;139;Marnhagues-et-Latour;138;1;139
76;Occitanie;12;3;23;140;Martiel;975;24;999
76;Occitanie;12;1;04;141;Martrin;219;8;227
76;Occitanie;12;3;06;142;Mayran;629;16;645
76;Occitanie;12;1;04;143;Mélagues;62;0;62
76;Occitanie;12;3;05;144;Meljac;122;2;124
76;Occitanie;12;1;98;145;Millau;21482;696;22178
76;Occitanie;12;2;17;146;Le Monastère;2306;79;2385
76;Occitanie;12;1;04;147;Montagnol;141;1;142
76;Occitanie;12;3;08;148;Montbazens;1417;41;1458
76;Occitanie;12;1;04;149;Montclar;150;5;155
76;Occitanie;12;3;02;150;Monteils;481;88;569
76;Occitanie;12;2;01;151;Montézic;218;9;227
76;Occitanie;12;1;04;152;Montfranc;128;2;130
76;Occitanie;12;1;20;153;Montjaux;426;7;433
76;Occitanie;12;1;04;154;Montlaur;633;10;643
76;Occitanie;12;1;04;155;Fondamente;334;9;343
76;Occitanie;12;2;01;156;Montpeyroux;528;10;538
76;Occitanie;12;2;03;157;Montrozier;1717;50;1767
76;Occitanie;12;3;23;158;Montsalès;326;8;334
76;Occitanie;12;3;02;159;Morlhon-le-Haut;556;25;581
76;Occitanie;12;1;20;160;Mostuéjouls;320;5;325
76;Occitanie;12;2;21;161;Mouret;549;13;562
76;Occitanie;12;3;05;162;Moyrazès;1076;28;1104
76;Occitanie;12;1;04;163;Murasson;211;4;215
76;Occitanie;12;2;01;164;Mur-de-Barrez;696;14;710
76;Occitanie;12;2;21;165;Muret-le-Château;362;15;377
76;Occitanie;12;2;01;166;Murols;113;1;114
76;Occitanie;12;3;02;167;Najac;701;22;723
76;Occitanie;12;1;12;168;Nant;992;18;1010
76;Occitanie;12;3;05;169;Naucelle;2023;149;2172
76;Occitanie;12;3;08;170;Naussac;373;8;381
76;Occitanie;12;2;21;171;Nauviale;588;17;605
76;Occitanie;12;2;10;172;Le Nayrac;528;12;540
76;Occitanie;12;2;14;174;Olemps;3471;102;3573
76;Occitanie;12;3;23;175;Ols-et-Rinhodes;189;2;191
76;Occitanie;12;2;18;176;Onet-le-Château;11797;574;12371
76;Occitanie;12;2;09;177;Palmas d'Aveyron;1028;15;1043
76;Occitanie;12;1;12;178;Paulhe;371;10;381
76;Occitanie;12;1;04;179;Peux-et-Couffouleux;85;2;87
76;Occitanie;12;1;20;180;Peyreleau;73;2;75
76;Occitanie;12;3;08;181;Peyrusse-le-Roc;210;6;216
76;Occitanie;12;2;09;182;Pierrefiche;284;5;289
76;Occitanie;12;1;04;183;Plaisance;219;3;222
76;Occitanie;12;2;09;184;Pomayrols;120;6;126
76;Occitanie;12;1;15;185;Pont-de-Salars;1632;72;1704
76;Occitanie;12;1;04;186;Pousthomy;212;2;214
76;Occitanie;12;2;09;187;Prades-d'Aubrac;348;4;352
76;Occitanie;12;1;15;188;Prades-Salars;319;10;329
76;Occitanie;12;3;05;189;Pradinas;354;6;360
76;Occitanie;12;3;02;190;Prévinquières;288;11;299
76;Occitanie;12;3;23;191;Privezac;324;10;334
76;Occitanie;12;1;04;192;Mounes-Prohencoux;186;4;190
76;Occitanie;12;2;21;193;Pruines;282;10;292
76;Occitanie;12;3;05;194;Quins;852;21;873
76;Occitanie;12;1;04;195;Rebourguil;270;3;273
76;Occitanie;12;1;13;197;Réquista;1978;78;2056
76;Occitanie;12;3;02;198;Rieupeyroux;1940;75;2015
76;Occitanie;12;3;06;199;Rignac;2006;141;2147
76;Occitanie;12;1;20;200;Rivière-sur-Tarn;1029;27;1056
76;Occitanie;12;2;03;201;Rodelle;1071;45;1116
76;Occitanie;12;2;99;202;Rodez;24397;1869;26266
76;Occitanie;12;1;19;203;Roquefort-sur-Soulzon;555;15;570
76;Occitanie;12;1;20;204;La Roque-Sainte-Marguerite;177;4;181
76;Occitanie;12;3;22;205;La Rouquette;770;16;786
76;Occitanie;12;3;08;206;Roussennac;631;18;649
76;Occitanie;12;1;13;207;Rullac-Saint-Cirq;346;14;360
76;Occitanie;12;1;19;208;Saint-Affrique;8018;633;8651
76;Occitanie;12;2;01;209;Saint-Amans-des-Cots;749;13;762
76;Occitanie;12;3;02;210;Saint-André-de-Najac;455;5;460
76;Occitanie;12;1;20;211;Saint-André-de-Vézines;133;1;134
76;Occitanie;12;1;04;212;Saint-Beaulize;87;7;94
76;Occitanie;12;1;20;213;Saint-Beauzély;624;16;640
76;Occitanie;12;2;01;214;Saint-Chély-d'Aubrac;518;13;531
76;Occitanie;12;2;21;215;Saint-Christophe-Vallon;1171;47;1218
76;Occitanie;12;2;09;216;Saint-Côme-d'Olt;1426;38;1464
76;Occitanie;12;3;23;217;Sainte-Croix;744;20;764
76;Occitanie;12;2;09;219;Sainte-Eulalie-d'Olt;377;8;385
76;Occitanie;12;1;04;220;Sainte-Eulalie-de-Cernon;299;0;299
76;Occitanie;12;2;07;221;Saint-Félix-de-Lunel;354;6;360
76;Occitanie;12;1;19;222;Saint-Félix-de-Sorgues;187;4;191
76;Occitanie;12;2;01;223;Argences en Aubrac;1602;39;1641
76;Occitanie;12;2;09;224;Saint Geniez d'Olt et d'Aubrac;2217;39;2256
76;Occitanie;12;1;11;225;Saint-Georges-de-Luzençon;1606;55;1661
76;Occitanie;12;2;10;226;Saint-Hippolyte;424;14;438
76;Occitanie;12;3;23;227;Saint-Igest;178;5;183
76;Occitanie;12;1;19;228;Saint-Izaire;308;7;315
76;Occitanie;12;1;19;229;Saint-Jean-d'Alcapiès;244;11;255
76;Occitanie;12;1;13;230;Saint-Jean-Delnous;393;16;409
76;Occitanie;12;1;12;231;Saint-Jean-du-Bruel;717;7;724
76;Occitanie;12;1;04;232;Saint-Jean-et-Saint-Paul;281;8;289
76;Occitanie;12;1;04;233;Saint-Juéry;294;3;297
76;Occitanie;12;3;13;234;Sainte-Juliette-sur-Viaur;624;8;632
76;Occitanie;12;3;05;235;Saint-Just-sur-Viaur;204;8;212
76;Occitanie;12;1;15;236;Saint-Laurent-de-Lévézou;153;5;158
76;Occitanie;12;2;20;237;Saint-Laurent-d'Olt;648;82;730
76;Occitanie;12;1;15;238;Saint-Léons;425;16;441
76;Occitanie;12;2;20;239;Saint-Martin-de-Lenne;324;13;337
76;Occitanie;12;3;07;240;Saint-Parthem;401;10;411
76;Occitanie;12;2;14;241;Sainte-Radegonde;1759;67;1826
76;Occitanie;12;3;23;242;Saint-Rémy;306;15;321
76;Occitanie;12;1;19;243;Saint-Rome-de-Cernon;957;13;970
76;Occitanie;12;1;15;244;Saint-Rome-de-Tarn;889;10;899
76;Occitanie;12;3;07;246;Saint-Santin;530;15;545
76;Occitanie;12;2;20;247;Saint-Saturnin-de-Lenne;297;3;300
76;Occitanie;12;1;04;248;Saint-Sernin-sur-Rance;607;103;710
76;Occitanie;12;1;04;249;Saint-Sever-du-Moustier;189;6;195
76;Occitanie;12;2;01;250;Saint-Symphorien-de-Thénières;210;6;216
76;Occitanie;12;1;15;251;Saint-Victor-et-Melvieu;322;7;329
76;Occitanie;12;3;08;252;Salles-Courbatiès;439;12;451
76;Occitanie;12;1;15;253;Salles-Curan;1005;30;1035
76;Occitanie;12;2;21;254;Salles-la-Source;2286;71;2357
76;Occitanie;12;1;13;255;Salmiech;762;26;788
76;Occitanie;12;3;23;256;Salvagnac-Cajarc;367;10;377
76;Occitanie;12;3;08;257;Causse-et-Diège;797;17;814
76;Occitanie;12;3;02;258;La Salvetat-Peyralès;989;15;1004
76;Occitanie;12;3;02;259;Sanvensa;643;18;661
76;Occitanie;12;1;04;260;Sauclières;169;2;171
76;Occitanie;12;3;23;261;Saujac;124;4;128
76;Occitanie;12;3;05;262;Sauveterre-de-Rouergue;713;14;727
76;Occitanie;12;3;23;263;Savignac;752;25;777
76;Occitanie;12;2;03;264;Sébazac-Concourès;3330;90;3420
76;Occitanie;12;2;10;265;Sébrazac;529;15;544
76;Occitanie;12;1;15;266;Ségur;547;5;552
76;Occitanie;12;1;13;267;La Selve;626;12;638
76;Occitanie;12;2;07;268;Sénergues;424;16;440
76;Occitanie;12;1;04;269;La Serre;126;3;129
76;Occitanie;12;2;20;270;Sévérac d'Aveyron;4079;119;4198
76;Occitanie;12;3;08;272;Sonnac;519;13;532
76;Occitanie;12;2;01;273;Soulages-Bonneval;298;8;306
76;Occitanie;12;1;04;274;Sylvanès;114;2;116
76;Occitanie;12;1;04;275;Tauriac-de-Camarès;35;1;36
76;Occitanie;12;3;05;276;Tauriac-de-Naucelle;359;12;371
76;Occitanie;12;2;01;277;Taussac;523;9;532
76;Occitanie;12;3;02;278;Tayrac;185;2;187
76;Occitanie;12;2;01;280;Thérondels;391;13;404
76;Occitanie;12;3;23;281;Toulonjac;745;23;768
76;Occitanie;12;1;19;282;Tournemire;424;7;431
76;Occitanie;12;1;15;283;Trémouilles;476;15;491
76;Occitanie;12;1;15;284;Le Truel;344;1;345
76;Occitanie;12;1;19;286;Vabres-l'Abbaye;1219;31;1250
76;Occitanie;12;3;22;287;Vailhourles;636;18;654
76;Occitanie;12;2;21;288;Valady;1595;38;1633
76;Occitanie;12;3;08;289;Valzergues;206;8;214
76;Occitanie;12;3;23;290;Vaureilles;490;10;500
76;Occitanie;12;1;20;291;Verrières;378;9;387
76;Occitanie;12;1;19;292;Versols-et-Lapeyre;416;14;430
76;Occitanie;12;1;20;293;Veyreau;136;1;137
76;Occitanie;12;1;15;294;Vézins-de-Lévézou;649;18;667
76;Occitanie;12;1;04;295;Viala-du-Pas-de-Jaux;97;2;99
76;Occitanie;12;1;20;296;Viala-du-Tarn;528;13;541
76;Occitanie;12;1;15;297;Le Vibal;510;19;529
76;Occitanie;12;2;10;298;Villecomtal;417;8;425
76;Occitanie;12;1;15;299;Villefranche-de-Panat;684;26;710
76;Occitanie;12;3;22;300;Villefranche-de-Rouergue;11681;514;12195
76;Occitanie;12;3;23;301;Villeneuve;1976;46;2022
76;Occitanie;12;2;09;303;Vimenet;251;5;256
76;Occitanie;12;3;07;305;Viviez;1227;21;1248
76;Occitanie;12;1;15;307;Curan;293;15;308
93;Provence-Alpes-Côte d'Azur;13;1;97;001;Aix-en-Provence;147122;3236;150358
93;Provence-Alpes-Côte d'Azur;13;3;03;002;Allauch;21546;223;21769
93;Provence-Alpes-Côte d'Azur;13;1;25;003;Alleins;2695;67;2762
93;Provence-Alpes-Côte d'Azur;13;2;04;004;Arles;50968;723;51691
93;Provence-Alpes-Côte d'Azur;13;3;05;005;Aubagne;47190;450;47640
93;Provence-Alpes-Côte d'Azur;13;2;26;006;Aureille;1545;30;1575
93;Provence-Alpes-Côte d'Azur;13;3;03;007;Auriol;12667;167;12834
93;Provence-Alpes-Côte d'Azur;13;1;25;008;Aurons;565;16;581
93;Provence-Alpes-Côte d'Azur;13;1;25;009;La Barben;845;34;879
93;Provence-Alpes-Côte d'Azur;13;2;07;010;Barbentane;4228;139;4367
93;Provence-Alpes-Côte d'Azur;13;2;26;011;Les Baux-de-Provence;315;4;319
93;Provence-Alpes-Côte d'Azur;13;1;28;012;Beaurecueil;600;57;657
93;Provence-Alpes-Côte d'Azur;13;3;03;013;Belcodène;1917;37;1954
93;Provence-Alpes-Côte d'Azur;13;4;06;014;Berre-l'Étang;13834;69;13903
93;Provence-Alpes-Côte d'Azur;13;1;29;015;Bouc-Bel-Air;14984;273;15257
93;Provence-Alpes-Côte d'Azur;13;3;03;016;La Bouilladisse;6316;82;6398
93;Provence-Alpes-Côte d'Azur;13;2;07;017;Boulbon;1516;18;1534
93;Provence-Alpes-Côte d'Azur;13;2;07;018;Cabannes;4471;59;4530
93;Provence-Alpes-Côte d'Azur;13;1;29;019;Cabriès;10006;326;10332
93;Provence-Alpes-Côte d'Azur;13;3;03;020;Cadolive;2179;44;2223
93;Provence-Alpes-Côte d'Azur;13;4;11;021;Carry-le-Rouet;5705;126;5831
93;Provence-Alpes-Côte d'Azur;13;3;08;022;Cassis;6782;107;6889
93;Provence-Alpes-Côte d'Azur;13;3;08;023;Ceyreste;4801;111;4912
93;Provence-Alpes-Côte d'Azur;13;1;25;024;Charleval;2655;36;2691
93;Provence-Alpes-Côte d'Azur;13;1;28;025;Châteauneuf-le-Rouge;2358;75;2433
93;Provence-Alpes-Côte d'Azur;13;4;11;026;Châteauneuf-les-Martigues;17809;74;17883
93;Provence-Alpes-Côte d'Azur;13;2;07;027;Châteaurenard;16201;253;16454
93;Provence-Alpes-Côte d'Azur;13;3;08;028;La Ciotat;36441;371;36812
93;Provence-Alpes-Côte d'Azur;13;4;06;029;Cornillon-Confoux;1494;24;1518
93;Provence-Alpes-Côte d'Azur;13;3;08;030;Cuges-les-Pins;5380;54;5434
93;Provence-Alpes-Côte d'Azur;13;3;03;031;La Destrousse;3803;45;3848
93;Provence-Alpes-Côte d'Azur;13;1;25;032;Éguilles;8076;146;8222
93;Provence-Alpes-Côte d'Azur;13;4;11;033;Ensuès-la-Redonne;5739;97;5836
93;Provence-Alpes-Côte d'Azur;13;2;26;034;Eygalières;1730;30;1760
93;Provence-Alpes-Côte d'Azur;13;1;26;035;Eyguières;6854;160;7014
93;Provence-Alpes-Côte d'Azur;13;2;07;036;Eyragues;4421;129;4550
93;Provence-Alpes-Côte d'Azur;13;1;06;037;La Fare-les-Oliviers;8800;106;8906
93;Provence-Alpes-Côte d'Azur;13;2;26;038;Fontvieille;3531;68;3599
93;Provence-Alpes-Côte d'Azur;13;4;10;039;Fos-sur-Mer;15512;173;15685
93;Provence-Alpes-Côte d'Azur;13;1;28;040;Fuveau;10164;187;10351
93;Provence-Alpes-Côte d'Azur;13;1;09;041;Gardanne;21501;349;21850
93;Provence-Alpes-Côte d'Azur;13;3;08;042;Gémenos;6698;129;6827
93;Provence-Alpes-Côte d'Azur;13;4;11;043;Gignac-la-Nerthe;9899;91;9990
93;Provence-Alpes-Côte d'Azur;13;4;27;044;Grans;5201;85;5286
93;Provence-Alpes-Côte d'Azur;13;2;07;045;Graveson;4854;75;4929
93;Provence-Alpes-Côte d'Azur;13;1;03;046;Gréasque;4281;80;4361
93;Provence-Alpes-Côte d'Azur;13;4;10;047;Istres;44438;681;45119
93;Provence-Alpes-Côte d'Azur;13;1;28;048;Jouques;4436;101;4537
93;Provence-Alpes-Côte d'Azur;13;1;26;049;Lamanon;2044;41;2085
93;Provence-Alpes-Côte d'Azur;13;1;25;050;Lambesc;10018;255;10273
93;Provence-Alpes-Côte d'Azur;13;1;06;051;Lançon-Provence;9052;123;9175
93;Provence-Alpes-Côte d'Azur;13;2;07;052;Maillane;2705;33;2738
93;Provence-Alpes-Côte d'Azur;13;1;25;053;Mallemort;6184;162;6346
93;Provence-Alpes-Côte d'Azur;13;4;11;054;Marignane;32515;220;32735
93;Provence-Alpes-Côte d'Azur;13;4;24;056;Martigues;48506;531;49037
93;Provence-Alpes-Côte d'Azur;13;2;26;057;Mas-Blanc-des-Alpilles;516;10;526
93;Provence-Alpes-Côte d'Azur;13;2;26;058;Maussane-les-Alpilles;2396;49;2445
93;Provence-Alpes-Côte d'Azur;13;1;28;059;Meyrargues;3843;63;3906
93;Provence-Alpes-Côte d'Azur;13;1;28;060;Meyreuil;5786;88;5874
93;Provence-Alpes-Côte d'Azur;13;2;07;061;Saint-Pierre-de-Mézoargues;219;4;223
93;Provence-Alpes-Côte d'Azur;13;1;09;062;Mimet;4158;74;4232
93;Provence-Alpes-Côte d'Azur;13;4;27;063;Miramas;26433;374;26807
93;Provence-Alpes-Côte d'Azur;13;2;07;064;Mollégès;2662;29;2691
93;Provence-Alpes-Côte d'Azur;13;2;26;065;Mouriès;3400;47;3447
93;Provence-Alpes-Côte d'Azur;13;2;07;066;Noves;5827;66;5893
93;Provence-Alpes-Côte d'Azur;13;2;26;067;Orgon;2752;34;2786
93;Provence-Alpes-Côte d'Azur;13;2;26;068;Paradou;2145;38;2183
93;Provence-Alpes-Côte d'Azur;13;1;25;069;Pélissanne;10561;266;10827
93;Provence-Alpes-Côte d'Azur;13;3;05;070;La Penne-sur-Huveaune;6521;53;6574
93;Provence-Alpes-Côte d'Azur;13;1;09;071;Les Pennes-Mirabeau;21897;277;22174
93;Provence-Alpes-Côte d'Azur;13;1;28;072;Peynier;3567;74;3641
93;Provence-Alpes-Côte d'Azur;13;3;03;073;Peypin;5604;77;5681
93;Provence-Alpes-Côte d'Azur;13;1;28;074;Peyrolles-en-Provence;5129;88;5217
93;Provence-Alpes-Côte d'Azur;13;3;03;075;Plan-de-Cuques;11522;90;11612
93;Provence-Alpes-Côte d'Azur;13;2;07;076;Plan-d'Orgon;3562;49;3611
93;Provence-Alpes-Côte d'Azur;13;4;24;077;Port-de-Bouc;16290;132;16422
93;Provence-Alpes-Côte d'Azur;13;4;04;078;Port-Saint-Louis-du-Rhône;8370;77;8447
93;Provence-Alpes-Côte d'Azur;13;1;28;079;Puyloubier;1785;119;1904
93;Provence-Alpes-Côte d'Azur;13;1;28;080;Le Puy-Sainte-Réparade;5866;114;5980
93;Provence-Alpes-Côte d'Azur;13;4;06;081;Rognac;12136;103;12239
93;Provence-Alpes-Côte d'Azur;13;1;25;082;Rognes;4616;124;4740
93;Provence-Alpes-Côte d'Azur;13;2;07;083;Rognonas;4036;58;4094
93;Provence-Alpes-Côte d'Azur;13;1;25;084;La Roque-d'Anthéron;5411;123;5534
93;Provence-Alpes-Côte d'Azur;13;3;08;085;Roquefort-la-Bédoule;5937;67;6004
93;Provence-Alpes-Côte d'Azur;13;3;05;086;Roquevaire;8569;122;8691
93;Provence-Alpes-Côte d'Azur;13;1;28;087;Rousset;4977;140;5117
93;Provence-Alpes-Côte d'Azur;13;4;11;088;Le Rove;5193;47;5240
93;Provence-Alpes-Côte d'Azur;13;2;07;089;Saint-Andiol;3396;55;3451
93;Provence-Alpes-Côte d'Azur;13;1;28;090;Saint-Antonin-sur-Bayon;125;4;129
93;Provence-Alpes-Côte d'Azur;13;1;25;091;Saint-Cannat;5648;113;5761
93;Provence-Alpes-Côte d'Azur;13;4;06;092;Saint-Chamas;8617;135;8752
93;Provence-Alpes-Côte d'Azur;13;1;25;093;Saint-Estève-Janson;379;8;387
93;Provence-Alpes-Côte d'Azur;13;2;26;094;Saint-Étienne-du-Grès;2492;43;2535
93;Provence-Alpes-Côte d'Azur;13;1;28;095;Saint-Marc-Jaumegarde;1229;68;1297
93;Provence-Alpes-Côte d'Azur;13;2;04;096;Saintes-Maries-de-la-Mer;2123;22;2145
93;Provence-Alpes-Côte d'Azur;13;2;27;097;Saint-Martin-de-Crau;13364;297;13661
93;Provence-Alpes-Côte d'Azur;13;4;10;098;Saint-Mitre-les-Remparts;5818;111;5929
93;Provence-Alpes-Côte d'Azur;13;1;28;099;Saint-Paul-lès-Durance;891;13;904
93;Provence-Alpes-Côte d'Azur;13;2;26;100;Saint-Rémy-de-Provence;9692;196;9888
93;Provence-Alpes-Côte d'Azur;13;3;03;101;Saint-Savournin;3481;59;3540
93;Provence-Alpes-Côte d'Azur;13;4;29;102;Saint-Victoret;6609;51;6660
93;Provence-Alpes-Côte d'Azur;13;1;99;103;Salon-de-Provence;45009;586;45595
93;Provence-Alpes-Côte d'Azur;13;4;11;104;Sausset-les-Pins;7570;118;7688
93;Provence-Alpes-Côte d'Azur;13;1;26;105;Sénas;6878;88;6966
93;Provence-Alpes-Côte d'Azur;13;3;09;106;Septèmes-les-Vallons;11366;68;11434
93;Provence-Alpes-Côte d'Azur;13;1;09;107;Simiane-Collongue;5917;125;6042
93;Provence-Alpes-Côte d'Azur;13;2;07;108;Tarascon;15508;131;15639
93;Provence-Alpes-Côte d'Azur;13;1;28;109;Le Tholonet;2355;60;2415
93;Provence-Alpes-Côte d'Azur;13;1;28;110;Trets;10507;173;10680
93;Provence-Alpes-Côte d'Azur;13;1;28;111;Vauvenargues;1024;21;1045
93;Provence-Alpes-Côte d'Azur;13;1;06;112;Velaux;8579;150;8729
93;Provence-Alpes-Côte d'Azur;13;1;28;113;Venelles;8432;165;8597
93;Provence-Alpes-Côte d'Azur;13;1;06;114;Ventabren;5381;138;5519
93;Provence-Alpes-Côte d'Azur;13;1;25;115;Vernègues;2062;43;2105
93;Provence-Alpes-Côte d'Azur;13;2;07;116;Verquières;805;15;820
93;Provence-Alpes-Côte d'Azur;13;4;29;117;Vitrolles;34418;396;34814
93;Provence-Alpes-Côte d'Azur;13;1;06;118;Coudoux;3668;51;3719
93;Provence-Alpes-Côte d'Azur;13;3;08;119;Carnoux-en-Provence;6623;83;6706
93;Provence-Alpes-Côte d'Azur;13;3;12;201;Marseille 1er Arrondissement;39265;182;39447
93;Provence-Alpes-Côte d'Azur;13;3;13;202;Marseille 2e Arrondissement;23898;69;23967
93;Provence-Alpes-Côte d'Azur;13;3;98;203;Marseille 3e Arrondissement;52277;159;52436
93;Provence-Alpes-Côte d'Azur;13;3;98;204;Marseille 4e Arrondissement;49636;325;49961
93;Provence-Alpes-Côte d'Azur;13;3;98;205;Marseille 5e Arrondissement;45098;276;45374
93;Provence-Alpes-Côte d'Azur;13;3;98;206;Marseille 6e Arrondissement;40734;386;41120
93;Provence-Alpes-Côte d'Azur;13;3;23;207;Marseille 7e Arrondissement;34596;303;34899
93;Provence-Alpes-Côte d'Azur;13;3;98;208;Marseille 8e Arrondissement;82155;1268;83423
93;Provence-Alpes-Côte d'Azur;13;3;98;209;Marseille 9e Arrondissement;76053;644;76697
93;Provence-Alpes-Côte d'Azur;13;3;98;210;Marseille 10e Arrondissement;59131;343;59474
93;Provence-Alpes-Côte d'Azur;13;3;98;211;Marseille 11e Arrondissement;57519;460;57979
93;Provence-Alpes-Côte d'Azur;13;3;98;212;Marseille 12e Arrondissement;61931;530;62461
93;Provence-Alpes-Côte d'Azur;13;3;98;213;Marseille 13e Arrondissement;91959;705;92664
93;Provence-Alpes-Côte d'Azur;13;3;98;214;Marseille 14e Arrondissement;60968;254;61222
93;Provence-Alpes-Côte d'Azur;13;3;98;215;Marseille 15e Arrondissement;79092;271;79363
93;Provence-Alpes-Côte d'Azur;13;3;14;216;Marseille 16e Arrondissement;16009;106;16115
28;Normandie;14;3;15;001;Ablon;1194;43;1237
28;Normandie;14;1;02;003;Agy;310;7;317
28;Normandie;14;2;24;005;Valambray;1700;39;1739
28;Normandie;14;2;12;006;Amayé-sur-Orne;1067;21;1088
28;Normandie;14;4;01;007;Amayé-sur-Seulles;224;4;228
28;Normandie;14;3;04;009;Amfreville;1378;19;1397
28;Normandie;14;4;01;011;Aurseulles;1899;22;1921
28;Normandie;14;3;04;012;Angerville;195;1;196
28;Normandie;14;2;11;014;Colomby-Anguerny;1256;20;1276
28;Normandie;14;2;11;015;Anisy;742;22;764
28;Normandie;14;3;04;016;Annebault;490;13;503
28;Normandie;14;1;02;019;Arganchy;216;3;219
28;Normandie;14;2;24;020;Argences;3798;31;3829
28;Normandie;14;1;11;021;Arromanches-les-Bains;465;11;476
28;Normandie;14;1;11;022;Asnelles;603;9;612
28;Normandie;14;1;23;023;Asnières-en-Bessin;69;1;70
28;Normandie;14;3;04;024;Auberville;591;12;603
28;Normandie;14;2;13;025;Aubigny;315;3;318
28;Normandie;14;1;03;026;Audrieu;1125;20;1145
28;Normandie;14;4;89;027;Les Monts d'Aunay;4595;64;4659
28;Normandie;14;2;06;030;Authie;1666;48;1714
28;Normandie;14;3;21;032;Les Authieux-sur-Calonne;275;11;286
28;Normandie;14;3;19;033;Auvillars;212;2;214
28;Normandie;14;2;12;034;Avenay;572;2;574
28;Normandie;14;1;23;035;Balleroy-sur-Drôme;1346;75;1421
28;Normandie;14;2;24;036;Banneville-la-Campagne;171;1;172
28;Normandie;14;4;01;037;Malherbe-sur-Ajon;567;11;578
28;Normandie;14;1;11;038;Banville;792;11;803
28;Normandie;14;2;22;039;Barbery;802;18;820
28;Normandie;14;1;02;040;Barbeville;210;3;213
28;Normandie;14;3;15;041;Barneville-la-Bertran;123;5;128
28;Normandie;14;2;12;042;Baron-sur-Odon;1005;21;1026
28;Normandie;14;2;13;043;Barou-en-Auge;69;0;69
28;Normandie;14;2;11;044;Basly;1065;17;1082
28;Normandie;14;3;04;045;Basseneville;249;2;251
28;Normandie;14;3;04;046;Bavent;1932;14;1946
28;Normandie;14;1;02;047;Bayeux;12640;326;12966
28;Normandie;14;1;11;049;Bazenville;141;6;147
28;Normandie;14;1;23;050;La Bazoque;185;2;187
28;Normandie;14;2;13;053;Beaumais;167;3;170
28;Normandie;14;4;25;054;Beaumesnil;202;4;206
28;Normandie;14;3;21;055;Beaumont-en-Auge;409;8;417
28;Normandie;14;2;24;057;Bellengreville;1470;9;1479
28;Normandie;14;3;21;059;Benerville-sur-Mer;420;32;452
28;Normandie;14;2;20;060;Bénouville;2039;26;2065
28;Normandie;14;4;10;061;Souleuvre en Bocage;8848;147;8995
28;Normandie;14;1;03;062;Bény-sur-Mer;444;6;450
28;Normandie;14;1;23;063;Bernesq;213;5;218
28;Normandie;14;2;13;064;Bernières-d'Ailly;221;7;228
28;Normandie;14;2;11;066;Bernières-sur-Mer;2330;34;2364
28;Normandie;14;2;20;068;Biéville-Beuville;3646;87;3733
28;Normandie;14;3;17;069;Beuvillers;1331;26;1357
28;Normandie;14;3;19;070;Beuvron-en-Auge;197;2;199
28;Normandie;14;2;20;076;Blainville-sur-Orne;5761;75;5836
28;Normandie;14;3;21;077;Blangy-le-Château;728;56;784
28;Normandie;14;1;23;078;Blay;364;4;368
28;Normandie;14;3;21;079;Blonville-sur-Mer;1552;35;1587
28;Normandie;14;2;22;080;Le Bô;125;4;129
28;Normandie;14;3;19;082;La Boissière;189;8;197
28;Normandie;14;3;19;083;Bonnebosq;666;15;681
28;Normandie;14;4;01;084;Bonnemaison;398;8;406
28;Normandie;14;3;21;085;Bonneville-la-Louvet;814;19;833
28;Normandie;14;3;21;086;Bonneville-sur-Touques;321;12;333
28;Normandie;14;2;13;087;Bonnœil;122;1;123
28;Normandie;14;2;13;088;Bons-Tassilly;401;9;410
28;Normandie;14;2;12;089;Bougy;390;9;399
28;Normandie;14;2;22;090;Boulon;778;7;785
28;Normandie;14;3;04;091;Bourgeauville;100;0;100
28;Normandie;14;2;12;092;Bourguébus;2304;26;2330
28;Normandie;14;3;04;093;Branville;198;5;203
28;Normandie;14;4;01;096;Brémoy;236;5;241
28;Normandie;14;2;22;097;Bretteville-le-Rabet;303;3;306
28;Normandie;14;2;03;098;Thue et Mue;6150;62;6212
28;Normandie;14;2;22;100;Bretteville-sur-Laize;1912;25;1937
28;Normandie;14;2;05;101;Bretteville-sur-Odon;4069;71;4140
28;Normandie;14;3;21;102;Le Breuil-en-Auge;994;22;1016
28;Normandie;14;1;23;103;Le Breuil-en-Bessin;415;7;422
28;Normandie;14;3;21;104;Le Brévedent;178;5;183
28;Normandie;14;3;04;106;Bréville-les-Monts;659;6;665
28;Normandie;14;1;23;107;Bricqueville;155;0;155
28;Normandie;14;3;04;110;Brucourt;126;1;127
28;Normandie;14;1;03;111;Bucéels;437;5;442
28;Normandie;14;2;22;116;Le Bû-sur-Rouvres;113;5;118
28;Normandie;14;3;04;117;Cabourg;3511;30;3541
28;Normandie;14;2;99;118;Caen;107250;2151;109401
28;Normandie;14;2;24;119;Cagny;2003;14;2017
28;Normandie;14;4;01;120;Cahagnes;1400;21;1421
28;Normandie;14;1;23;121;Cahagnolles;256;1;257
28;Normandie;14;2;12;122;La Caine;158;1;159
28;Normandie;14;2;03;123;Cairon;2029;50;2079
28;Normandie;14;1;23;124;La Cambe;548;9;557
28;Normandie;14;2;20;125;Cambes-en-Plaine;1717;49;1766
28;Normandie;14;3;19;126;Cambremer;1322;36;1358
28;Normandie;14;4;25;127;Campagnolles;555;5;560
28;Normandie;14;1;02;130;Campigny;186;4;190
28;Normandie;14;3;21;131;Canapville;226;4;230
28;Normandie;14;1;23;132;Canchy;205;0;205
28;Normandie;14;2;24;134;Canteloup;190;4;194
28;Normandie;14;1;03;135;Carcagny;281;2;283
28;Normandie;14;1;23;136;Cardonville;96;0;96
28;Normandie;14;2;06;137;Carpiquet;3137;28;3165
28;Normandie;14;1;23;138;Cartigny-l'Épinay;295;5;300
28;Normandie;14;1;23;140;Castillon;352;6;358
28;Normandie;14;3;19;141;Castillon-en-Auge;160;2;162
28;Normandie;14;4;01;143;Caumont-sur-Aure;2394;26;2420
28;Normandie;14;2;22;145;Cauvicourt;550;4;554
28;Normandie;14;2;22;146;Cauville;169;4;173
28;Normandie;14;3;18;147;Cernay;139;1;140
28;Normandie;14;2;24;149;Cesny-aux-Vignes;416;13;429
28;Normandie;14;2;22;150;Cesny-les-Sources;1365;19;1384
28;Normandie;14;1;02;159;Chouain;229;12;241
28;Normandie;14;2;22;160;Cintheaux;187;6;193
28;Normandie;14;3;21;161;Clarbec;331;14;345
28;Normandie;14;2;22;162;Clécy;1305;14;1319
28;Normandie;14;2;24;163;Cléville;387;3;390
28;Normandie;14;1;23;165;Colleville-sur-Mer;184;1;185
28;Normandie;14;2;20;166;Colleville-Montgomery;2546;42;2588
28;Normandie;14;2;14;167;Colombelles;7029;35;7064
28;Normandie;14;1;23;168;Colombières;205;5;210
28;Normandie;14;1;03;169;Colombiers-sur-Seulles;157;0;157
28;Normandie;14;2;22;171;Combray;144;1;145
28;Normandie;14;1;02;172;Commes;445;8;453
28;Normandie;14;2;19;173;Condé-sur-Ifs;434;14;448
28;Normandie;14;4;10;174;Condé-en-Normandie;6296;309;6605
28;Normandie;14;1;02;175;Condé-sur-Seulles;298;5;303
28;Normandie;14;3;21;177;Coquainvilliers;844;16;860
28;Normandie;14;3;17;179;Cordebugle;164;4;168
28;Normandie;14;2;13;180;Cordey;155;3;158
28;Normandie;14;2;16;181;Cormelles-le-Royal;5093;43;5136
28;Normandie;14;1;23;182;Cormolain;397;5;402
28;Normandie;14;2;22;183;Cossesseville;107;0;107
28;Normandie;14;1;02;184;Cottun;230;6;236
28;Normandie;14;2;13;190;Courcy;127;4;131
28;Normandie;14;2;11;191;Courseulles-sur-Mer;4185;52;4237
28;Normandie;14;3;17;193;Courtonne-la-Meurdrac;665;19;684
28;Normandie;14;3;17;194;Courtonne-les-Deux-Églises;642;20;662
28;Normandie;14;4;01;195;Courvaudon;270;1;271
28;Normandie;14;1;11;196;Crépon;212;8;220
28;Normandie;14;2;11;197;Cresserons;1099;27;1126
28;Normandie;14;3;04;198;Cresseveuille;252;9;261
28;Normandie;14;1;03;200;Creully sur Seulles;2260;62;2322
28;Normandie;14;3;15;202;Cricquebœuf;267;5;272
28;Normandie;14;3;04;203;Cricqueville-en-Auge;189;2;191
28;Normandie;14;1;23;204;Cricqueville-en-Bessin;172;2;174
28;Normandie;14;1;03;205;Cristot;218;6;224
28;Normandie;14;2;13;206;Crocy;291;0;291
28;Normandie;14;2;22;207;Croisilles;648;9;657
28;Normandie;14;1;23;209;Crouay;505;10;515
28;Normandie;14;2;22;211;Culey-le-Patry;366;1;367
28;Normandie;14;1;02;214;Cussy;183;1;184
28;Normandie;14;2;24;215;Cuverville;2284;32;2316
28;Normandie;14;2;13;216;Damblainville;239;3;242
28;Normandie;14;3;04;218;Danestal;404;5;409
28;Normandie;14;3;15;220;Deauville;3567;48;3615
28;Normandie;14;2;24;221;Démouville;3063;41;3104
28;Normandie;14;2;13;223;Le Détroit;88;2;90
28;Normandie;14;1;23;224;Deux-Jumeaux;47;2;49
28;Normandie;14;3;04;225;Dives-sur-Mer;5234;169;5403
28;Normandie;14;2;22;226;Donnay;302;2;304
28;Normandie;14;3;04;227;Douville-en-Auge;214;1;215
28;Normandie;14;2;11;228;Douvres-la-Délivrande;5076;202;5278
28;Normandie;14;3;04;229;Dozulé;2314;21;2335
28;Normandie;14;3;19;230;Drubec;114;0;114
28;Normandie;14;3;19;231;Beaufour-Druval;439;12;451
28;Normandie;14;1;03;232;Ducy-Sainte-Marguerite;172;3;175
28;Normandie;14;1;02;236;Ellon;608;7;615
28;Normandie;14;2;24;237;Émiéville;633;7;640
28;Normandie;14;3;21;238;Englesqueville-en-Auge;112;2;114
28;Normandie;14;1;23;239;Englesqueville-la-Percée;103;0;103
28;Normandie;14;2;13;240;Épaney;508;12;520
28;Normandie;14;4;01;241;Épinay-sur-Odon;624;14;638
28;Normandie;14;2;07;242;Épron;1655;24;1679
28;Normandie;14;3;15;243;Équemauville;1580;25;1605
28;Normandie;14;2;13;244;Eraines;294;10;304
28;Normandie;14;2;13;245;Ernes;319;10;329
28;Normandie;14;3;24;246;Escoville;809;6;815
28;Normandie;14;2;22;248;Espins;250;5;255
28;Normandie;14;2;12;249;Esquay-Notre-Dame;1436;22;1458
28;Normandie;14;1;02;250;Esquay-sur-Seulles;279;6;285
28;Normandie;14;2;22;251;Esson;550;6;556
28;Normandie;14;2;22;252;Estrées-la-Campagne;265;3;268
28;Normandie;14;2;09;254;Éterville;1644;26;1670
28;Normandie;14;1;23;256;Étréham;330;5;335
28;Normandie;14;2;12;257;Évrecy;2020;26;2046
28;Normandie;14;2;13;258;Falaise;7849;234;8083
28;Normandie;14;3;21;260;Fauguernon;241;7;248
28;Normandie;14;3;21;261;Le Faulq;335;7;342
28;Normandie;14;2;12;266;Feuguerolles-Bully;1443;21;1464
28;Normandie;14;3;21;269;Fierville-les-Parcs;228;4;232
28;Normandie;14;3;21;270;Firfol;387;9;396
28;Normandie;14;2;09;271;Fleury-sur-Orne;4981;70;5051
28;Normandie;14;1;23;272;La Folie;99;2;101
28;Normandie;14;3;18;273;La Folletière-Abenon;140;1;141
28;Normandie;14;2;12;274;Fontaine-Étoupefour;2682;65;2747
28;Normandie;14;1;03;275;Fontaine-Henry;494;6;500
28;Normandie;14;2;13;276;Fontaine-le-Pin;355;3;358
28;Normandie;14;2;12;277;Fontenay-le-Marmion;1946;14;1960
28;Normandie;14;1;03;278;Fontenay-le-Pesnel;1197;18;1215
28;Normandie;14;3;19;280;Formentin;259;8;267
28;Normandie;14;1;23;281;Formigny La Bataille;744;10;754
28;Normandie;14;1;23;282;Foulognes;213;6;219
28;Normandie;14;2;13;283;Fourches;220;7;227
28;Normandie;14;2;13;284;Fourneaux-le-Val;155;3;158
28;Normandie;14;3;19;285;Le Fournet;76;2;78
28;Normandie;14;3;15;286;Fourneville;477;20;497
28;Normandie;14;2;24;287;Frénouville;1981;15;1996
28;Normandie;14;2;03;288;Le Fresne-Camilly;949;25;974
28;Normandie;14;2;13;289;Fresné-la-Mère;580;13;593
28;Normandie;14;2;22;290;Fresney-le-Puceux;804;9;813
28;Normandie;14;2;22;291;Fresney-le-Vieux;297;4;301
28;Normandie;14;3;21;293;Fumichon;272;2;274
28;Normandie;14;2;12;297;Gavrus;597;7;604
28;Normandie;14;1;23;298;Géfosse-Fontenay;132;3;135
28;Normandie;14;3;15;299;Genneville;844;17;861
28;Normandie;14;3;19;300;Gerrots;51;0;51
28;Normandie;14;2;16;301;Giberville;4881;48;4929
28;Normandie;14;3;21;302;Glanville;164;5;169
28;Normandie;14;3;17;303;Glos;926;21;947
28;Normandie;14;3;15;304;Gonneville-sur-Honfleur;873;23;896
28;Normandie;14;3;04;305;Gonneville-sur-Mer;670;6;676
28;Normandie;14;3;04;306;Gonneville-en-Auge;389;5;394
28;Normandie;14;3;04;308;Goustranville;301;0;301
28;Normandie;14;2;22;309;Gouvix;834;4;838
28;Normandie;14;2;22;310;Grainville-Langannerie;733;8;741
28;Normandie;14;2;12;311;Grainville-sur-Odon;1049;9;1058
28;Normandie;14;1;23;312;Grandcamp-Maisy;1533;22;1555
28;Normandie;14;3;04;316;Grangues;276;3;279
28;Normandie;14;1;11;318;Graye-sur-Mer;731;7;738
28;Normandie;14;2;12;319;Grentheville;964;8;972
28;Normandie;14;2;22;320;Grimbosq;282;7;289
28;Normandie;14;1;02;322;Guéron;246;5;251
28;Normandie;14;2;20;325;Hermanville-sur-Mer;3144;43;3187
28;Normandie;14;3;21;326;Hermival-les-Vaux;825;18;843
28;Normandie;14;2;14;327;Hérouville-Saint-Clair;22150;238;22388
28;Normandie;14;3;04;328;Hérouvillette;1349;7;1356
28;Normandie;14;3;04;329;Heuland;115;4;119
28;Normandie;14;2;13;332;La Hoguette;664;11;675
28;Normandie;14;3;15;333;Honfleur;6742;191;6933
28;Normandie;14;3;17;334;L'Hôtellerie;318;6;324
28;Normandie;14;3;19;335;Hotot-en-Auge;298;3;301
28;Normandie;14;1;01;336;Hottot-les-Bagues;473;5;478
28;Normandie;14;3;19;337;La Houblonnière;329;10;339
28;Normandie;14;3;04;338;Houlgate;1689;39;1728
28;Normandie;14;2;16;341;Ifs;11902;221;12123
28;Normandie;14;1;23;342;Isigny-sur-Mer;3590;40;3630
28;Normandie;14;2;13;343;Les Isles-Bardel;67;0;67
28;Normandie;14;2;24;344;Janville;386;9;395
28;Normandie;14;2;13;345;Jort;301;2;303
28;Normandie;14;1;02;346;Juaye-Mondaye;685;10;695
28;Normandie;14;4;01;347;Dialan sur Chaîne;1027;12;1039
28;Normandie;14;1;03;348;Juvigny-sur-Seulles;82;1;83
28;Normandie;14;2;12;349;Laize-Clinchamps;2130;31;2161
28;Normandie;14;4;25;352;Landelles-et-Coupigny;839;17;856
28;Normandie;14;4;01;353;Landes-sur-Ajon;451;5;456
28;Normandie;14;2;11;354;Langrune-sur-Mer;1948;47;1995
28;Normandie;14;1;03;355;Ponts sur Seulles;1217;21;1238
28;Normandie;14;4;10;357;Terres de Druance;903;19;922
28;Normandie;14;3;19;358;Léaupartie;88;1;89
28;Normandie;14;2;13;360;Leffard;219;2;221
28;Normandie;14;3;19;362;Lessard-et-le-Chêne;159;0;159
28;Normandie;14;1;01;364;Lingèvres;466;13;479
28;Normandie;14;2;20;365;Lion-sur-Mer;2499;40;2539
28;Normandie;14;3;17;366;Lisieux;19755;611;20366
28;Normandie;14;1;23;367;Lison;434;5;439
28;Normandie;14;3;18;368;Lisores;263;11;274
28;Normandie;14;1;23;369;Litteau;286;3;289
28;Normandie;14;1;23;370;Le Molay-Littry;3030;39;3069
28;Normandie;14;3;18;371;Livarot-Pays-d'Auge;6183;111;6294
28;Normandie;14;4;01;374;Les Loges;144;2;146
28;Normandie;14;2;13;375;Les Loges-Saulces;170;3;173
28;Normandie;14;1;02;377;Longues-sur-Mer;585;9;594
28;Normandie;14;1;23;378;Longueville;270;8;278
28;Normandie;14;4;01;379;Longvillers;361;4;365
28;Normandie;14;1;03;380;Loucelles;186;5;191
28;Normandie;14;2;13;381;Louvagny;60;1;61
28;Normandie;14;2;09;383;Louvigny;2666;37;2703
28;Normandie;14;2;11;384;Luc-sur-Mer;3241;60;3301
28;Normandie;14;1;02;385;Magny-en-Bessin;160;8;168
28;Normandie;14;4;01;389;Maisoncelles-Pelvey;260;12;272
28;Normandie;14;4;01;390;Maisoncelles-sur-Ajon;188;4;192
28;Normandie;14;1;23;391;Maisons;405;13;418
28;Normandie;14;2;12;393;Maizet;368;7;375
28;Normandie;14;2;13;394;Maizières;431;14;445
28;Normandie;14;2;12;396;Maltot;1025;15;1040
28;Normandie;14;1;23;397;Mandeville-en-Bessin;326;8;334
28;Normandie;14;3;19;398;Manerbe;547;16;563
28;Normandie;14;3;21;399;Manneville-la-Pipard;268;10;278
28;Normandie;14;1;02;400;Le Manoir;211;6;217
28;Normandie;14;1;02;401;Manvieux;139;6;145
28;Normandie;14;2;13;402;Le Marais-la-Chapelle;104;1;105
28;Normandie;14;3;17;403;Marolles;744;21;765
28;Normandie;14;2;22;404;Martainville;121;1;122
28;Normandie;14;2;13;405;Martigny-sur-l'Ante;328;7;335
28;Normandie;14;1;03;406;Moulins-en-Bessin;1088;26;1114
28;Normandie;14;2;20;407;Mathieu;2318;58;2376
28;Normandie;14;2;12;408;May-sur-Orne;2016;19;2035
28;Normandie;14;3;04;409;Merville-Franceville-Plage;2195;33;2228
28;Normandie;14;3;19;410;Méry-Bissières-en-Auge;1078;13;1091
28;Normandie;14;2;22;411;Meslay;319;5;324
28;Normandie;14;4;01;412;Le Mesnil-au-Grain;80;0;80
28;Normandie;14;3;19;419;Le Mesnil-Eudes;253;8;261
28;Normandie;14;3;17;421;Le Mesnil-Guillaume;591;8;599
28;Normandie;14;4;25;424;Le Mesnil-Robert;188;3;191
28;Normandie;14;3;19;425;Le Mesnil-Simon;161;6;167
28;Normandie;14;3;21;426;Le Mesnil-sur-Blangy;162;7;169
28;Normandie;14;2;13;427;Le Mesnil-Villement;291;3;294
28;Normandie;14;1;11;430;Meuvaines;136;3;139
28;Normandie;14;3;19;431;Mézidon Vallée d'Auge;9624;110;9734
28;Normandie;14;3;19;435;Les Monceaux;202;3;205
28;Normandie;14;1;02;436;Monceaux-en-Bessin;556;5;561
28;Normandie;14;2;16;437;Mondeville;10054;231;10285
28;Normandie;14;2;12;438;Mondrainville;558;7;565
28;Normandie;14;1;23;439;Monfréville;91;2;93
28;Normandie;14;1;23;445;Montfiquet;90;2;92
28;Normandie;14;2;12;446;Montigny;99;2;101
28;Normandie;14;3;19;448;Montreuil-en-Auge;66;0;66
28;Normandie;14;4;01;449;Monts-en-Bessin;408;6;414
28;Normandie;14;2;13;452;Morteaux-Coulibœuf;616;10;626
28;Normandie;14;1;23;453;Mosles;351;7;358
28;Normandie;14;2;05;454;Mouen;1683;28;1711
28;Normandie;14;2;22;455;Moulines;276;3;279
28;Normandie;14;2;24;456;Moult-Chicheboville;3344;46;3390
28;Normandie;14;2;13;457;Les Moutiers-en-Auge;129;1;130
28;Normandie;14;2;22;458;Les Moutiers-en-Cinglais;515;79;594
28;Normandie;14;3;21;460;Moyaux;1342;29;1371
28;Normandie;14;2;22;461;Mutrécy;506;5;511
28;Normandie;14;1;02;465;Nonant;505;13;518
28;Normandie;14;3;21;466;Norolles;342;9;351
28;Normandie;14;2;13;467;Noron-l'Abbaye;318;7;325
28;Normandie;14;1;23;468;Noron-la-Poterie;346;6;352
28;Normandie;14;2;13;469;Norrey-en-Auge;92;1;93
28;Normandie;14;3;19;473;Notre-Dame-de-Livaye;111;3;114
28;Normandie;14;3;19;474;Notre-Dame-d'Estrées-Corbon;201;3;204
28;Normandie;14;4;01;475;Val d'Arry;2399;47;2446
28;Normandie;14;2;13;476;Olendon;182;3;185
28;Normandie;14;3;18;478;Orbec;1943;49;1992
28;Normandie;14;1;23;480;Osmanville;514;5;519
28;Normandie;14;2;24;482;Ouézy;241;2;243
28;Normandie;14;2;22;483;Ouffières;190;2;192
28;Normandie;14;3;21;484;Ouilly-du-Houley;247;5;252
28;Normandie;14;2;13;486;Ouilly-le-Tesson;572;9;581
28;Normandie;14;3;21;487;Ouilly-le-Vicomte;756;21;777
28;Normandie;14;2;20;488;Ouistreham;9438;120;9558
28;Normandie;14;4;01;491;Parfouru-sur-Odon;195;11;206
28;Normandie;14;3;15;492;Pennedepie;313;7;320
28;Normandie;14;3;04;494;Périers-en-Auge;124;7;131
28;Normandie;14;2;20;495;Périers-sur-le-Dan;566;11;577
28;Normandie;14;4;10;496;Périgny;57;4;61
28;Normandie;14;2;13;497;Perrières;337;7;344
28;Normandie;14;2;13;498;Pertheville-Ners;238;4;242
28;Normandie;14;3;04;499;Petiville;547;6;553
28;Normandie;14;3;21;500;Pierrefitte-en-Auge;157;6;163
28;Normandie;14;2;13;501;Pierrefitte-en-Cinglais;242;5;247
28;Normandie;14;2;13;502;Pierrepont;87;1;88
28;Normandie;14;3;21;504;Le Pin;813;21;834
28;Normandie;14;1;23;506;Planquery;249;3;252
28;Normandie;14;2;11;509;Plumetot;210;5;215
28;Normandie;14;2;22;510;La Pommeraye;59;3;62
28;Normandie;14;4;25;511;Pont-Bellanger;67;0;67
28;Normandie;14;4;10;512;Pontécoulant;70;0;70
28;Normandie;14;3;21;514;Pont-l'Évêque;4790;72;4862
28;Normandie;14;1;02;515;Port-en-Bessin-Huppain;1921;17;1938
28;Normandie;14;2;13;516;Potigny;2072;20;2092
28;Normandie;14;2;12;519;Préaux-Bocage;126;0;126
28;Normandie;14;3;19;520;Le Pré-d'Auge;858;22;880
28;Normandie;14;3;19;522;Prêtreville;388;7;395
28;Normandie;14;3;04;524;Putot-en-Auge;303;7;310
28;Normandie;14;3;19;527;Belle Vie en Auge;543;8;551
28;Normandie;14;3;15;528;Quetteville;399;5;404
28;Normandie;14;1;02;529;Ranchy;269;3;272
28;Normandie;14;3;04;530;Ranville;1962;28;1990
28;Normandie;14;2;13;531;Rapilly;49;0;49
28;Normandie;14;3;19;533;Repentigny;100;4;104
28;Normandie;14;3;21;534;Reux;396;3;399
28;Normandie;14;2;03;535;Reviers;550;12;562
28;Normandie;14;3;15;536;La Rivière-Saint-Sauveur;2551;45;2596
28;Normandie;14;2;12;538;Castine-en-Plaine;1699;33;1732
28;Normandie;14;3;21;540;Rocques;287;13;300
28;Normandie;14;3;19;541;La Roque-Baignard;115;1;116
28;Normandie;14;2;03;542;Rosel;536;11;547
28;Normandie;14;2;03;543;Rots;2474;50;2524
28;Normandie;14;2;13;546;Rouvres;223;2;225
28;Normandie;14;1;23;547;Rubercy;152;3;155
28;Normandie;14;3;19;550;Rumesnil;90;1;91
28;Normandie;14;1;02;552;Ryes;499;14;513
28;Normandie;14;2;12;554;Le Castelet;1716;21;1737
28;Normandie;14;3;21;555;Saint-André-d'Hébertot;451;5;456
28;Normandie;14;2;09;556;Saint-André-sur-Orne;1814;22;1836
28;Normandie;14;3;21;557;Saint-Arnoult;1118;15;1133
28;Normandie;14;2;20;558;Saint-Aubin-d'Arquenay;1122;16;1138
28;Normandie;14;4;25;559;Saint-Aubin-des-Bois;226;2;228
28;Normandie;14;2;11;562;Saint-Aubin-sur-Mer;2162;36;2198
28;Normandie;14;3;21;563;Saint-Benoît-d'Hébertot;441;9;450
28;Normandie;14;1;11;565;Saint-Côme-de-Fresné;259;3;262
28;Normandie;14;2;06;566;Saint-Contest;2515;49;2564
28;Normandie;14;1;11;569;Sainte-Croix-sur-Mer;239;6;245
28;Normandie;14;3;18;570;Valorbiquet;2517;42;2559
28;Normandie;14;3;18;571;Saint-Denis-de-Mailloc;306;6;312
28;Normandie;14;4;10;572;Saint-Denis-de-Méré;771;7;778
28;Normandie;14;3;19;574;Saint-Désir;1746;88;1834
28;Normandie;14;3;21;575;Saint-Étienne-la-Thillaye;381;21;402
28;Normandie;14;3;18;576;Val-de-Vie;518;13;531
28;Normandie;14;3;15;578;Saint-Gatien-des-Bois;1345;31;1376
28;Normandie;14;4;01;579;Seulline;1310;24;1334
28;Normandie;14;3;19;582;Saint-Germain-de-Livet;718;22;740
28;Normandie;14;1;23;586;Saint-Germain-du-Pert;157;6;163
28;Normandie;14;2;06;587;Saint-Germain-la-Blanche-Herbe;2405;45;2450
28;Normandie;14;2;13;588;Saint-Germain-Langot;343;2;345
28;Normandie;14;2;22;589;Saint-Germain-le-Vasson;957;9;966
28;Normandie;14;1;23;590;Sainte-Honorine-de-Ducy;136;1;137
28;Normandie;14;1;23;591;Aure sur Mer;720;11;731
28;Normandie;14;2;12;592;Sainte-Honorine-du-Fay;1341;21;1362
28;Normandie;14;3;21;593;Saint-Hymer;692;13;705
28;Normandie;14;3;19;595;Saint-Jean-de-Livet;242;5;247
28;Normandie;14;3;04;598;Saint-Jouin;241;5;246
28;Normandie;14;3;21;601;Saint-Julien-sur-Calonne;167;4;171
28;Normandie;14;2;22;602;Saint-Lambert;269;3;272
28;Normandie;14;2;22;603;Saint-Laurent-de-Condel;507;8;515
28;Normandie;14;1;23;605;Saint-Laurent-sur-Mer;260;8;268
28;Normandie;14;3;04;606;Saint-Léger-Dubosq;224;2;226
28;Normandie;14;4;01;607;Saint-Louet-sur-Seulles;141;1;142
28;Normandie;14;1;02;609;Saint-Loup-Hors;555;9;564
28;Normandie;14;2;03;610;Saint-Manvieu-Norrey;2016;100;2116
28;Normandie;14;1;23;613;Saint-Marcouf;90;1;91
28;Normandie;14;1;23;614;Sainte-Marguerite-d'Elle;771;9;780
28;Normandie;14;4;25;619;Sainte-Marie-Outre-l'Eau;125;2;127
28;Normandie;14;3;21;620;Saint-Martin-aux-Chartrains;425;6;431
28;Normandie;14;3;18;621;Saint-Martin-de-Bienfaite-la-Cressonnière;467;11;478
28;Normandie;14;1;23;622;Saint-Martin-de-Blagny;125;0;125
28;Normandie;14;2;12;623;Saint-Martin-de-Fontenay;2519;45;2564
28;Normandie;14;3;17;625;Saint-Martin-de-la-Lieue;776;14;790
28;Normandie;14;3;19;626;Saint-Martin-de-Mailloc;947;22;969
28;Normandie;14;2;13;627;Saint-Martin-de-Mieux;393;8;401
28;Normandie;14;1;02;630;Saint-Martin-des-Entrées;714;20;734
28;Normandie;14;2;22;635;Saint-Omer;189;1;190
28;Normandie;14;2;24;637;Saint-Ouen-du-Mesnil-Oger;209;3;212
28;Normandie;14;3;19;639;Saint-Ouen-le-Pin;257;8;265
28;Normandie;14;2;24;640;Saint-Pair;244;1;245
28;Normandie;14;1;23;643;Saint-Paul-du-Vernay;832;14;846
28;Normandie;14;3;21;644;Saint-Philbert-des-Champs;655;14;669
28;Normandie;14;3;21;645;Saint-Pierre-Azif;162;9;171
28;Normandie;14;2;13;646;Saint-Pierre-Canivet;459;9;468
28;Normandie;14;3;19;648;Saint-Pierre-des-Ifs;454;19;473
28;Normandie;14;2;13;649;Saint-Pierre-du-Bû;464;6;470
28;Normandie;14;4;01;650;Saint-Pierre-du-Fresne;188;4;192
28;Normandie;14;2;24;651;Saint-Pierre-du-Jonquet;273;2;275
28;Normandie;14;1;23;652;Saint-Pierre-du-Mont;77;2;79
28;Normandie;14;3;18;654;Saint-Pierre-en-Auge;7325;340;7665
28;Normandie;14;2;22;656;Saint-Rémy;985;14;999
28;Normandie;14;3;24;657;Saint-Samson;315;4;319
28;Normandie;14;4;25;658;Noues de Sienne;4326;87;4413
28;Normandie;14;2;22;659;Saint-Sylvain;1445;25;1470
28;Normandie;14;3;04;660;Saint-Vaast-en-Auge;101;3;104
28;Normandie;14;1;03;661;Saint-Vaast-sur-Seulles;157;0;157
28;Normandie;14;1;02;663;Saint-Vigor-le-Grand;2529;53;2582
28;Normandie;14;1;23;664;Sallen;316;4;320
28;Normandie;14;3;04;665;Sallenelles;296;4;300
28;Normandie;14;2;24;666;Sannerville;1892;19;1911
28;Normandie;14;1;23;667;Saon;221;4;225
28;Normandie;14;1;23;668;Saonnet;323;2;325
28;Normandie;14;2;13;669;Sassy;208;2;210
28;Normandie;14;4;01;672;Val de Drôme;881;14;895
28;Normandie;14;2;22;674;Soignolles;124;4;128
28;Normandie;14;2;12;675;Soliers;2079;30;2109
28;Normandie;14;1;02;676;Sommervieu;987;23;1010
28;Normandie;14;2;13;677;Soulangy;252;4;256
28;Normandie;14;2;13;678;Soumont-Saint-Quentin;588;10;598
28;Normandie;14;1;02;679;Subles;667;15;682
28;Normandie;14;1;02;680;Sully;160;6;166
28;Normandie;14;1;23;681;Surrain;147;4;151
28;Normandie;14;3;21;682;Surville;463;12;475
28;Normandie;14;1;03;684;Tessel;249;3;252
28;Normandie;14;2;03;685;Thaon;1795;34;1829
28;Normandie;14;3;15;687;Le Theil-en-Auge;193;3;196
28;Normandie;14;2;22;689;Thury-Harcourt-le-Hom;3599;48;3647
28;Normandie;14;1;03;692;Tilly-sur-Seulles;1766;23;1789
28;Normandie;14;3;21;694;Le Torquesne;541;20;561
28;Normandie;14;3;24;698;Touffréville;400;2;402
28;Normandie;14;3;15;699;Touques;3744;63;3807
28;Normandie;14;1;23;700;Tour-en-Bessin;674;8;682
28;Normandie;14;3;21;701;Tourgéville;803;15;818
28;Normandie;14;1;23;705;Tournières;149;1;150
28;Normandie;14;3;21;706;Tourville-en-Auge;246;6;252
28;Normandie;14;2;05;707;Tourville-sur-Odon;1115;13;1128
28;Normandie;14;4;01;708;Tracy-Bocage;298;7;305
28;Normandie;14;1;02;709;Tracy-sur-Mer;345;7;352
28;Normandie;14;2;13;710;Tréprel;103;0;103
28;Normandie;14;1;23;711;Trévières;918;10;928
28;Normandie;14;2;24;712;Troarn;3435;91;3526
28;Normandie;14;2;22;713;Montillières-sur-Orne;572;11;583
28;Normandie;14;1;23;714;Le Tronquay;783;11;794
28;Normandie;14;3;15;715;Trouville-sur-Mer;4603;86;4689
28;Normandie;14;1;23;716;Trungy;211;3;214
28;Normandie;14;2;22;719;Urville;725;6;731
28;Normandie;14;2;13;720;Ussy;852;28;880
28;Normandie;14;2;12;721;Vacognes-Neuilly;659;7;666
28;Normandie;14;3;19;723;Valsemé;267;4;271
28;Normandie;14;3;04;724;Varaville;1019;12;1031
28;Normandie;14;4;10;726;Valdallière;5735;104;5839
28;Normandie;14;1;02;728;Vaucelles;580;7;587
28;Normandie;14;3;21;731;Vauville;193;12;205
28;Normandie;14;1;02;732;Vaux-sur-Aure;299;11;310
28;Normandie;14;1;02;733;Vaux-sur-Seulles;317;9;326
28;Normandie;14;1;03;734;Vendes;332;8;340
28;Normandie;14;2;18;735;Vendeuvre;807;11;818
28;Normandie;14;2;13;737;Versainville;498;10;508
28;Normandie;14;2;05;738;Verson;3657;53;3710
28;Normandie;14;1;11;739;Ver-sur-Mer;1648;36;1684
28;Normandie;14;3;18;740;La Vespière-Friardel;1181;26;1207
28;Normandie;14;2;22;741;Le Vey;119;3;122
28;Normandie;14;2;13;742;Vicques;73;0;73
28;Normandie;14;3;19;743;Victot-Pontfol;85;3;88
28;Normandie;14;1;02;744;Vienne-en-Bessin;288;4;292
28;Normandie;14;1;23;745;Vierville-sur-Mer;231;4;235
28;Normandie;14;2;12;747;Vieux;675;8;683
28;Normandie;14;3;21;748;Vieux-Bourg;76;1;77
28;Normandie;14;2;13;751;Vignats;292;8;300
28;Normandie;14;4;01;752;Villers-Bocage;3147;40;3187
28;Normandie;14;2;13;753;Villers-Canivet;740;22;762
28;Normandie;14;3;21;754;Villers-sur-Mer;2507;52;2559
28;Normandie;14;3;15;755;Villerville;591;12;603
28;Normandie;14;4;10;756;La Villette;233;3;236
28;Normandie;14;2;06;758;Villons-les-Buissons;796;18;814
28;Normandie;14;2;13;759;Villy-lez-Falaise;265;10;275
28;Normandie;14;4;01;760;Villy-Bocage;733;6;739
28;Normandie;14;2;24;761;Vimont;826;15;841
28;Normandie;14;4;25;762;Vire Normandie;16935;849;17784
28;Normandie;14;2;13;764;Pont-d'Ouilly;961;13;974
84;Auvergne-Rhône-Alpes;15;3;07;001;Allanche;796;10;806
84;Auvergne-Rhône-Alpes;15;3;09;002;Alleuze;223;4;227
84;Auvergne-Rhône-Alpes;15;2;05;003;Ally;599;11;610
84;Auvergne-Rhône-Alpes;15;3;11;004;Andelat;474;9;483
84;Auvergne-Rhône-Alpes;15;3;09;005;Anglards-de-Saint-Flour;369;12;381
84;Auvergne-Rhône-Alpes;15;2;05;006;Anglards-de-Salers;708;23;731
84;Auvergne-Rhône-Alpes;15;3;09;007;Anterrieux;122;5;127
84;Auvergne-Rhône-Alpes;15;2;15;008;Antignac;284;7;291
84;Auvergne-Rhône-Alpes;15;2;10;009;Apchon;186;4;190
84;Auvergne-Rhône-Alpes;15;2;15;010;Arches;196;3;199
84;Auvergne-Rhône-Alpes;15;1;13;011;Arnac;182;3;185
84;Auvergne-Rhône-Alpes;15;1;01;012;Arpajon-sur-Cère;6313;196;6509
84;Auvergne-Rhône-Alpes;15;3;11;013;Auriac-l'Église;145;1;146
84;Auvergne-Rhône-Alpes;15;1;98;014;Aurillac;25703;1270;26973
84;Auvergne-Rhône-Alpes;15;2;10;015;Auzers;166;3;169
84;Auvergne-Rhône-Alpes;15;1;13;016;Ayrens;625;14;639
84;Auvergne-Rhône-Alpes;15;1;14;017;Badailhac;140;7;147
84;Auvergne-Rhône-Alpes;15;2;05;018;Barriac-les-Bosquets;136;1;137
84;Auvergne-Rhône-Alpes;15;2;15;019;Bassignac;225;4;229
84;Auvergne-Rhône-Alpes;15;2;15;020;Beaulieu;93;0;93
84;Auvergne-Rhône-Alpes;15;1;06;021;Boisset;644;19;663
84;Auvergne-Rhône-Alpes;15;3;11;022;Bonnac;162;5;167
84;Auvergne-Rhône-Alpes;15;2;05;024;Brageac;76;0;76
84;Auvergne-Rhône-Alpes;15;3;07;025;Albepierre-Bredons;237;8;245
84;Auvergne-Rhône-Alpes;15;3;12;026;Brezons;183;1;184
84;Auvergne-Rhône-Alpes;15;1;06;027;Puycapel;739;14;753
84;Auvergne-Rhône-Alpes;15;1;14;028;Carlat;367;6;373
84;Auvergne-Rhône-Alpes;15;1;01;029;Cassaniouze;505;16;521
84;Auvergne-Rhône-Alpes;15;1;13;030;Cayrols;295;13;308
84;Auvergne-Rhône-Alpes;15;3;09;032;Celoux;58;3;61
84;Auvergne-Rhône-Alpes;15;3;12;033;Cézens;214;4;218
84;Auvergne-Rhône-Alpes;15;3;09;034;Chaliers;143;6;149
84;Auvergne-Rhône-Alpes;15;2;05;036;Chalvignac;471;8;479
84;Auvergne-Rhône-Alpes;15;2;15;037;Champagnac;1040;22;1062
84;Auvergne-Rhône-Alpes;15;2;15;038;Champs-sur-Tarentaine-Marchal;1015;15;1030
84;Auvergne-Rhône-Alpes;15;3;10;040;Chanterelle;99;6;105
84;Auvergne-Rhône-Alpes;15;3;07;041;La Chapelle-d'Alagnon;254;4;258
84;Auvergne-Rhône-Alpes;15;3;11;042;La Chapelle-Laurent;249;4;253
84;Auvergne-Rhône-Alpes;15;3;07;043;Charmensac;82;2;84
84;Auvergne-Rhône-Alpes;15;3;09;045;Chaudes-Aigues;818;11;829
84;Auvergne-Rhône-Alpes;15;2;05;046;Chaussenac;219;4;223
84;Auvergne-Rhône-Alpes;15;3;09;048;Chazelles;30;1;31
84;Auvergne-Rhône-Alpes;15;3;07;049;Cheylade;222;6;228
84;Auvergne-Rhône-Alpes;15;3;07;050;Le Claux;166;3;169
84;Auvergne-Rhône-Alpes;15;3;09;051;Clavières;210;5;215
84;Auvergne-Rhône-Alpes;15;2;10;052;Collandres;157;10;167
84;Auvergne-Rhône-Alpes;15;3;11;053;Coltines;433;9;442
84;Auvergne-Rhône-Alpes;15;3;10;054;Condat;985;29;1014
84;Auvergne-Rhône-Alpes;15;3;11;055;Coren;444;14;458
84;Auvergne-Rhône-Alpes;15;1;08;056;Crandelles;861;20;881
84;Auvergne-Rhône-Alpes;15;1;13;057;Cros-de-Montvert;187;4;191
84;Auvergne-Rhône-Alpes;15;1;14;058;Cros-de-Ronesque;146;1;147
84;Auvergne-Rhône-Alpes;15;3;12;059;Cussac;122;7;129
84;Auvergne-Rhône-Alpes;15;3;09;060;Deux-Verges;52;1;53
84;Auvergne-Rhône-Alpes;15;3;07;061;Dienne;261;5;266
84;Auvergne-Rhône-Alpes;15;2;05;063;Drugeac;323;13;336
84;Auvergne-Rhône-Alpes;15;2;05;064;Escorailles;84;1;85
84;Auvergne-Rhône-Alpes;15;3;09;065;Espinasse;77;1;78
84;Auvergne-Rhône-Alpes;15;2;10;066;Le Falgoux;118;2;120
84;Auvergne-Rhône-Alpes;15;2;05;067;Le Fau;28;0;28
84;Auvergne-Rhône-Alpes;15;3;11;069;Ferrières-Saint-Mary;244;6;250
84;Auvergne-Rhône-Alpes;15;2;05;070;Fontanges;201;2;203
84;Auvergne-Rhône-Alpes;15;1;08;072;Freix-Anglards;220;9;229
84;Auvergne-Rhône-Alpes;15;3;09;073;Fridefont;93;2;95
84;Auvergne-Rhône-Alpes;15;1;14;074;Giou-de-Mamou;752;21;773
84;Auvergne-Rhône-Alpes;15;1;08;075;Girgols;73;4;77
84;Auvergne-Rhône-Alpes;15;1;13;076;Glénat;170;4;174
84;Auvergne-Rhône-Alpes;15;3;12;077;Gourdièges;63;0;63
84;Auvergne-Rhône-Alpes;15;3;09;078;Jabrun;158;2;160
84;Auvergne-Rhône-Alpes;15;2;15;079;Jaleyrac;368;10;378
84;Auvergne-Rhône-Alpes;15;3;07;080;Joursac;146;5;151
84;Auvergne-Rhône-Alpes;15;1;14;081;Jou-sous-Monjou;96;2;98
84;Auvergne-Rhône-Alpes;15;1;01;082;Junhac;293;11;304
84;Auvergne-Rhône-Alpes;15;1;08;083;Jussac;2027;65;2092
84;Auvergne-Rhône-Alpes;15;1;01;084;Labesserette;291;9;300
84;Auvergne-Rhône-Alpes;15;1;14;085;Labrousse;488;12;500
84;Auvergne-Rhône-Alpes;15;3;12;086;Lacapelle-Barrès;58;1;59
84;Auvergne-Rhône-Alpes;15;1;01;087;Lacapelle-del-Fraisse;368;11;379
84;Auvergne-Rhône-Alpes;15;1;13;088;Lacapelle-Viescamp;508;14;522
84;Auvergne-Rhône-Alpes;15;1;01;089;Ladinhac;444;13;457
84;Auvergne-Rhône-Alpes;15;1;01;090;Lafeuillade-en-Vézie;592;15;607
84;Auvergne-Rhône-Alpes;15;3;07;091;Landeyrat;91;4;95
84;Auvergne-Rhône-Alpes;15;2;15;092;Lanobre;1386;17;1403
84;Auvergne-Rhône-Alpes;15;1;01;093;Lapeyrugue;100;3;103
84;Auvergne-Rhône-Alpes;15;1;13;094;Laroquebrou;804;16;820
84;Auvergne-Rhône-Alpes;15;1;08;095;Laroquevieille;352;3;355
84;Auvergne-Rhône-Alpes;15;1;14;096;Lascelle;279;7;286
84;Auvergne-Rhône-Alpes;15;3;11;097;Lastic;110;5;115
84;Auvergne-Rhône-Alpes;15;3;11;098;Laurie;90;0;90
84;Auvergne-Rhône-Alpes;15;3;07;100;Laveissenet;131;2;133
84;Auvergne-Rhône-Alpes;15;3;07;101;Laveissière;517;10;527
84;Auvergne-Rhône-Alpes;15;3;07;102;Lavigerie;108;0;108
84;Auvergne-Rhône-Alpes;15;1;01;103;Leucamp;239;6;245
84;Auvergne-Rhône-Alpes;15;1;06;104;Leynhac;351;11;362
84;Auvergne-Rhône-Alpes;15;3;11;105;Leyvaux;34;3;37
84;Auvergne-Rhône-Alpes;15;3;09;106;Lieutadès;161;2;163
84;Auvergne-Rhône-Alpes;15;3;09;107;Lorcières;170;4;174
84;Auvergne-Rhône-Alpes;15;3;09;108;Val d'Arcomie;994;22;1016
84;Auvergne-Rhône-Alpes;15;3;10;110;Lugarde;122;7;129
84;Auvergne-Rhône-Alpes;15;2;15;111;Madic;209;7;216
84;Auvergne-Rhône-Alpes;15;3;12;112;Malbo;90;4;94
84;Auvergne-Rhône-Alpes;15;1;14;113;Mandailles-Saint-Julien;180;4;184
84;Auvergne-Rhône-Alpes;15;3;10;114;Marcenat;514;8;522
84;Auvergne-Rhône-Alpes;15;3;10;116;Marchastel;147;4;151
84;Auvergne-Rhône-Alpes;15;1;06;117;Marcolès;585;70;655
84;Auvergne-Rhône-Alpes;15;1;08;118;Marmanhac;722;31;753
84;Auvergne-Rhône-Alpes;15;3;11;119;Massiac;1801;68;1869
84;Auvergne-Rhône-Alpes;15;2;05;120;Mauriac;3489;212;3701
84;Auvergne-Rhône-Alpes;15;3;09;121;Maurines;108;1;109
84;Auvergne-Rhône-Alpes;15;1;06;122;Maurs;2107;61;2168
84;Auvergne-Rhône-Alpes;15;2;10;123;Méallet;161;0;161
84;Auvergne-Rhône-Alpes;15;2;10;124;Menet;531;24;555
84;Auvergne-Rhône-Alpes;15;3;11;125;Mentières;130;3;133
84;Auvergne-Rhône-Alpes;15;3;11;126;Molèdes;80;3;83
84;Auvergne-Rhône-Alpes;15;3;11;127;Molompize;278;5;283
84;Auvergne-Rhône-Alpes;15;2;15;128;La Monselie;122;1;123
84;Auvergne-Rhône-Alpes;15;3;10;129;Montboudif;166;6;172
84;Auvergne-Rhône-Alpes;15;3;11;130;Montchamp;143;4;147
84;Auvergne-Rhône-Alpes;15;2;15;131;Le Monteil;284;8;292
84;Auvergne-Rhône-Alpes;15;3;10;132;Montgreleix;41;1;42
84;Auvergne-Rhône-Alpes;15;1;06;133;Montmurat;134;2;136
84;Auvergne-Rhône-Alpes;15;1;01;134;Montsalvy;812;11;823
84;Auvergne-Rhône-Alpes;15;1;13;135;Montvert;114;6;120
84;Auvergne-Rhône-Alpes;15;2;10;137;Moussages;262;3;265
84;Auvergne-Rhône-Alpes;15;3;07;138;Murat;1815;98;1913
84;Auvergne-Rhône-Alpes;15;3;12;139;Narnhac;68;0;68
84;Auvergne-Rhône-Alpes;15;1;08;140;Naucelles;2116;62;2178
84;Auvergne-Rhône-Alpes;15;3;07;141;Neussargues en Pinatelle;1728;37;1765
84;Auvergne-Rhône-Alpes;15;3;09;142;Neuvéglise-sur-Truyère;1720;44;1764
84;Auvergne-Rhône-Alpes;15;1;13;143;Nieudan;101;1;102
84;Auvergne-Rhône-Alpes;15;1;13;144;Omps;325;10;335
84;Auvergne-Rhône-Alpes;15;1;14;146;Pailherols;124;5;129
84;Auvergne-Rhône-Alpes;15;1;13;147;Parlan;457;8;465
84;Auvergne-Rhône-Alpes;15;3;12;148;Paulhac;430;12;442
84;Auvergne-Rhône-Alpes;15;3;12;149;Paulhenc;258;3;261
84;Auvergne-Rhône-Alpes;15;3;07;151;Peyrusse;148;0;148
84;Auvergne-Rhône-Alpes;15;3;12;152;Pierrefort;905;19;924
84;Auvergne-Rhône-Alpes;15;2;05;153;Pleaux;1454;34;1488
84;Auvergne-Rhône-Alpes;15;1;14;154;Polminhac;1195;24;1219
84;Auvergne-Rhône-Alpes;15;3;07;155;Pradiers;85;1;86
84;Auvergne-Rhône-Alpes;15;1;01;156;Prunet;685;16;701
84;Auvergne-Rhône-Alpes;15;1;06;157;Quézac;355;42;397
84;Auvergne-Rhône-Alpes;15;3;09;158;Rageade;103;2;105
84;Auvergne-Rhône-Alpes;15;1;14;159;Raulhac;269;9;278
84;Auvergne-Rhône-Alpes;15;1;08;160;Reilhac;1089;22;1111
84;Auvergne-Rhône-Alpes;15;3;11;161;Rézentières;108;3;111
84;Auvergne-Rhône-Alpes;15;2;10;162;Riom-ès-Montagnes;2454;40;2494
84;Auvergne-Rhône-Alpes;15;1;06;163;Roannes-Saint-Mary;1109;34;1143
84;Auvergne-Rhône-Alpes;15;3;11;164;Roffiac;605;24;629
84;Auvergne-Rhône-Alpes;15;1;13;165;Rouffiac;203;4;207
84;Auvergne-Rhône-Alpes;15;1;13;166;Roumégoux;316;10;326
84;Auvergne-Rhône-Alpes;15;1;06;167;Rouziers;115;8;123
84;Auvergne-Rhône-Alpes;15;3;09;168;Ruynes-en-Margeride;712;25;737
84;Auvergne-Rhône-Alpes;15;2;15;169;Saignes;821;14;835
84;Auvergne-Rhône-Alpes;15;3;10;170;Saint-Amandin;232;2;234
84;Auvergne-Rhône-Alpes;15;1;06;172;Saint-Antoine;91;0;91
84;Auvergne-Rhône-Alpes;15;3;10;173;Saint-Bonnet-de-Condat;115;5;120
84;Auvergne-Rhône-Alpes;15;2;05;174;Saint-Bonnet-de-Salers;270;3;273
84;Auvergne-Rhône-Alpes;15;1;08;175;Saint-Cernin;1062;23;1085
84;Auvergne-Rhône-Alpes;15;2;08;176;Saint-Chamant;239;8;247
84;Auvergne-Rhône-Alpes;15;1;14;178;Saint-Cirgues-de-Jordanne;143;7;150
84;Auvergne-Rhône-Alpes;15;1;08;179;Saint-Cirgues-de-Malbert;249;3;252
84;Auvergne-Rhône-Alpes;15;1;14;180;Saint-Clément;75;4;79
84;Auvergne-Rhône-Alpes;15;1;06;181;Saint-Constant-Fournoulès;574;11;585
84;Auvergne-Rhône-Alpes;15;1;13;182;Saint-Étienne-Cantalès;130;2;132
84;Auvergne-Rhône-Alpes;15;1;14;183;Saint-Étienne-de-Carlat;135;0;135
84;Auvergne-Rhône-Alpes;15;1;06;184;Saint-Étienne-de-Maurs;782;19;801
84;Auvergne-Rhône-Alpes;15;2;10;185;Saint-Étienne-de-Chomeil;246;7;253
84;Auvergne-Rhône-Alpes;15;2;05;186;Sainte-Eulalie;231;3;234
84;Auvergne-Rhône-Alpes;15;3;99;187;Saint-Flour;6451;541;6992
84;Auvergne-Rhône-Alpes;15;3;09;188;Saint-Georges;1190;27;1217
84;Auvergne-Rhône-Alpes;15;1;13;189;Saint-Gérons;224;6;230
84;Auvergne-Rhône-Alpes;15;2;10;190;Saint-Hippolyte;98;2;100
84;Auvergne-Rhône-Alpes;15;1;08;191;Saint-Illide;635;11;646
84;Auvergne-Rhône-Alpes;15;1;14;192;Saint-Jacques-des-Blats;291;4;295
84;Auvergne-Rhône-Alpes;15;1;06;194;Saint-Julien-de-Toursac;103;7;110
84;Auvergne-Rhône-Alpes;15;1;06;196;Saint-Mamet-la-Salvetat;1546;55;1601
84;Auvergne-Rhône-Alpes;15;3;12;198;Sainte-Marie;109;2;111
84;Auvergne-Rhône-Alpes;15;3;09;199;Saint-Martial;72;0;72
84;Auvergne-Rhône-Alpes;15;2;05;200;Saint-Martin-Cantalès;147;3;150
84;Auvergne-Rhône-Alpes;15;3;12;201;Saint-Martin-sous-Vigouroux;223;3;226
84;Auvergne-Rhône-Alpes;15;2;05;202;Saint-Martin-Valmeroux;708;15;723
84;Auvergne-Rhône-Alpes;15;3;11;203;Saint-Mary-le-Plain;182;6;188
84;Auvergne-Rhône-Alpes;15;1;13;204;Saint-Paul-des-Landes;1536;45;1581
84;Auvergne-Rhône-Alpes;15;2;05;205;Saint-Paul-de-Salers;105;4;109
84;Auvergne-Rhône-Alpes;15;2;15;206;Saint-Pierre;143;1;144
84;Auvergne-Rhône-Alpes;15;3;11;207;Saint-Poncy;354;6;360
84;Auvergne-Rhône-Alpes;15;2;08;208;Saint-Projet-de-Salers;133;4;137
84;Auvergne-Rhône-Alpes;15;3;09;209;Saint-Rémy-de-Chaudes-Aigues;123;5;128
84;Auvergne-Rhône-Alpes;15;1;13;211;Saint-Santin-Cantalès;294;5;299
84;Auvergne-Rhône-Alpes;15;1;06;212;Saint-Santin-de-Maurs;361;10;371
84;Auvergne-Rhône-Alpes;15;3;07;213;Saint-Saturnin;202;6;208
84;Auvergne-Rhône-Alpes;15;1;13;214;Saint-Saury;174;5;179
84;Auvergne-Rhône-Alpes;15;1;14;215;Saint-Simon;1127;37;1164
84;Auvergne-Rhône-Alpes;15;3;09;216;Saint-Urcize;398;14;412
84;Auvergne-Rhône-Alpes;15;1;13;217;Saint-Victor;106;3;109
84;Auvergne-Rhône-Alpes;15;2;10;218;Saint-Vincent-de-Salers;69;2;71
84;Auvergne-Rhône-Alpes;15;2;05;219;Salers;321;6;327
84;Auvergne-Rhône-Alpes;15;2;05;220;Salins;143;2;145
84;Auvergne-Rhône-Alpes;15;1;06;221;Sansac-de-Marmiesse;1352;42;1394
84;Auvergne-Rhône-Alpes;15;1;01;222;Sansac-Veinazès;212;7;219
84;Auvergne-Rhône-Alpes;15;2;15;223;Sauvat;214;6;220
84;Auvergne-Rhône-Alpes;15;1;13;224;La Ségalassière;129;7;136
84;Auvergne-Rhône-Alpes;15;3;07;225;Ségur-les-Villas;217;4;221
84;Auvergne-Rhône-Alpes;15;1;01;226;Sénezergues;209;4;213
84;Auvergne-Rhône-Alpes;15;1;13;228;Siran;460;11;471
84;Auvergne-Rhône-Alpes;15;3;09;229;Soulages;81;2;83
84;Auvergne-Rhône-Alpes;15;2;15;230;Sourniac;197;9;206
84;Auvergne-Rhône-Alpes;15;3;11;231;Talizat;602;27;629
84;Auvergne-Rhône-Alpes;15;3;12;232;Tanavelle;225;9;234
84;Auvergne-Rhône-Alpes;15;1;08;233;Teissières-de-Cornet;304;5;309
84;Auvergne-Rhône-Alpes;15;1;14;234;Teissières-lès-Bouliès;330;6;336
84;Auvergne-Rhône-Alpes;15;3;12;235;Les Ternes;568;24;592
84;Auvergne-Rhône-Alpes;15;1;14;236;Thiézac;602;15;617
84;Auvergne-Rhône-Alpes;15;3;11;237;Tiviers;170;11;181
84;Auvergne-Rhône-Alpes;15;1;08;238;Tournemire;127;3;130
84;Auvergne-Rhône-Alpes;15;2;15;240;Trémouille;172;7;179
84;Auvergne-Rhône-Alpes;15;3;09;241;La Trinitat;48;3;51
84;Auvergne-Rhône-Alpes;15;1;06;242;Le Trioulou;101;2;103
84;Auvergne-Rhône-Alpes;15;2;10;243;Trizac;482;14;496
84;Auvergne-Rhône-Alpes;15;3;07;244;Ussel;468;10;478
84;Auvergne-Rhône-Alpes;15;3;09;245;Vabres;250;4;254
84;Auvergne-Rhône-Alpes;15;2;10;246;Valette;239;3;242
84;Auvergne-Rhône-Alpes;15;3;11;247;Valjouze;23;0;23
84;Auvergne-Rhône-Alpes;15;3;12;248;Valuéjols;563;11;574
84;Auvergne-Rhône-Alpes;15;2;10;249;Le Vaulmier;60;2;62
84;Auvergne-Rhône-Alpes;15;2;15;250;Vebret;511;18;529
84;Auvergne-Rhône-Alpes;15;3;09;251;Védrines-Saint-Loup;134;6;140
84;Auvergne-Rhône-Alpes;15;1;14;252;Velzic;404;18;422
84;Auvergne-Rhône-Alpes;15;3;07;253;Vernols;65;2;67
84;Auvergne-Rhône-Alpes;15;2;15;254;Veyrières;120;4;124
84;Auvergne-Rhône-Alpes;15;1;14;255;Vézac;1269;35;1304
84;Auvergne-Rhône-Alpes;15;3;07;256;Vèze;56;2;58
84;Auvergne-Rhône-Alpes;15;1;14;257;Vezels-Roussy;127;5;132
84;Auvergne-Rhône-Alpes;15;1;14;258;Vic-sur-Cère;1862;37;1899
84;Auvergne-Rhône-Alpes;15;3;11;259;Vieillespesse;241;3;244
84;Auvergne-Rhône-Alpes;15;1;01;260;Vieillevie;107;4;111
84;Auvergne-Rhône-Alpes;15;2;05;261;Le Vigean;827;19;846
84;Auvergne-Rhône-Alpes;15;3;12;262;Villedieu;563;12;575
84;Auvergne-Rhône-Alpes;15;3;07;263;Virargues;119;3;122
84;Auvergne-Rhône-Alpes;15;1;06;264;Vitrac;268;6;274
84;Auvergne-Rhône-Alpes;15;2;15;265;Ydes;1632;25;1657
84;Auvergne-Rhône-Alpes;15;1;14;266;Yolet;565;10;575
84;Auvergne-Rhône-Alpes;15;1;02;267;Ytrac;4329;107;4436
84;Auvergne-Rhône-Alpes;15;1;13;268;Le Rouget-Pers;1268;25;1293
84;Auvergne-Rhône-Alpes;15;1;08;269;Besse;129;3;132
75;Nouvelle-Aquitaine;16;3;10;001;Abzac;507;1;508
75;Nouvelle-Aquitaine;16;3;08;002;Les Adjots;526;16;542
75;Nouvelle-Aquitaine;16;1;19;003;Agris;859;10;869
75;Nouvelle-Aquitaine;16;3;08;005;Aigre;1595;20;1615
75;Nouvelle-Aquitaine;16;3;06;007;Alloue;469;11;480
75;Nouvelle-Aquitaine;16;3;05;008;Ambérac;306;2;308
75;Nouvelle-Aquitaine;16;3;10;009;Ambernac;379;6;385
75;Nouvelle-Aquitaine;16;3;05;011;Anais;563;21;584
75;Nouvelle-Aquitaine;16;2;07;012;Angeac-Champagne;498;9;507
75;Nouvelle-Aquitaine;16;2;07;013;Angeac-Charente;313;8;321
75;Nouvelle-Aquitaine;16;2;09;014;Angeduc;133;1;134
75;Nouvelle-Aquitaine;16;1;98;015;Angoulême;41407;1672;43079
75;Nouvelle-Aquitaine;16;3;10;016;Ansac-sur-Vienne;825;17;842
75;Nouvelle-Aquitaine;16;2;12;018;Ars;704;18;722
75;Nouvelle-Aquitaine;16;1;18;019;Asnières-sur-Nouère;1265;22;1287
75;Nouvelle-Aquitaine;16;1;17;020;Aubeterre-sur-Dronne;329;4;333
75;Nouvelle-Aquitaine;16;3;05;023;Aunac-sur-Charente;574;11;585
75;Nouvelle-Aquitaine;16;3;05;024;Aussac-Vadalle;518;9;527
75;Nouvelle-Aquitaine;16;2;09;025;Baignes-Sainte-Radegonde;1235;31;1266
75;Nouvelle-Aquitaine;16;1;14;026;Balzac;1371;26;1397
75;Nouvelle-Aquitaine;16;3;08;027;Barbezières;130;2;132
75;Nouvelle-Aquitaine;16;2;09;028;Barbezieux-Saint-Hilaire;4751;173;4924
75;Nouvelle-Aquitaine;16;1;17;029;Bardenac;225;5;230
75;Nouvelle-Aquitaine;16;2;09;030;Barret;1063;22;1085
75;Nouvelle-Aquitaine;16;3;08;031;Barro;409;11;420
75;Nouvelle-Aquitaine;16;2;15;032;Bassac;517;7;524
75;Nouvelle-Aquitaine;16;1;17;034;Bazac;145;2;147
75;Nouvelle-Aquitaine;16;3;06;035;Beaulieu-sur-Sonnette;197;5;202
75;Nouvelle-Aquitaine;16;2;09;036;Bécheresse;291;9;300
75;Nouvelle-Aquitaine;16;1;17;037;Bellon;140;5;145
75;Nouvelle-Aquitaine;16;3;06;038;Benest;307;8;315
75;Nouvelle-Aquitaine;16;3;08;039;Bernac;472;12;484
75;Nouvelle-Aquitaine;16;2;09;040;Berneuil;310;6;316
75;Nouvelle-Aquitaine;16;1;17;041;Bessac;113;1;114
75;Nouvelle-Aquitaine;16;3;08;042;Bessé;108;5;113
75;Nouvelle-Aquitaine;16;3;08;044;Bioussac;209;7;216
75;Nouvelle-Aquitaine;16;2;07;045;Birac;369;5;374
75;Nouvelle-Aquitaine;16;2;09;046;Coteaux-du-Blanzacais;997;16;1013
75;Nouvelle-Aquitaine;16;1;17;047;Blanzaguet-Saint-Cybard;287;7;294
75;Nouvelle-Aquitaine;16;2;09;048;Boisbreteau;127;0;127
75;Nouvelle-Aquitaine;16;1;17;049;Bonnes;368;8;376
75;Nouvelle-Aquitaine;16;2;07;050;Bonneuil;247;8;255
75;Nouvelle-Aquitaine;16;1;17;052;Bors (Canton de Tude-et-Lavalette);235;3;238
75;Nouvelle-Aquitaine;16;2;09;053;Bors (Canton de Charente-Sud);120;1;121
75;Nouvelle-Aquitaine;16;3;06;054;Le Bouchage;175;1;176
75;Nouvelle-Aquitaine;16;1;04;055;Bouëx;884;13;897
75;Nouvelle-Aquitaine;16;2;15;056;Bourg-Charente;884;16;900
75;Nouvelle-Aquitaine;16;2;07;057;Bouteville;322;6;328
75;Nouvelle-Aquitaine;16;2;11;058;Boutiers-Saint-Trojan;1405;50;1455
75;Nouvelle-Aquitaine;16;3;08;059;Brettes;166;6;172
75;Nouvelle-Aquitaine;16;2;11;060;Bréville;449;12;461
75;Nouvelle-Aquitaine;16;1;16;061;Brie;4222;80;4302
75;Nouvelle-Aquitaine;16;2;09;062;Brie-sous-Barbezieux;128;2;130
75;Nouvelle-Aquitaine;16;1;17;063;Brie-sous-Chalais;161;0;161
75;Nouvelle-Aquitaine;16;3;10;064;Brigueuil;1110;12;1122
75;Nouvelle-Aquitaine;16;3;10;065;Brillac;626;6;632
75;Nouvelle-Aquitaine;16;2;09;066;Brossac;462;9;471
75;Nouvelle-Aquitaine;16;1;19;067;Bunzac;464;9;473
75;Nouvelle-Aquitaine;16;3;05;068;Cellefrouin;571;6;577
75;Nouvelle-Aquitaine;16;3;05;069;Cellettes;385;3;388
75;Nouvelle-Aquitaine;16;3;10;070;Chabanais;1561;30;1591
75;Nouvelle-Aquitaine;16;3;10;071;Chabrac;598;15;613
75;Nouvelle-Aquitaine;16;1;17;072;Chadurie;513;10;523
75;Nouvelle-Aquitaine;16;1;17;073;Chalais;1786;30;1816
75;Nouvelle-Aquitaine;16;2;09;074;Challignac;336;8;344
75;Nouvelle-Aquitaine;16;2;09;075;Champagne-Vigny;241;4;245
75;Nouvelle-Aquitaine;16;3;06;076;Champagne-Mouton;879;9;888
75;Nouvelle-Aquitaine;16;2;18;077;Champmillon;482;9;491
75;Nouvelle-Aquitaine;16;1;14;078;Champniers;5155;116;5271
75;Nouvelle-Aquitaine;16;2;09;079;Chantillac;356;2;358
75;Nouvelle-Aquitaine;16;3;05;081;La Chapelle;215;5;220
75;Nouvelle-Aquitaine;16;1;17;082;Boisné-La Tude;667;13;680
75;Nouvelle-Aquitaine;16;3;08;083;Charmé;338;6;344
75;Nouvelle-Aquitaine;16;1;19;084;Charras;338;4;342
75;Nouvelle-Aquitaine;16;3;06;085;Chasseneuil-sur-Bonnieure;3100;281;3381
75;Nouvelle-Aquitaine;16;3;10;086;Chassenon;857;17;874
75;Nouvelle-Aquitaine;16;3;06;087;Chassiecq;144;4;148
75;Nouvelle-Aquitaine;16;2;15;088;Chassors;1097;38;1135
75;Nouvelle-Aquitaine;16;2;12;089;Châteaubernard;3766;65;3831
75;Nouvelle-Aquitaine;16;2;07;090;Châteauneuf-sur-Charente;3546;57;3603
75;Nouvelle-Aquitaine;16;1;17;091;Châtignac;172;2;174
75;Nouvelle-Aquitaine;16;1;19;093;Chazelles;1575;25;1600
75;Nouvelle-Aquitaine;16;3;05;095;Chenon;128;4;132
75;Nouvelle-Aquitaine;16;3;06;096;Cherves-Châtelars;420;3;423
75;Nouvelle-Aquitaine;16;2;11;097;Cherves-Richemont;2293;101;2394
75;Nouvelle-Aquitaine;16;3;08;098;La Chèvrerie;139;1;140
75;Nouvelle-Aquitaine;16;2;09;099;Chillac;223;1;224
75;Nouvelle-Aquitaine;16;3;10;100;Chirac;775;14;789
75;Nouvelle-Aquitaine;16;1;04;101;Claix;1064;18;1082
75;Nouvelle-Aquitaine;16;2;99;102;Cognac;18606;424;19030
75;Nouvelle-Aquitaine;16;1;17;103;Combiers;122;4;126
75;Nouvelle-Aquitaine;16;3;08;104;Condac;468;9;477
75;Nouvelle-Aquitaine;16;2;09;105;Condéon;616;16;632
75;Nouvelle-Aquitaine;16;3;10;106;Confolens;2720;153;2873
75;Nouvelle-Aquitaine;16;1;19;107;Coulgens;541;6;547
75;Nouvelle-Aquitaine;16;3;05;108;Coulonges;130;1;131
75;Nouvelle-Aquitaine;16;2;18;109;Courbillac;751;11;762
75;Nouvelle-Aquitaine;16;3;08;110;Courcôme;776;21;797
75;Nouvelle-Aquitaine;16;1;17;111;Courgeac;174;2;176
75;Nouvelle-Aquitaine;16;1;17;112;Courlac;57;2;59
75;Nouvelle-Aquitaine;16;1;13;113;La Couronne;7742;258;8000
75;Nouvelle-Aquitaine;16;3;08;114;Couture;167;3;170
75;Nouvelle-Aquitaine;16;2;07;116;Criteuil-la-Magdeleine;381;10;391
75;Nouvelle-Aquitaine;16;1;17;117;Curac;120;3;123
75;Nouvelle-Aquitaine;16;1;17;118;Deviat;135;0;135
75;Nouvelle-Aquitaine;16;1;04;119;Dignac;1356;15;1371
75;Nouvelle-Aquitaine;16;1;04;120;Dirac;1521;22;1543
75;Nouvelle-Aquitaine;16;2;18;121;Douzat;434;13;447
75;Nouvelle-Aquitaine;16;3;08;122;Ébréon;138;4;142
75;Nouvelle-Aquitaine;16;2;18;123;Échallat;483;10;493
75;Nouvelle-Aquitaine;16;1;19;124;Écuras;558;10;568
75;Nouvelle-Aquitaine;16;1;17;125;Édon;268;3;271
75;Nouvelle-Aquitaine;16;3;08;127;Empuré;94;3;97
75;Nouvelle-Aquitaine;16;3;10;128;Épenède;169;6;175
75;Nouvelle-Aquitaine;16;1;17;130;Les Essards;183;7;190
75;Nouvelle-Aquitaine;16;3;10;131;Esse;501;7;508
75;Nouvelle-Aquitaine;16;3;10;132;Étagnac;996;8;1004
75;Nouvelle-Aquitaine;16;2;09;133;Étriac;199;3;202
75;Nouvelle-Aquitaine;16;3;10;134;Exideuil-sur-Vienne;1013;26;1039
75;Nouvelle-Aquitaine;16;1;19;135;Eymouthiers;312;1;313
75;Nouvelle-Aquitaine;16;3;08;136;La Faye;572;12;584
75;Nouvelle-Aquitaine;16;1;19;137;Feuillade;303;2;305
75;Nouvelle-Aquitaine;16;1;01;138;Fléac;3865;105;3970
75;Nouvelle-Aquitaine;16;2;15;139;Fleurac;239;2;241
75;Nouvelle-Aquitaine;16;3;05;140;Fontclaireau;436;5;441
75;Nouvelle-Aquitaine;16;3;05;141;Fontenille;322;11;333
75;Nouvelle-Aquitaine;16;3;08;142;La Forêt-de-Tessé;205;4;209
75;Nouvelle-Aquitaine;16;1;17;143;Fouquebrune;704;13;717
75;Nouvelle-Aquitaine;16;3;08;144;Fouqueure;428;5;433
75;Nouvelle-Aquitaine;16;2;15;145;Foussignac;641;20;661
75;Nouvelle-Aquitaine;16;1;04;146;Garat;2124;34;2158
75;Nouvelle-Aquitaine;16;1;17;147;Gardes-le-Pontaroux;259;6;265
75;Nouvelle-Aquitaine;16;2;18;148;Genac-Bignac;999;20;1019
75;Nouvelle-Aquitaine;16;2;07;150;Gensac-la-Pallue;1589;42;1631
75;Nouvelle-Aquitaine;16;2;07;151;Genté;886;20;906
75;Nouvelle-Aquitaine;16;2;12;152;Gimeux;719;20;739
75;Nouvelle-Aquitaine;16;2;15;153;Mainxe-Gondeville;1171;22;1193
75;Nouvelle-Aquitaine;16;1;14;154;Gond-Pontouvre;6017;99;6116
75;Nouvelle-Aquitaine;16;3;08;155;Les Gours;105;3;108
75;Nouvelle-Aquitaine;16;3;06;157;Le Grand-Madieu;156;3;159
75;Nouvelle-Aquitaine;16;1;19;158;Grassac;305;5;310
75;Nouvelle-Aquitaine;16;2;09;160;Guimps;485;6;491
75;Nouvelle-Aquitaine;16;2;09;161;Guizengeard;163;4;167
75;Nouvelle-Aquitaine;16;1;17;162;Gurat;183;0;183
75;Nouvelle-Aquitaine;16;2;18;163;Hiersac;1152;22;1174
75;Nouvelle-Aquitaine;16;3;10;164;Hiesse;241;2;243
75;Nouvelle-Aquitaine;16;2;15;165;Houlette;376;6;382
75;Nouvelle-Aquitaine;16;1;02;166;L'Isle-d'Espagnac;5633;118;5751
75;Nouvelle-Aquitaine;16;2;15;167;Jarnac;4447;133;4580
75;Nouvelle-Aquitaine;16;1;16;168;Jauldes;816;7;823
75;Nouvelle-Aquitaine;16;2;12;169;Javrezac;569;11;580
75;Nouvelle-Aquitaine;16;1;17;170;Juignac;395;2;397
75;Nouvelle-Aquitaine;16;2;07;171;Juillac-le-Coq;652;14;666
75;Nouvelle-Aquitaine;16;3;05;173;Juillé;181;4;185
75;Nouvelle-Aquitaine;16;2;15;174;Julienne;516;11;527
75;Nouvelle-Aquitaine;16;2;09;175;Val des Vignes;1371;31;1402
75;Nouvelle-Aquitaine;16;2;09;176;Lachaise;299;7;306
75;Nouvelle-Aquitaine;16;2;09;177;Ladiville;118;2;120
75;Nouvelle-Aquitaine;16;2;09;178;Lagarde-sur-le-Né;187;5;192
75;Nouvelle-Aquitaine;16;1;17;180;Laprade;247;6;253
75;Nouvelle-Aquitaine;16;3;10;181;Lessac;521;11;532
75;Nouvelle-Aquitaine;16;3;10;182;Lesterps;444;13;457
75;Nouvelle-Aquitaine;16;3;06;183;Lésignac-Durand;173;4;177
75;Nouvelle-Aquitaine;16;3;05;184;Lichères;86;1;87
75;Nouvelle-Aquitaine;16;3;08;185;Ligné;154;2;156
75;Nouvelle-Aquitaine;16;2;07;186;Lignières-Ambleville;712;21;733
75;Nouvelle-Aquitaine;16;1;18;187;Linars;2096;48;2144
75;Nouvelle-Aquitaine;16;3;06;188;Le Lindois;339;4;343
75;Nouvelle-Aquitaine;16;3;08;189;Londigny;254;6;260
75;Nouvelle-Aquitaine;16;3;08;190;Longré;186;6;192
75;Nouvelle-Aquitaine;16;3;05;191;Lonnes;181;1;182
75;Nouvelle-Aquitaine;16;3;89;192;Terres-de-Haute-Charente;3867;104;3971
75;Nouvelle-Aquitaine;16;2;11;193;Louzac-Saint-André;991;16;1007
75;Nouvelle-Aquitaine;16;3;08;194;Lupsault;110;1;111
75;Nouvelle-Aquitaine;16;3;06;195;Lussac;294;8;302
75;Nouvelle-Aquitaine;16;3;05;196;Luxé;720;8;728
75;Nouvelle-Aquitaine;16;3;08;197;La Magdeleine;114;7;121
75;Nouvelle-Aquitaine;16;1;17;198;Magnac-Lavalette-Villars;459;4;463
75;Nouvelle-Aquitaine;16;1;16;199;Magnac-sur-Touvre;3223;63;3286
75;Nouvelle-Aquitaine;16;3;05;200;Maine-de-Boixe;481;4;485
75;Nouvelle-Aquitaine;16;1;19;203;Mainzac;119;0;119
75;Nouvelle-Aquitaine;16;2;07;204;Bellevigne;1282;33;1315
75;Nouvelle-Aquitaine;16;3;10;205;Manot;535;5;540
75;Nouvelle-Aquitaine;16;3;05;206;Mansle;1681;20;1701
75;Nouvelle-Aquitaine;16;2;18;207;Marcillac-Lanville;486;9;495
75;Nouvelle-Aquitaine;16;2;18;208;Mareuil;393;4;397
75;Nouvelle-Aquitaine;16;1;19;209;Marillac-le-Franc;824;19;843
75;Nouvelle-Aquitaine;16;1;18;210;Marsac;815;8;823
75;Nouvelle-Aquitaine;16;1;19;211;Marthon;560;6;566
75;Nouvelle-Aquitaine;16;3;06;212;Massignac;389;6;395
75;Nouvelle-Aquitaine;16;3;06;213;Mazerolles;297;5;302
75;Nouvelle-Aquitaine;16;1;17;215;Médillac;154;5;159
75;Nouvelle-Aquitaine;16;2;15;216;Mérignac;833;14;847
75;Nouvelle-Aquitaine;16;2;12;217;Merpins;1100;24;1124
75;Nouvelle-Aquitaine;16;2;11;218;Mesnac;411;13;424
75;Nouvelle-Aquitaine;16;2;15;220;Les Métairies;720;15;735
75;Nouvelle-Aquitaine;16;2;18;221;Mons;234;3;237
75;Nouvelle-Aquitaine;16;1;17;222;Montboyer;323;5;328
75;Nouvelle-Aquitaine;16;1;19;223;Montbron;2001;30;2031
75;Nouvelle-Aquitaine;16;2;09;224;Montmérac;717;18;735
75;Nouvelle-Aquitaine;16;3;06;225;Montembœuf;653;30;683
75;Nouvelle-Aquitaine;16;3;05;226;Montignac-Charente;712;9;721
75;Nouvelle-Aquitaine;16;1;17;227;Montignac-le-Coq;140;0;140
75;Nouvelle-Aquitaine;16;3;08;229;Montjean;244;4;248
75;Nouvelle-Aquitaine;16;1;17;230;Montmoreau;2517;87;2604
75;Nouvelle-Aquitaine;16;3;10;231;Montrollet;324;2;326
75;Nouvelle-Aquitaine;16;1;16;232;Mornac;2137;48;2185
75;Nouvelle-Aquitaine;16;2;07;233;Mosnac-Saint-Simeux;1002;17;1019
75;Nouvelle-Aquitaine;16;2;18;234;Moulidars;708;12;720
75;Nouvelle-Aquitaine;16;1;04;236;Mouthiers-sur-Boëme;2377;73;2450
75;Nouvelle-Aquitaine;16;3;05;237;Mouton;222;2;224
75;Nouvelle-Aquitaine;16;3;05;238;Moutonneau;118;0;118
75;Nouvelle-Aquitaine;16;3;06;239;Mouzon;136;2;138
75;Nouvelle-Aquitaine;16;1;17;240;Nabinaud;100;0;100
75;Nouvelle-Aquitaine;16;3;05;241;Nanclars;207;4;211
75;Nouvelle-Aquitaine;16;3;08;242;Nanteuil-en-Vallée;1381;17;1398
75;Nouvelle-Aquitaine;16;2;15;243;Nercillac;1047;21;1068
75;Nouvelle-Aquitaine;16;1;13;244;Nersac;2314;53;2367
75;Nouvelle-Aquitaine;16;3;06;245;Nieuil;918;14;932
75;Nouvelle-Aquitaine;16;1;17;246;Nonac;256;8;264
75;Nouvelle-Aquitaine;16;3;08;248;Oradour;150;2;152
75;Nouvelle-Aquitaine;16;3;10;249;Oradour-Fanais;385;3;388
75;Nouvelle-Aquitaine;16;1;19;250;Orgedeuil;216;2;218
75;Nouvelle-Aquitaine;16;2;09;251;Oriolles;250;7;257
75;Nouvelle-Aquitaine;16;1;17;252;Orival;151;1;152
75;Nouvelle-Aquitaine;16;3;08;253;Paizay-Naudouin-Embourie;362;3;365
75;Nouvelle-Aquitaine;16;1;17;254;Palluaud;217;8;225
75;Nouvelle-Aquitaine;16;3;06;255;Parzac;139;5;144
75;Nouvelle-Aquitaine;16;2;09;256;Passirac;244;4;248
75;Nouvelle-Aquitaine;16;2;09;258;Pérignac;494;9;503
75;Nouvelle-Aquitaine;16;1;17;260;Pillac;273;7;280
75;Nouvelle-Aquitaine;16;3;06;261;Les Pins;479;14;493
75;Nouvelle-Aquitaine;16;1;04;263;Plassac-Rouffiac;396;5;401
75;Nouvelle-Aquitaine;16;3;10;264;Pleuville;320;6;326
75;Nouvelle-Aquitaine;16;1;17;267;Poullignac;94;1;95
75;Nouvelle-Aquitaine;16;3;08;268;Poursac;214;2;216
75;Nouvelle-Aquitaine;16;1;19;269;Pranzac;902;11;913
75;Nouvelle-Aquitaine;16;3;10;270;Pressignac;340;5;345
75;Nouvelle-Aquitaine;16;1;13;271;Puymoyen;2382;133;2515
75;Nouvelle-Aquitaine;16;3;05;272;Puyréaux;555;9;564
75;Nouvelle-Aquitaine;16;3;08;273;Raix;121;6;127
75;Nouvelle-Aquitaine;16;3;08;275;Ranville-Breuillaud;177;2;179
75;Nouvelle-Aquitaine;16;2;09;276;Reignac;741;11;752
75;Nouvelle-Aquitaine;16;2;15;277;Réparsac;589;11;600
75;Nouvelle-Aquitaine;16;1;17;279;Rioux-Martin;225;3;228
75;Nouvelle-Aquitaine;16;1;19;280;Rivières;2007;29;2036
75;Nouvelle-Aquitaine;16;1;19;281;La Rochefoucauld-en-Angoumois;3984;129;4113
75;Nouvelle-Aquitaine;16;1;19;282;La Rochette;533;11;544
75;Nouvelle-Aquitaine;16;1;17;283;Ronsenac;570;8;578
75;Nouvelle-Aquitaine;16;1;17;284;Rouffiac;120;1;121
75;Nouvelle-Aquitaine;16;1;17;285;Rougnac;406;5;411
75;Nouvelle-Aquitaine;16;2;18;286;Rouillac;2940;43;2983
75;Nouvelle-Aquitaine;16;1;04;287;Roullet-Saint-Estèphe;4295;68;4363
75;Nouvelle-Aquitaine;16;3;06;289;Roussines;299;3;302
75;Nouvelle-Aquitaine;16;1;19;290;Rouzède;239;2;241
75;Nouvelle-Aquitaine;16;1;16;291;Ruelle-sur-Touvre;7364;195;7559
75;Nouvelle-Aquitaine;16;3;08;292;Ruffec;3370;150;3520
75;Nouvelle-Aquitaine;16;1;19;293;Saint-Adjutory;491;6;497
75;Nouvelle-Aquitaine;16;3;05;295;Saint-Amant-de-Boixe;1322;24;1346
75;Nouvelle-Aquitaine;16;2;07;297;Graves-Saint-Amant;327;9;336
75;Nouvelle-Aquitaine;16;2;18;298;Saint-Amant-de-Nouère;357;5;362
75;Nouvelle-Aquitaine;16;3;05;300;Val-de-Bonnieure;1318;12;1330
75;Nouvelle-Aquitaine;16;2;09;301;Saint-Aulais-la-Chapelle;226;4;230
75;Nouvelle-Aquitaine;16;1;17;302;Saint-Avit;217;2;219
75;Nouvelle-Aquitaine;16;2;09;303;Saint-Bonnet;406;12;418
75;Nouvelle-Aquitaine;16;2;11;304;Saint-Brice;965;19;984
75;Nouvelle-Aquitaine;16;3;10;306;Saint-Christophe;314;8;322
75;Nouvelle-Aquitaine;16;3;05;307;Saint-Ciers-sur-Bonnieure;327;12;339
75;Nouvelle-Aquitaine;16;3;06;308;Saint-Claud;1047;19;1066
75;Nouvelle-Aquitaine;16;3;06;310;Saint-Coutant;215;2;217
75;Nouvelle-Aquitaine;16;2;18;312;Saint-Cybardeaux;821;12;833
75;Nouvelle-Aquitaine;16;2;09;315;Saint-Félix;105;0;105
75;Nouvelle-Aquitaine;16;2;07;316;Saint-Fort-sur-le-Né;386;6;392
75;Nouvelle-Aquitaine;16;3;08;317;Saint-Fraigne;436;2;438
75;Nouvelle-Aquitaine;16;3;05;318;Saint-Front;364;2;366
75;Nouvelle-Aquitaine;16;2;18;320;Saint-Genis-d'Hiersac;895;14;909
75;Nouvelle-Aquitaine;16;3;08;321;Saint-Georges;45;0;45
75;Nouvelle-Aquitaine;16;1;19;323;Saint-Germain-de-Montbron;468;10;478
75;Nouvelle-Aquitaine;16;3;08;325;Saint-Gourson;128;3;131
75;Nouvelle-Aquitaine;16;3;05;326;Saint-Groux;134;0;134
75;Nouvelle-Aquitaine;16;3;06;329;Saint-Laurent-de-Céris;763;11;774
75;Nouvelle-Aquitaine;16;2;12;330;Saint-Laurent-de-Cognac;824;28;852
75;Nouvelle-Aquitaine;16;1;17;331;Saint-Laurent-des-Combes;90;2;92
75;Nouvelle-Aquitaine;16;1;17;334;Saint-Martial;123;3;126
75;Nouvelle-Aquitaine;16;3;08;335;Saint-Martin-du-Clocher;124;3;127
75;Nouvelle-Aquitaine;16;3;06;336;Saint-Mary;343;2;345
75;Nouvelle-Aquitaine;16;3;10;337;Saint-Maurice-des-Lions;899;30;929
75;Nouvelle-Aquitaine;16;2;09;338;Saint-Médard;315;5;320
75;Nouvelle-Aquitaine;16;2;18;339;Val-d'Auge;802;16;818
75;Nouvelle-Aquitaine;16;2;15;340;Saint-Même-les-Carrières;1028;27;1055
75;Nouvelle-Aquitaine;16;1;13;341;Saint-Michel;3225;38;3263
75;Nouvelle-Aquitaine;16;2;09;342;Saint-Palais-du-Né;304;7;311
75;Nouvelle-Aquitaine;16;2;07;343;Saint-Preuil;295;9;304
75;Nouvelle-Aquitaine;16;3;10;345;Saint-Quentin-sur-Charente;212;5;217
75;Nouvelle-Aquitaine;16;1;17;346;Saint-Quentin-de-Chalais;247;9;256
75;Nouvelle-Aquitaine;16;1;17;347;Saint-Romain;511;11;522
75;Nouvelle-Aquitaine;16;1;18;348;Saint-Saturnin;1288;33;1321
75;Nouvelle-Aquitaine;16;2;15;349;Sainte-Sévère;508;11;519
75;Nouvelle-Aquitaine;16;1;17;350;Saint-Séverin;803;10;813
75;Nouvelle-Aquitaine;16;2;07;352;Saint-Simon;223;8;231
75;Nouvelle-Aquitaine;16;1;19;353;Saint-Sornin;802;11;813
75;Nouvelle-Aquitaine;16;2;09;354;Sainte-Souline;124;3;127
75;Nouvelle-Aquitaine;16;2;11;355;Saint-Sulpice-de-Cognac;1186;16;1202
75;Nouvelle-Aquitaine;16;3;08;356;Saint-Sulpice-de-Ruffec;32;0;32
75;Nouvelle-Aquitaine;16;2;09;357;Saint-Vallier;138;2;140
75;Nouvelle-Aquitaine;16;1;14;358;Saint-Yrieix-sur-Charente;7499;241;7740
75;Nouvelle-Aquitaine;16;2;07;359;Salles-d'Angles;1010;27;1037
75;Nouvelle-Aquitaine;16;2;09;360;Salles-de-Barbezieux;403;85;488
75;Nouvelle-Aquitaine;16;3;08;361;Salles-de-Villefagnan;313;6;319
75;Nouvelle-Aquitaine;16;1;17;362;Salles-Lavalette;321;12;333
75;Nouvelle-Aquitaine;16;3;10;363;Saulgond;529;9;538
75;Nouvelle-Aquitaine;16;3;06;364;Sauvagnac;66;2;68
75;Nouvelle-Aquitaine;16;2;09;365;Sauvignac;103;2;105
75;Nouvelle-Aquitaine;16;2;07;366;Segonzac;2076;77;2153
75;Nouvelle-Aquitaine;16;1;04;368;Sers;895;20;915
75;Nouvelle-Aquitaine;16;2;15;369;Sigogne;976;21;997
75;Nouvelle-Aquitaine;16;1;18;370;Sireuil;1157;40;1197
75;Nouvelle-Aquitaine;16;1;19;372;Souffrignac;135;1;136
75;Nouvelle-Aquitaine;16;3;08;373;Souvigné;192;6;198
75;Nouvelle-Aquitaine;16;1;03;374;Soyaux;9969;309;10278
75;Nouvelle-Aquitaine;16;3;06;375;Suaux;384;6;390
75;Nouvelle-Aquitaine;16;3;05;377;La Tâche;112;2;114
75;Nouvelle-Aquitaine;16;3;08;378;Taizé-Aizie;573;15;588
75;Nouvelle-Aquitaine;16;1;19;379;Taponnat-Fleurignac;1477;27;1504
75;Nouvelle-Aquitaine;16;2;09;380;Le Tâtre;417;3;420
75;Nouvelle-Aquitaine;16;3;08;381;Theil-Rabier;166;2;168
75;Nouvelle-Aquitaine;16;1;04;382;Torsac;718;30;748
75;Nouvelle-Aquitaine;16;3;05;383;Tourriers;774;10;784
75;Nouvelle-Aquitaine;16;2;09;384;Touvérac;565;7;572
75;Nouvelle-Aquitaine;16;1;16;385;Touvre;1151;27;1178
75;Nouvelle-Aquitaine;16;2;15;387;Triac-Lautrait;463;60;523
75;Nouvelle-Aquitaine;16;1;18;388;Trois-Palis;933;22;955
75;Nouvelle-Aquitaine;16;3;06;389;Turgon;85;3;88
75;Nouvelle-Aquitaine;16;3;08;390;Tusson;228;11;239
75;Nouvelle-Aquitaine;16;3;05;392;Valence;185;5;190
75;Nouvelle-Aquitaine;16;3;05;393;Vars;2166;31;2197
75;Nouvelle-Aquitaine;16;1;17;394;Vaux-Lavalette;82;2;84
75;Nouvelle-Aquitaine;16;2;18;395;Vaux-Rouillac;298;3;301
75;Nouvelle-Aquitaine;16;3;05;396;Ventouse;123;0;123
75;Nouvelle-Aquitaine;16;3;08;397;Verdille;381;7;388
75;Nouvelle-Aquitaine;16;3;06;398;Verneuil;99;5;104
75;Nouvelle-Aquitaine;16;2;07;399;Verrières;344;9;353
75;Nouvelle-Aquitaine;16;3;08;400;Verteuil-sur-Charente;603;11;614
75;Nouvelle-Aquitaine;16;3;05;401;Vervant;146;2;148
75;Nouvelle-Aquitaine;16;2;07;402;Vibrac;284;5;289
75;Nouvelle-Aquitaine;16;3;06;403;Le Vieux-Cérier;129;0;129
75;Nouvelle-Aquitaine;16;3;06;404;Vieux-Ruffec;111;2;113
75;Nouvelle-Aquitaine;16;2;09;405;Vignolles;163;10;173
75;Nouvelle-Aquitaine;16;1;19;406;Moulins-sur-Tardoire;781;13;794
75;Nouvelle-Aquitaine;16;1;17;408;Villebois-Lavalette;714;19;733
75;Nouvelle-Aquitaine;16;3;08;409;Villefagnan;993;11;1004
75;Nouvelle-Aquitaine;16;3;05;412;Villejoubert;338;1;339
75;Nouvelle-Aquitaine;16;3;08;413;Villiers-le-Roux;135;2;137
75;Nouvelle-Aquitaine;16;3;05;414;Villognon;318;3;321
75;Nouvelle-Aquitaine;16;1;18;415;Vindelle;1081;23;1104
75;Nouvelle-Aquitaine;16;3;06;416;Vitrac-Saint-Vincent;499;8;507
75;Nouvelle-Aquitaine;16;1;04;418;Vœuil-et-Giget;1555;30;1585
75;Nouvelle-Aquitaine;16;3;05;419;Vouharte;326;2;328
75;Nouvelle-Aquitaine;16;1;04;420;Voulgézac;238;4;242
75;Nouvelle-Aquitaine;16;1;19;421;Vouthon;412;5;417
75;Nouvelle-Aquitaine;16;1;04;422;Vouzan;829;8;837
75;Nouvelle-Aquitaine;16;3;05;423;Xambes;247;2;249
75;Nouvelle-Aquitaine;16;1;17;424;Yviers;533;8;541
75;Nouvelle-Aquitaine;16;1;19;425;Yvrac-et-Malleyrand;559;9;568
75;Nouvelle-Aquitaine;17;1;07;002;Agudelle;133;4;137
75;Nouvelle-Aquitaine;17;2;23;003;Aigrefeuille-d'Aunis;4343;74;4417
75;Nouvelle-Aquitaine;17;2;03;004;Île-d'Aix;209;4;213
75;Nouvelle-Aquitaine;17;1;07;005;Allas-Bocage;196;1;197
75;Nouvelle-Aquitaine;17;1;07;006;Allas-Champagne;250;4;254
75;Nouvelle-Aquitaine;17;2;06;007;Anais;316;7;323
75;Nouvelle-Aquitaine;17;3;09;008;Andilly;2295;37;2332
75;Nouvelle-Aquitaine;17;3;09;009;Angliers;1204;11;1215
75;Nouvelle-Aquitaine;17;3;03;010;Angoulins;4063;100;4163
75;Nouvelle-Aquitaine;17;5;18;011;Annepont;395;4;399
75;Nouvelle-Aquitaine;17;5;18;012;Annezay;155;5;160
75;Nouvelle-Aquitaine;17;5;11;013;Antezant-la-Chapelle;348;4;352
75;Nouvelle-Aquitaine;17;4;21;015;Arces;745;10;755
75;Nouvelle-Aquitaine;17;1;07;016;Archiac;775;12;787
75;Nouvelle-Aquitaine;17;5;18;017;Archingeay;702;5;707
75;Nouvelle-Aquitaine;17;2;23;018;Ardillières;856;13;869
75;Nouvelle-Aquitaine;17;3;05;019;Ars-en-Ré;1302;24;1326
75;Nouvelle-Aquitaine;17;1;07;020;Arthenac;350;4;354
75;Nouvelle-Aquitaine;17;2;26;021;Arvert;3672;74;3746
75;Nouvelle-Aquitaine;17;5;11;022;Asnières-la-Giraud;984;25;1009
75;Nouvelle-Aquitaine;17;5;02;023;Aujac;374;7;381
75;Nouvelle-Aquitaine;17;5;11;024;Aulnay;1324;23;1347
75;Nouvelle-Aquitaine;17;5;02;025;Aumagne;703;29;732
75;Nouvelle-Aquitaine;17;5;02;026;Authon-Ébéon;390;5;395
75;Nouvelle-Aquitaine;17;1;12;027;Avy;470;7;477
75;Nouvelle-Aquitaine;17;3;01;028;Aytré;9397;148;9545
75;Nouvelle-Aquitaine;17;5;11;029;Bagnizeau;199;3;202
75;Nouvelle-Aquitaine;17;4;19;030;Balanzac;559;5;564
75;Nouvelle-Aquitaine;17;5;11;031;Ballans;198;3;201
75;Nouvelle-Aquitaine;17;2;23;032;Ballon;809;17;826
75;Nouvelle-Aquitaine;17;1;27;033;La Barde;496;5;501
75;Nouvelle-Aquitaine;17;4;21;034;Barzan;459;7;466
75;Nouvelle-Aquitaine;17;5;11;035;Bazauges;109;4;113
75;Nouvelle-Aquitaine;17;2;10;036;Beaugeay;780;14;794
75;Nouvelle-Aquitaine;17;5;11;037;Beauvais-sur-Matha;651;9;660
75;Nouvelle-Aquitaine;17;1;27;038;Bedenac;693;6;699
75;Nouvelle-Aquitaine;17;1;12;039;Belluire;214;1;215
75;Nouvelle-Aquitaine;17;3;09;041;Benon;1715;16;1731
75;Nouvelle-Aquitaine;17;5;02;042;Bercloux;445;10;455
75;Nouvelle-Aquitaine;17;5;18;043;Bernay-Saint-Martin;744;13;757
75;Nouvelle-Aquitaine;17;4;24;044;Berneuil;1149;23;1172
75;Nouvelle-Aquitaine;17;4;19;045;Beurlay;1022;17;1039
75;Nouvelle-Aquitaine;17;5;18;046;Bignay;375;6;381
75;Nouvelle-Aquitaine;17;1;12;047;Biron;237;1;238
75;Nouvelle-Aquitaine;17;5;11;048;Blanzac-lès-Matha;321;4;325
75;Nouvelle-Aquitaine;17;5;11;049;Blanzay-sur-Boutonne;78;5;83
75;Nouvelle-Aquitaine;17;1;12;050;Bois;519;145;664
75;Nouvelle-Aquitaine;17;3;05;051;Le Bois-Plage-en-Ré;2280;30;2310
75;Nouvelle-Aquitaine;17;1;12;052;Boisredon;700;4;704
75;Nouvelle-Aquitaine;17;5;18;053;Bords;1317;26;1343
75;Nouvelle-Aquitaine;17;1;27;054;Boresse-et-Martron;203;9;212
75;Nouvelle-Aquitaine;17;1;27;055;Boscamnant;348;4;352
75;Nouvelle-Aquitaine;17;1;12;056;Bougneau;612;13;625
75;Nouvelle-Aquitaine;17;2;06;057;Bouhet;911;16;927
75;Nouvelle-Aquitaine;17;2;10;058;Bourcefranc-le-Chapus;3515;129;3644
75;Nouvelle-Aquitaine;17;3;06;059;Bourgneuf;1394;25;1419
75;Nouvelle-Aquitaine;17;4;21;060;Boutenac-Touvent;229;2;231
75;Nouvelle-Aquitaine;17;1;27;061;Bran;139;2;141
75;Nouvelle-Aquitaine;17;5;11;062;Bresdon;220;1;221
75;Nouvelle-Aquitaine;17;2;23;063;Breuil-la-Réorte;460;11;471
75;Nouvelle-Aquitaine;17;2;26;064;Breuillet;3031;64;3095
75;Nouvelle-Aquitaine;17;2;25;065;Breuil-Magné;1823;54;1877
75;Nouvelle-Aquitaine;17;1;07;066;Brie-sous-Archiac;232;3;235
75;Nouvelle-Aquitaine;17;5;11;067;Brie-sous-Matha;172;4;176
75;Nouvelle-Aquitaine;17;4;21;068;Brie-sous-Mortagne;246;3;249
75;Nouvelle-Aquitaine;17;1;24;069;Brives-sur-Charente;231;7;238
75;Nouvelle-Aquitaine;17;5;02;070;Brizambourg;940;15;955
75;Nouvelle-Aquitaine;17;5;11;071;La Brousse;513;8;521
75;Nouvelle-Aquitaine;17;4;02;072;Burie;1324;26;1350
75;Nouvelle-Aquitaine;17;4;02;073;Bussac-sur-Charente;1282;44;1326
75;Nouvelle-Aquitaine;17;1;27;074;Bussac-Forêt;1069;16;1085
75;Nouvelle-Aquitaine;17;2;25;075;Cabariot;1422;23;1445
75;Nouvelle-Aquitaine;17;1;07;076;Celles;321;3;324
75;Nouvelle-Aquitaine;17;1;27;077;Cercoux;1267;20;1287
75;Nouvelle-Aquitaine;17;1;12;078;Chadenac;514;8;522
75;Nouvelle-Aquitaine;17;2;26;079;Chaillevette;1628;33;1661
75;Nouvelle-Aquitaine;17;2;23;080;Chambon;978;12;990
75;Nouvelle-Aquitaine;17;1;27;081;Chamouillac;369;7;376
75;Nouvelle-Aquitaine;17;1;07;082;Champagnac;516;16;532
75;Nouvelle-Aquitaine;17;2;10;083;Champagne;620;12;632
75;Nouvelle-Aquitaine;17;1;12;084;Champagnolles;683;8;691
75;Nouvelle-Aquitaine;17;5;18;085;Champdolent;407;5;412
75;Nouvelle-Aquitaine;17;4;02;086;Chaniers;3585;82;3667
75;Nouvelle-Aquitaine;17;5;18;087;Chantemerle-sur-la-Soie;207;1;208
75;Nouvelle-Aquitaine;17;4;02;089;La Chapelle-des-Pots;1005;25;1030
75;Nouvelle-Aquitaine;17;3;09;091;Charron;2007;27;2034
75;Nouvelle-Aquitaine;17;1;27;092;Chartuzac;164;4;168
75;Nouvelle-Aquitaine;17;2;04;093;Le Château-d'Oléron;4312;79;4391
75;Nouvelle-Aquitaine;17;3;03;094;Châtelaillon-Plage;6024;94;6118
75;Nouvelle-Aquitaine;17;1;27;095;Chatenet;213;6;219
75;Nouvelle-Aquitaine;17;1;07;096;Chaunac;77;2;79
75;Nouvelle-Aquitaine;17;4;22;097;Le Chay;798;28;826
75;Nouvelle-Aquitaine;17;4;21;098;Chenac-Saint-Seurin-d'Uzet;592;13;605
75;Nouvelle-Aquitaine;17;1;27;099;Chepniers;655;7;662
75;Nouvelle-Aquitaine;17;4;02;100;Chérac;1125;17;1142
75;Nouvelle-Aquitaine;17;5;11;101;Cherbonnières;327;1;328
75;Nouvelle-Aquitaine;17;4;24;102;Chermignac;1271;36;1307
75;Nouvelle-Aquitaine;17;1;27;104;Chevanceaux;1099;106;1205
75;Nouvelle-Aquitaine;17;5;11;105;Chives;311;1;312
75;Nouvelle-Aquitaine;17;1;07;106;Cierzac;316;5;321
75;Nouvelle-Aquitaine;17;2;23;107;Ciré-d'Aunis;1509;25;1534
75;Nouvelle-Aquitaine;17;1;07;108;Clam;411;15;426
75;Nouvelle-Aquitaine;17;3;06;109;Clavette;1458;20;1478
75;Nouvelle-Aquitaine;17;1;27;110;Clérac;975;15;990
75;Nouvelle-Aquitaine;17;1;07;111;Clion;829;11;840
75;Nouvelle-Aquitaine;17;4;24;112;La Clisse;714;16;730
75;Nouvelle-Aquitaine;17;1;27;113;La Clotte;713;8;721
75;Nouvelle-Aquitaine;17;5;11;114;Coivert;207;2;209
75;Nouvelle-Aquitaine;17;4;24;115;Colombiers;305;7;312
75;Nouvelle-Aquitaine;17;1;07;116;Consac;232;5;237
75;Nouvelle-Aquitaine;17;5;11;117;Contré;138;0;138
75;Nouvelle-Aquitaine;17;1;27;118;Corignac;333;2;335
75;Nouvelle-Aquitaine;17;4;22;119;Corme-Écluse;1177;22;1199
75;Nouvelle-Aquitaine;17;4;24;120;Corme-Royal;1908;28;1936
75;Nouvelle-Aquitaine;17;3;05;121;La Couarde-sur-Mer;1103;18;1121
75;Nouvelle-Aquitaine;17;1;24;122;Coulonges;233;4;237
75;Nouvelle-Aquitaine;17;5;18;124;Courant;431;4;435
75;Nouvelle-Aquitaine;17;5;11;125;Courcelles;457;10;467
75;Nouvelle-Aquitaine;17;5;11;126;Courcerac;302;6;308
75;Nouvelle-Aquitaine;17;3;09;127;Courçon;1879;27;1906
75;Nouvelle-Aquitaine;17;4;24;128;Courcoury;700;12;712
75;Nouvelle-Aquitaine;17;1;12;129;Courpignac;418;6;424
75;Nouvelle-Aquitaine;17;1;27;130;Coux;476;13;489
75;Nouvelle-Aquitaine;17;4;21;131;Cozes;2144;44;2188
75;Nouvelle-Aquitaine;17;3;09;132;Cramchaban;648;18;666
75;Nouvelle-Aquitaine;17;4;21;133;Cravans;878;76;954
75;Nouvelle-Aquitaine;17;4;19;134;Crazannes;436;8;444
75;Nouvelle-Aquitaine;17;5;11;135;Cressé;222;2;224
75;Nouvelle-Aquitaine;17;3;06;136;Croix-Chapeau;1298;29;1327
75;Nouvelle-Aquitaine;17;5;18;137;La Croix-Comtesse;223;3;226
75;Nouvelle-Aquitaine;17;5;11;138;Dampierre-sur-Boutonne;279;7;286
75;Nouvelle-Aquitaine;17;5;18;139;Dœuil-sur-le-Mignon;348;4;352
75;Nouvelle-Aquitaine;17;2;04;140;Dolus-d'Oléron;3142;66;3208
75;Nouvelle-Aquitaine;17;4;02;141;Dompierre-sur-Charente;474;9;483
75;Nouvelle-Aquitaine;17;3;01;142;Dompierre-sur-Mer;5803;147;5950
75;Nouvelle-Aquitaine;17;4;02;143;Le Douhet;700;13;713
75;Nouvelle-Aquitaine;17;1;12;145;Échebrune;485;8;493
75;Nouvelle-Aquitaine;17;2;25;146;Échillais;3548;68;3616
75;Nouvelle-Aquitaine;17;4;02;147;Écoyeux;1386;21;1407
75;Nouvelle-Aquitaine;17;4;19;148;Écurat;453;10;463
75;Nouvelle-Aquitaine;17;5;11;149;Les Éduts;60;2;62
75;Nouvelle-Aquitaine;17;5;11;150;Les Églises-d'Argenteuil;525;7;532
75;Nouvelle-Aquitaine;17;2;22;151;L'Éguille;887;16;903
75;Nouvelle-Aquitaine;17;4;21;152;Épargnes;880;8;888
75;Nouvelle-Aquitaine;17;3;08;153;Esnandes;2079;32;2111
75;Nouvelle-Aquitaine;17;4;19;154;Les Essards;718;8;726
75;Nouvelle-Aquitaine;17;2;26;155;Étaules;2667;43;2710
75;Nouvelle-Aquitaine;17;1;27;156;Expiremont;135;3;138
75;Nouvelle-Aquitaine;17;5;18;157;Fenioux;162;2;164
75;Nouvelle-Aquitaine;17;3;09;158;Ferrières;1183;8;1191
75;Nouvelle-Aquitaine;17;1;12;159;Fléac-sur-Seugne;361;7;368
75;Nouvelle-Aquitaine;17;4;21;160;Floirac;433;13;446
75;Nouvelle-Aquitaine;17;3;05;161;La Flotte;2903;48;2951
75;Nouvelle-Aquitaine;17;5;11;162;Fontaine-Chalendray;197;1;198
75;Nouvelle-Aquitaine;17;1;07;163;Fontaines-d'Ozillac;511;10;521
75;Nouvelle-Aquitaine;17;4;02;164;Fontcouverte;2317;54;2371
75;Nouvelle-Aquitaine;17;5;11;165;Fontenet;391;13;404
75;Nouvelle-Aquitaine;17;2;23;166;Forges;1321;13;1334
75;Nouvelle-Aquitaine;17;1;27;167;Le Fouilloux;770;11;781
75;Nouvelle-Aquitaine;17;2;03;168;Fouras;3998;71;4069
75;Nouvelle-Aquitaine;17;4;19;171;Geay;772;11;783
75;Nouvelle-Aquitaine;17;4;21;172;Gémozac;2945;37;2982
75;Nouvelle-Aquitaine;17;1;27;173;La Genétouze;229;4;233
75;Nouvelle-Aquitaine;17;2;25;174;Genouillé;922;10;932
75;Nouvelle-Aquitaine;17;1;07;175;Germignac;647;8;655
75;Nouvelle-Aquitaine;17;5;11;176;Gibourne;104;4;108
75;Nouvelle-Aquitaine;17;5;11;177;Le Gicq;117;0;117
75;Nouvelle-Aquitaine;17;1;12;178;Givrezac;72;1;73
75;Nouvelle-Aquitaine;17;4;24;179;Les Gonds;1793;88;1881
75;Nouvelle-Aquitaine;17;5;11;180;Gourvillette;88;4;92
75;Nouvelle-Aquitaine;17;5;18;181;Grandjean;315;6;321
75;Nouvelle-Aquitaine;17;3;09;182;La Grève-sur-Mignon;549;11;560
75;Nouvelle-Aquitaine;17;4;21;183;Grézac;943;13;956
75;Nouvelle-Aquitaine;17;2;10;184;La Gripperie-Saint-Symphorien;585;12;597
75;Nouvelle-Aquitaine;17;2;10;185;Le Gua;2103;34;2137
75;Nouvelle-Aquitaine;17;3;09;186;Le Gué-d'Alleré;968;11;979
75;Nouvelle-Aquitaine;17;1;07;187;Guitinières;495;16;511
75;Nouvelle-Aquitaine;17;5;11;188;Haimps;454;10;464
75;Nouvelle-Aquitaine;17;3;08;190;L'Houmeau;2861;56;2917
75;Nouvelle-Aquitaine;17;4;24;191;La Jard;429;9;438
75;Nouvelle-Aquitaine;17;1;07;192;Jarnac-Champagne;859;19;878
75;Nouvelle-Aquitaine;17;3;06;193;La Jarne;2567;55;2622
75;Nouvelle-Aquitaine;17;3;06;194;La Jarrie;3371;75;3446
75;Nouvelle-Aquitaine;17;5;18;195;La Jarrie-Audouin;278;3;281
75;Nouvelle-Aquitaine;17;4;21;196;Jazennes;546;15;561
75;Nouvelle-Aquitaine;17;1;07;197;Jonzac;3542;224;3766
75;Nouvelle-Aquitaine;17;5;02;198;Juicq;305;6;311
75;Nouvelle-Aquitaine;17;1;27;199;Jussas;156;0;156
75;Nouvelle-Aquitaine;17;3;08;200;Lagord;7193;157;7350
75;Nouvelle-Aquitaine;17;3;09;201;La Laigne;482;5;487
75;Nouvelle-Aquitaine;17;5;18;202;Landes;575;13;588
75;Nouvelle-Aquitaine;17;2;23;203;Landrais;758;11;769
75;Nouvelle-Aquitaine;17;1;07;204;Léoville;303;8;311
75;Nouvelle-Aquitaine;17;2;25;205;Loire-les-Marais;390;7;397
75;Nouvelle-Aquitaine;17;5;11;206;Loiré-sur-Nie;283;3;286
75;Nouvelle-Aquitaine;17;3;05;207;Loix;735;19;754
75;Nouvelle-Aquitaine;17;3;09;208;Longèves;1055;10;1065
75;Nouvelle-Aquitaine;17;1;07;209;Lonzac;270;4;274
75;Nouvelle-Aquitaine;17;1;12;210;Lorignac;506;4;510
75;Nouvelle-Aquitaine;17;5;18;211;Loulay;754;11;765
75;Nouvelle-Aquitaine;17;5;11;212;Louzignac;168;2;170
75;Nouvelle-Aquitaine;17;5;18;213;Lozay;134;4;138
75;Nouvelle-Aquitaine;17;4;24;214;Luchat;529;11;540
75;Nouvelle-Aquitaine;17;1;07;215;Lussac;47;0;47
75;Nouvelle-Aquitaine;17;2;25;216;Lussant;1019;13;1032
75;Nouvelle-Aquitaine;17;5;11;217;Macqueville;291;7;298
75;Nouvelle-Aquitaine;17;3;09;218;Marans;4512;72;4584
75;Nouvelle-Aquitaine;17;2;10;219;Marennes-Hiers-Brouage;6203;101;6304
75;Nouvelle-Aquitaine;17;1;12;220;Marignac;412;17;429
75;Nouvelle-Aquitaine;17;2;23;221;Marsais;929;19;948
75;Nouvelle-Aquitaine;17;3;08;222;Marsilly;3190;94;3284
75;Nouvelle-Aquitaine;17;5;11;223;Massac;183;1;184
75;Nouvelle-Aquitaine;17;5;11;224;Matha;2178;79;2257
75;Nouvelle-Aquitaine;17;2;26;225;Les Mathes;2178;32;2210
75;Nouvelle-Aquitaine;17;5;18;226;Mazeray;988;14;1002
75;Nouvelle-Aquitaine;17;1;12;227;Mazerolles;221;3;224
75;Nouvelle-Aquitaine;17;4;22;228;Médis;3011;73;3084
75;Nouvelle-Aquitaine;17;1;27;229;Mérignac;225;3;228
75;Nouvelle-Aquitaine;17;2;21;230;Meschers-sur-Gironde;3131;70;3201
75;Nouvelle-Aquitaine;17;1;27;231;Messac;105;5;110
75;Nouvelle-Aquitaine;17;4;21;232;Meursac;1536;21;1557
75;Nouvelle-Aquitaine;17;1;07;233;Meux;330;1;331
75;Nouvelle-Aquitaine;17;5;18;234;Migré;356;4;360
75;Nouvelle-Aquitaine;17;4;02;235;Migron;714;11;725
75;Nouvelle-Aquitaine;17;1;12;236;Mirambeau;1520;29;1549
75;Nouvelle-Aquitaine;17;2;10;237;Moëze;596;4;600
75;Nouvelle-Aquitaine;17;5;11;239;Mons;446;7;453
75;Nouvelle-Aquitaine;17;1;27;240;Montendre;3222;52;3274
75;Nouvelle-Aquitaine;17;1;27;241;Montguyon;1564;19;1583
75;Nouvelle-Aquitaine;17;4;24;242;Montils;879;13;892
75;Nouvelle-Aquitaine;17;1;27;243;Montlieu-la-Garde;1217;10;1227
75;Nouvelle-Aquitaine;17;4;21;244;Montpellier-de-Médillan;688;9;697
75;Nouvelle-Aquitaine;17;3;06;245;Montroy;908;13;921
75;Nouvelle-Aquitaine;17;2;25;246;Moragne;531;6;537
75;Nouvelle-Aquitaine;17;2;26;247;Mornac-sur-Seudre;859;13;872
75;Nouvelle-Aquitaine;17;4;21;248;Mortagne-sur-Gironde;922;17;939
75;Nouvelle-Aquitaine;17;1;07;249;Mortiers;171;1;172
75;Nouvelle-Aquitaine;17;1;12;250;Mosnac;477;5;482
75;Nouvelle-Aquitaine;17;5;18;252;Le Mung;306;7;313
75;Nouvelle-Aquitaine;17;2;25;253;Muron;1351;16;1367
75;Nouvelle-Aquitaine;17;5;18;254;Nachamps;193;2;195
75;Nouvelle-Aquitaine;17;4;19;255;Nancras;796;11;807
75;Nouvelle-Aquitaine;17;5;02;256;Nantillé;323;13;336
75;Nouvelle-Aquitaine;17;5;11;257;Néré;658;5;663
75;Nouvelle-Aquitaine;17;1;07;258;Neuillac;302;4;306
75;Nouvelle-Aquitaine;17;1;07;259;Neulles;155;2;157
75;Nouvelle-Aquitaine;17;1;27;260;Neuvicq;469;5;474
75;Nouvelle-Aquitaine;17;5;11;261;Neuvicq-le-Château;307;5;312
75;Nouvelle-Aquitaine;17;4;19;262;Nieul-lès-Saintes;1266;22;1288
75;Nouvelle-Aquitaine;17;1;07;263;Nieul-le-Virouil;588;12;600
75;Nouvelle-Aquitaine;17;3;08;264;Nieul-sur-Mer;5811;146;5957
75;Nouvelle-Aquitaine;17;2;10;265;Nieulle-sur-Seudre;1221;18;1239
75;Nouvelle-Aquitaine;17;5;18;266;Les Nouillers;724;7;731
75;Nouvelle-Aquitaine;17;3;09;267;Nuaillé-d'Aunis;1196;18;1214
75;Nouvelle-Aquitaine;17;5;11;268;Nuaillé-sur-Boutonne;191;7;198
75;Nouvelle-Aquitaine;17;1;27;269;Orignolles;697;7;704
75;Nouvelle-Aquitaine;17;1;07;270;Ozillac;616;13;629
75;Nouvelle-Aquitaine;17;5;11;271;Paillé;325;6;331
75;Nouvelle-Aquitaine;17;1;24;273;Pérignac;998;18;1016
75;Nouvelle-Aquitaine;17;3;01;274;Périgny;8741;191;8932
75;Nouvelle-Aquitaine;17;4;24;275;Pessines;786;26;812
75;Nouvelle-Aquitaine;17;1;27;276;Le Pin;74;1;75
75;Nouvelle-Aquitaine;17;5;18;277;Essouvert;1059;81;1140
75;Nouvelle-Aquitaine;17;4;24;278;Pisany;777;9;786
75;Nouvelle-Aquitaine;17;1;12;279;Plassac;641;13;654
75;Nouvelle-Aquitaine;17;4;19;280;Plassay;760;11;771
75;Nouvelle-Aquitaine;17;1;27;281;Polignac;160;3;163
75;Nouvelle-Aquitaine;17;1;27;282;Pommiers-Moulons;213;2;215
75;Nouvelle-Aquitaine;17;1;12;283;Pons;4206;250;4456
75;Nouvelle-Aquitaine;17;4;19;284;Pont-l'Abbé-d'Arnoult;1788;288;2076
75;Nouvelle-Aquitaine;17;4;19;285;Port-d'Envaux;1151;27;1178
75;Nouvelle-Aquitaine;17;3;05;286;Les Portes-en-Ré;593;8;601
75;Nouvelle-Aquitaine;17;1;27;287;Pouillac;266;2;268
75;Nouvelle-Aquitaine;17;5;11;288;Poursay-Garnaud;315;6;321
75;Nouvelle-Aquitaine;17;4;24;289;Préguillac;437;18;455
75;Nouvelle-Aquitaine;17;5;11;290;Prignac;293;9;302
75;Nouvelle-Aquitaine;17;3;01;291;Puilboreau;6659;127;6786
75;Nouvelle-Aquitaine;17;5;18;292;Puy-du-Lac;513;5;518
75;Nouvelle-Aquitaine;17;2;23;293;Puyravault;700;12;712
75;Nouvelle-Aquitaine;17;5;18;294;Puyrolland;195;3;198
75;Nouvelle-Aquitaine;17;1;07;295;Réaux sur Trèfle;781;16;797
75;Nouvelle-Aquitaine;17;4;24;296;Rétaud;1059;14;1073
75;Nouvelle-Aquitaine;17;3;05;297;Rivedoux-Plage;2320;45;2365
75;Nouvelle-Aquitaine;17;4;24;298;Rioux;987;22;1009
75;Nouvelle-Aquitaine;17;2;13;299;Rochefort;23410;632;24042
75;Nouvelle-Aquitaine;17;3;99;300;La Rochelle;77210;2113;79323
75;Nouvelle-Aquitaine;17;5;11;301;Romazières;70;1;71
75;Nouvelle-Aquitaine;17;4;19;302;Romegoux;589;9;598
75;Nouvelle-Aquitaine;17;3;09;303;La Ronde;1021;17;1038
75;Nouvelle-Aquitaine;17;4;24;304;Rouffiac;494;5;499
75;Nouvelle-Aquitaine;17;1;27;305;Rouffignac;407;9;416
75;Nouvelle-Aquitaine;17;2;17;306;Royan;18638;536;19174
75;Nouvelle-Aquitaine;17;4;22;307;Sablonceaux;1396;32;1428
75;Nouvelle-Aquitaine;17;2;10;308;Saint-Agnant;2737;61;2798
75;Nouvelle-Aquitaine;17;1;27;309;Saint-Aigulin;1887;40;1927
75;Nouvelle-Aquitaine;17;4;21;310;Saint-André-de-Lidon;1147;14;1161
75;Nouvelle-Aquitaine;17;2;26;311;Saint-Augustin;1421;18;1439
75;Nouvelle-Aquitaine;17;1;12;312;Saint-Bonnet-sur-Gironde;825;14;839
75;Nouvelle-Aquitaine;17;4;02;313;Saint-Bris-des-Bois;383;13;396
75;Nouvelle-Aquitaine;17;4;02;314;Saint-Césaire;903;17;920
75;Nouvelle-Aquitaine;17;3;06;315;Saint-Christophe;1376;29;1405
75;Nouvelle-Aquitaine;17;1;07;316;Saint-Ciers-Champagne;388;11;399
75;Nouvelle-Aquitaine;17;1;12;317;Saint-Ciers-du-Taillon;564;5;569
75;Nouvelle-Aquitaine;17;3;05;318;Saint-Clément-des-Baleines;691;11;702
75;Nouvelle-Aquitaine;17;1;27;319;Sainte-Colombe;104;1;105
75;Nouvelle-Aquitaine;17;2;25;320;Saint-Coutant-le-Grand;409;6;415
75;Nouvelle-Aquitaine;17;2;18;321;Saint-Crépin;355;7;362
75;Nouvelle-Aquitaine;17;3;09;322;Saint-Cyr-du-Doret;687;5;692
75;Nouvelle-Aquitaine;17;2;04;323;Saint-Denis-d'Oléron;1297;24;1321
75;Nouvelle-Aquitaine;17;1;07;324;Saint-Dizant-du-Bois;111;0;111
75;Nouvelle-Aquitaine;17;1;12;325;Saint-Dizant-du-Gua;526;6;532
75;Nouvelle-Aquitaine;17;1;07;326;Saint-Eugène;286;3;289
75;Nouvelle-Aquitaine;17;5;18;327;Saint-Félix;317;3;320
75;Nouvelle-Aquitaine;17;1;12;328;Saint-Fort-sur-Gironde;908;11;919
75;Nouvelle-Aquitaine;17;2;10;329;Saint-Froult;368;2;370
75;Nouvelle-Aquitaine;17;4;19;330;Sainte-Gemme;1348;19;1367
75;Nouvelle-Aquitaine;17;1;12;331;Saint-Genis-de-Saintonge;1241;52;1293
75;Nouvelle-Aquitaine;17;1;07;332;Saint-Georges-Antignac;391;6;397
75;Nouvelle-Aquitaine;17;2;17;333;Saint-Georges-de-Didonne;5246;110;5356
75;Nouvelle-Aquitaine;17;5;11;334;Saint-Georges-de-Longuepierre;227;3;230
75;Nouvelle-Aquitaine;17;1;12;335;Saint-Georges-des-Agoûts;286;3;289
75;Nouvelle-Aquitaine;17;4;19;336;Saint-Georges-des-Coteaux;2779;70;2849
75;Nouvelle-Aquitaine;17;2;04;337;Saint-Georges-d'Oléron;3845;55;3900
75;Nouvelle-Aquitaine;17;2;23;338;Saint-Georges-du-Bois;1807;21;1828
75;Nouvelle-Aquitaine;17;1;07;339;Saint-Germain-de-Lusignan;1295;123;1418
75;Nouvelle-Aquitaine;17;2;23;340;Saint-Pierre-La-Noue;1517;91;1608
75;Nouvelle-Aquitaine;17;1;07;341;Saint-Germain-de-Vibrac;182;4;186
75;Nouvelle-Aquitaine;17;1;12;342;Saint-Germain-du-Seudre;413;11;424
75;Nouvelle-Aquitaine;17;1;12;343;Saint-Grégoire-d'Ardennes;145;3;148
75;Nouvelle-Aquitaine;17;5;02;344;Saint-Hilaire-de-Villefranche;1328;26;1354
75;Nouvelle-Aquitaine;17;1;07;345;Saint-Hilaire-du-Bois;297;14;311
75;Nouvelle-Aquitaine;17;2;25;346;Saint-Hippolyte;1475;25;1500
75;Nouvelle-Aquitaine;17;5;18;347;Saint-Jean-d'Angély;6744;428;7172
75;Nouvelle-Aquitaine;17;2;10;348;Saint-Jean-d'Angle;693;10;703
75;Nouvelle-Aquitaine;17;3;09;349;Saint-Jean-de-Liversay;2997;44;3041
75;Nouvelle-Aquitaine;17;5;11;350;Saint-Julien-de-l'Escap;864;16;880
75;Nouvelle-Aquitaine;17;2;10;351;Saint-Just-Luzac;2046;34;2080
75;Nouvelle-Aquitaine;17;2;03;353;Saint-Laurent-de-la-Prée;2264;62;2326
75;Nouvelle-Aquitaine;17;1;12;354;Saint-Léger;653;14;667
75;Nouvelle-Aquitaine;17;1;07;355;Sainte-Lheurine;511;8;519
75;Nouvelle-Aquitaine;17;5;18;356;Saint-Loup;309;4;313
75;Nouvelle-Aquitaine;17;1;07;357;Saint-Maigrin;531;8;539
75;Nouvelle-Aquitaine;17;5;11;358;Saint-Mandé-sur-Brédoire;307;6;313
75;Nouvelle-Aquitaine;17;2;23;359;Saint-Mard;1210;20;1230
75;Nouvelle-Aquitaine;17;3;05;360;Sainte-Marie-de-Ré;3356;108;3464
75;Nouvelle-Aquitaine;17;5;11;361;Saint-Martial;112;5;117
75;Nouvelle-Aquitaine;17;1;12;362;Saint-Martial-de-Mirambeau;299;7;306
75;Nouvelle-Aquitaine;17;1;07;363;Saint-Martial-de-Vitaterne;547;14;561
75;Nouvelle-Aquitaine;17;1;07;364;Saint-Martial-sur-Né;430;14;444
75;Nouvelle-Aquitaine;17;1;27;365;Saint-Martin-d'Ary;469;9;478
75;Nouvelle-Aquitaine;17;1;27;366;Saint-Martin-de-Coux;489;4;493
75;Nouvelle-Aquitaine;17;5;11;367;Saint-Martin-de-Juillers;156;4;160
75;Nouvelle-Aquitaine;17;3;05;369;Saint-Martin-de-Ré;2220;20;2240
75;Nouvelle-Aquitaine;17;1;07;372;Saint-Médard;82;1;83
75;Nouvelle-Aquitaine;17;3;06;373;Saint-Médard-d'Aunis;2333;43;2376
75;Nouvelle-Aquitaine;17;5;02;374;Sainte-Même;237;6;243
75;Nouvelle-Aquitaine;17;2;25;375;Saint-Nazaire-sur-Charente;1205;20;1225
75;Nouvelle-Aquitaine;17;3;09;376;Saint-Ouen-d'Aunis;1983;31;2014
75;Nouvelle-Aquitaine;17;5;11;377;Saint-Ouen-la-Thène;128;5;133
75;Nouvelle-Aquitaine;17;1;27;378;Saint-Palais-de-Négrignac;432;6;438
75;Nouvelle-Aquitaine;17;1;12;379;Saint-Palais-de-Phiolin;209;3;212
75;Nouvelle-Aquitaine;17;2;26;380;Saint-Palais-sur-Mer;3920;82;4002
75;Nouvelle-Aquitaine;17;5;11;381;Saint-Pardoult;222;3;225
75;Nouvelle-Aquitaine;17;2;23;382;Saint-Pierre-d'Amilly;550;6;556
75;Nouvelle-Aquitaine;17;5;11;383;Saint-Pierre-de-Juillers;347;4;351
75;Nouvelle-Aquitaine;17;5;11;384;Saint-Pierre-de-l'Isle;261;2;263
75;Nouvelle-Aquitaine;17;2;04;385;Saint-Pierre-d'Oléron;6585;97;6682
75;Nouvelle-Aquitaine;17;1;27;386;Saint-Pierre-du-Palais;348;10;358
75;Nouvelle-Aquitaine;17;4;19;387;Saint-Porchaire;1920;27;1947
75;Nouvelle-Aquitaine;17;1;12;388;Saint-Quantin-de-Rançanne;254;6;260
75;Nouvelle-Aquitaine;17;4;19;389;Sainte-Radegonde;579;8;587
75;Nouvelle-Aquitaine;17;1;12;390;Sainte-Ramée;114;1;115
75;Nouvelle-Aquitaine;17;3;06;391;Saint-Rogatien;2425;50;2475
75;Nouvelle-Aquitaine;17;4;22;393;Saint-Romain-de-Benet;1760;27;1787
75;Nouvelle-Aquitaine;17;2;23;394;Saint-Saturnin-du-Bois;902;18;920
75;Nouvelle-Aquitaine;17;4;02;395;Saint-Sauvant;494;8;502
75;Nouvelle-Aquitaine;17;3;09;396;Saint-Sauveur-d'Aunis;1727;29;1756
75;Nouvelle-Aquitaine;17;5;18;397;Saint-Savinien;2452;101;2553
75;Nouvelle-Aquitaine;17;1;12;398;Saint-Seurin-de-Palenne;167;7;174
75;Nouvelle-Aquitaine;17;4;24;400;Saint-Sever-de-Saintonge;638;13;651
75;Nouvelle-Aquitaine;17;5;11;401;Saint-Séverin-sur-Boutonne;94;3;97
75;Nouvelle-Aquitaine;17;1;07;402;Saint-Sigismond-de-Clermont;158;2;160
75;Nouvelle-Aquitaine;17;1;07;403;Saint-Simon-de-Bordes;763;13;776
75;Nouvelle-Aquitaine;17;4;21;404;Saint-Simon-de-Pellouaille;662;19;681
75;Nouvelle-Aquitaine;17;1;12;405;Saint-Sorlin-de-Conac;198;2;200
75;Nouvelle-Aquitaine;17;2;10;406;Saint-Sornin;417;3;420
75;Nouvelle-Aquitaine;17;3;06;407;Sainte-Soulle;4906;95;5001
75;Nouvelle-Aquitaine;17;4;19;408;Saint-Sulpice-d'Arnoult;910;9;919
75;Nouvelle-Aquitaine;17;2;22;409;Saint-Sulpice-de-Royan;3328;65;3393
75;Nouvelle-Aquitaine;17;1;12;410;Saint-Thomas-de-Conac;575;9;584
75;Nouvelle-Aquitaine;17;2;04;411;Saint-Trojan-les-Bains;1133;21;1154
75;Nouvelle-Aquitaine;17;4;02;412;Saint-Vaize;660;13;673
75;Nouvelle-Aquitaine;17;3;03;413;Saint-Vivien;1385;21;1406
75;Nouvelle-Aquitaine;17;3;08;414;Saint-Xandre;5231;168;5399
75;Nouvelle-Aquitaine;17;4;20;415;Saintes;25412;1402;26814
75;Nouvelle-Aquitaine;17;5;11;416;Saleignes;58;2;60
75;Nouvelle-Aquitaine;17;1;12;417;Salignac-de-Mirambeau;167;1;168
75;Nouvelle-Aquitaine;17;1;24;418;Salignac-sur-Charente;606;17;623
75;Nouvelle-Aquitaine;17;3;03;420;Salles-sur-Mer;2324;63;2387
75;Nouvelle-Aquitaine;17;4;22;421;Saujon;7200;120;7320
75;Nouvelle-Aquitaine;17;5;11;422;Seigné;78;1;79
75;Nouvelle-Aquitaine;17;1;12;423;Semillac;75;1;76
75;Nouvelle-Aquitaine;17;1;12;424;Semoussac;394;3;397
75;Nouvelle-Aquitaine;17;4;22;425;Semussac;2429;46;2475
75;Nouvelle-Aquitaine;17;4;02;426;Le Seure;260;2;262
75;Nouvelle-Aquitaine;17;5;11;427;Siecq;217;5;222
75;Nouvelle-Aquitaine;17;5;11;428;Sonnac;486;9;495
75;Nouvelle-Aquitaine;17;2;25;429;Soubise;3347;42;3389
75;Nouvelle-Aquitaine;17;1;12;430;Soubran;408;7;415
75;Nouvelle-Aquitaine;17;4;19;431;Soulignonne;721;6;727
75;Nouvelle-Aquitaine;17;1;27;432;Souméras;365;6;371
75;Nouvelle-Aquitaine;17;1;27;433;Sousmoulins;208;7;215
75;Nouvelle-Aquitaine;17;2;23;434;Surgères;6801;169;6970
75;Nouvelle-Aquitaine;17;5;18;435;Taillant;174;1;175
75;Nouvelle-Aquitaine;17;5;18;436;Taillebourg;768;24;792
75;Nouvelle-Aquitaine;17;4;21;437;Talmont-sur-Gironde;96;1;97
75;Nouvelle-Aquitaine;17;4;21;438;Tanzac;299;7;306
75;Nouvelle-Aquitaine;17;3;09;439;Taugon;779;14;793
75;Nouvelle-Aquitaine;17;5;18;440;Ternant;371;8;379
75;Nouvelle-Aquitaine;17;4;24;441;Tesson;1130;26;1156
75;Nouvelle-Aquitaine;17;4;21;442;Thaims;381;3;384
75;Nouvelle-Aquitaine;17;3;06;443;Thairé;1778;45;1823
75;Nouvelle-Aquitaine;17;4;24;444;Thénac;1696;258;1954
75;Nouvelle-Aquitaine;17;4;24;445;Thézac;334;8;342
75;Nouvelle-Aquitaine;17;5;11;446;Thors;463;6;469
75;Nouvelle-Aquitaine;17;2;23;447;Le Thou;2020;25;2045
75;Nouvelle-Aquitaine;17;5;18;448;Tonnay-Boutonne;1180;14;1194
75;Nouvelle-Aquitaine;17;2;25;449;Tonnay-Charente;8142;106;8248
75;Nouvelle-Aquitaine;17;5;18;450;Torxé;244;2;246
75;Nouvelle-Aquitaine;17;5;11;451;Les Touches-de-Périgny;548;10;558
75;Nouvelle-Aquitaine;17;2;26;452;La Tremblade;4326;65;4391
75;Nouvelle-Aquitaine;17;4;19;453;Trizay;1468;32;1500
75;Nouvelle-Aquitaine;17;1;27;454;Tugéras-Saint-Maurice;378;7;385
75;Nouvelle-Aquitaine;17;4;19;455;La Vallée;665;11;676
75;Nouvelle-Aquitaine;17;2;18;457;La Devise;1193;17;1210
75;Nouvelle-Aquitaine;17;1;27;458;Vanzac;181;0;181
75;Nouvelle-Aquitaine;17;5;11;459;Varaize;560;10;570
75;Nouvelle-Aquitaine;17;4;24;460;Varzay;841;18;859
75;Nouvelle-Aquitaine;17;2;17;461;Vaux-sur-Mer;3990;80;4070
75;Nouvelle-Aquitaine;17;4;02;462;Vénérand;766;15;781
75;Nouvelle-Aquitaine;17;2;25;463;Vergeroux;1282;21;1303
75;Nouvelle-Aquitaine;17;5;18;464;Vergné;158;6;164
75;Nouvelle-Aquitaine;17;5;18;465;La Vergne;601;10;611
75;Nouvelle-Aquitaine;17;3;06;466;Vérines;2326;34;2360
75;Nouvelle-Aquitaine;17;5;11;467;Vervant;236;2;238
75;Nouvelle-Aquitaine;17;1;07;468;Vibrac;153;3;156
75;Nouvelle-Aquitaine;17;4;21;469;Villars-en-Pons;576;14;590
75;Nouvelle-Aquitaine;17;4;02;470;Villars-les-Bois;228;9;237
75;Nouvelle-Aquitaine;17;5;11;471;La Villedieu;208;3;211
75;Nouvelle-Aquitaine;17;3;09;472;Villedoux;2297;19;2316
75;Nouvelle-Aquitaine;17;5;11;473;Villemorin;119;0;119
75;Nouvelle-Aquitaine;17;5;18;474;Villeneuve-la-Comtesse;742;13;755
75;Nouvelle-Aquitaine;17;1;07;476;Villexavier;271;5;276
75;Nouvelle-Aquitaine;17;5;11;477;Villiers-Couture;109;1;110
75;Nouvelle-Aquitaine;17;5;11;478;Vinax;61;0;61
75;Nouvelle-Aquitaine;17;4;21;479;Virollet;300;3;303
75;Nouvelle-Aquitaine;17;2;23;480;Virson;757;17;774
75;Nouvelle-Aquitaine;17;5;18;481;Voissay;168;3;171
75;Nouvelle-Aquitaine;17;2;23;482;Vouhé;643;11;654
75;Nouvelle-Aquitaine;17;3;03;483;Yves;1497;26;1523
75;Nouvelle-Aquitaine;17;2;25;484;Port-des-Barques;1764;13;1777
75;Nouvelle-Aquitaine;17;2;04;485;Le Grand-Village-Plage;1074;13;1087
75;Nouvelle-Aquitaine;17;2;04;486;La Brée-les-Bains;688;6;694
24;Centre-Val de Loire;18;1;15;001;Achères;364;7;371
24;Centre-Val de Loire;18;2;08;002;Ainay-le-Vieil;191;4;195
24;Centre-Val de Loire;18;1;14;003;Les Aix-d'Angillon;1881;28;1909
24;Centre-Val de Loire;18;1;15;004;Allogny;1097;18;1115
24;Centre-Val de Loire;18;3;11;005;Allouis;1074;23;1097
24;Centre-Val de Loire;18;1;17;006;Annoix;240;2;242
24;Centre-Val de Loire;18;2;10;007;Apremont-sur-Allier;69;1;70
24;Centre-Val de Loire;18;1;17;008;Arçay;493;10;503
24;Centre-Val de Loire;18;2;08;009;Arcomps;278;11;289
24;Centre-Val de Loire;18;2;08;010;Ardenais;199;7;206
24;Centre-Val de Loire;18;3;01;011;Argent-sur-Sauldre;2070;38;2108
24;Centre-Val de Loire;18;1;02;012;Argenvières;438;5;443
24;Centre-Val de Loire;18;2;09;013;Arpheuilles;301;5;306
24;Centre-Val de Loire;18;1;16;014;Assigny;148;7;155
24;Centre-Val de Loire;18;3;01;015;Aubigny-sur-Nère;5499;124;5623
24;Centre-Val de Loire;18;1;14;016;Aubinges;405;3;408
24;Centre-Val de Loire;18;2;09;017;Augy-sur-Aubois;286;3;289
24;Centre-Val de Loire;18;1;02;018;Avord;2804;37;2841
24;Centre-Val de Loire;18;1;14;019;Azy;448;7;455
24;Centre-Val de Loire;18;1;16;020;Bannay;848;13;861
24;Centre-Val de Loire;18;2;09;021;Bannegon;272;4;276
24;Centre-Val de Loire;18;1;16;022;Barlieu;342;8;350
24;Centre-Val de Loire;18;1;02;023;Baugy;1637;54;1691
24;Centre-Val de Loire;18;2;08;024;Beddes;102;3;105
24;Centre-Val de Loire;18;1;02;025;Beffes;610;12;622
24;Centre-Val de Loire;18;1;16;026;Belleville-sur-Loire;986;27;1013
24;Centre-Val de Loire;18;1;02;027;Bengy-sur-Craon;653;67;720
24;Centre-Val de Loire;18;3;11;028;Berry-Bouy;1172;37;1209
24;Centre-Val de Loire;18;2;09;029;Bessais-le-Fromental;299;4;303
24;Centre-Val de Loire;18;3;01;030;Blancafort;1008;21;1029
24;Centre-Val de Loire;18;2;10;031;Blet;563;5;568
24;Centre-Val de Loire;18;1;16;032;Boulleret;1375;35;1410
24;Centre-Val de Loire;18;1;98;033;Bourges;64362;2023;66385
24;Centre-Val de Loire;18;2;12;034;Bouzais;308;9;317
24;Centre-Val de Loire;18;1;14;035;Brécy;1053;22;1075
24;Centre-Val de Loire;18;3;11;036;Brinay;524;6;530
24;Centre-Val de Loire;18;3;01;037;Brinon-sur-Sauldre;971;16;987
24;Centre-Val de Loire;18;2;12;038;Bruère-Allichamps;567;4;571
24;Centre-Val de Loire;18;1;16;039;Bué;322;8;330
24;Centre-Val de Loire;18;2;09;040;Bussy;353;3;356
24;Centre-Val de Loire;18;2;08;041;La Celette;196;2;198
24;Centre-Val de Loire;18;2;12;042;La Celle;345;5;350
24;Centre-Val de Loire;18;2;08;043;La Celle-Condé;194;0;194
24;Centre-Val de Loire;18;3;11;044;Cerbois;407;4;411
24;Centre-Val de Loire;18;2;09;045;Chalivoy-Milon;404;8;412
24;Centre-Val de Loire;18;2;17;046;Chambon;162;2;164
24;Centre-Val de Loire;18;3;01;047;La Chapelle-d'Angillon;612;8;620
24;Centre-Val de Loire;18;2;10;048;La Chapelle-Hugon;380;4;384
24;Centre-Val de Loire;18;1;02;049;La Chapelle-Montlinard;467;9;476
24;Centre-Val de Loire;18;1;13;050;La Chapelle-Saint-Ursin;3674;79;3753
24;Centre-Val de Loire;18;1;14;051;La Chapelotte;134;3;137
24;Centre-Val de Loire;18;2;09;052;Charenton-du-Cher;1017;22;1039
24;Centre-Val de Loire;18;1;02;053;Charentonnay;290;8;298
24;Centre-Val de Loire;18;2;10;054;Charly;246;3;249
24;Centre-Val de Loire;18;1;07;055;Chârost;922;22;944
24;Centre-Val de Loire;18;1;02;056;Chassy;236;6;242
24;Centre-Val de Loire;18;2;08;057;Châteaumeillant;1740;18;1758
24;Centre-Val de Loire;18;2;17;058;Châteauneuf-sur-Cher;1425;13;1438
24;Centre-Val de Loire;18;2;08;059;Le Châtelet;936;11;947
24;Centre-Val de Loire;18;2;09;060;Chaumont;48;2;50
24;Centre-Val de Loire;18;1;02;061;Chaumoux-Marcilly;88;0;88
24;Centre-Val de Loire;18;2;10;062;Le Chautay;266;1;267
24;Centre-Val de Loire;18;2;17;063;Chavannes;156;3;159
24;Centre-Val de Loire;18;3;11;064;Chéry;218;6;224
24;Centre-Val de Loire;18;2;08;065;Chezal-Benoît;802;12;814
24;Centre-Val de Loire;18;1;07;066;Civray;901;15;916
24;Centre-Val de Loire;18;3;01;067;Clémont;708;10;718
24;Centre-Val de Loire;18;2;09;068;Cogny;34;2;36
24;Centre-Val de Loire;18;2;12;069;Colombiers;412;16;428
24;Centre-Val de Loire;18;1;16;070;Concressault;201;2;203
24;Centre-Val de Loire;18;2;09;071;Contres;33;0;33
24;Centre-Val de Loire;18;2;10;072;Cornusse;253;1;254
24;Centre-Val de Loire;18;2;17;073;Corquoy;200;6;206
24;Centre-Val de Loire;18;1;16;074;Couargues;199;4;203
24;Centre-Val de Loire;18;2;10;075;Cours-les-Barres;1023;27;1050
24;Centre-Val de Loire;18;2;09;076;Coust;443;8;451
24;Centre-Val de Loire;18;1;02;077;Couy;366;9;375
24;Centre-Val de Loire;18;2;17;078;Crézançay-sur-Cher;61;1;62
24;Centre-Val de Loire;18;1;16;079;Crézancy-en-Sancerre;438;6;444
24;Centre-Val de Loire;18;2;10;080;Croisy;146;2;148
24;Centre-Val de Loire;18;1;02;081;Crosses;405;3;408
24;Centre-Val de Loire;18;2;10;082;Cuffy;1026;29;1055
24;Centre-Val de Loire;18;2;08;083;Culan;767;7;774
24;Centre-Val de Loire;18;1;16;084;Dampierre-en-Crot;203;3;206
24;Centre-Val de Loire;18;3;19;085;Dampierre-en-Graçay;240;5;245
24;Centre-Val de Loire;18;2;12;086;Drevant;546;16;562
24;Centre-Val de Loire;18;2;09;087;Dun-sur-Auron;3616;71;3687
24;Centre-Val de Loire;18;3;01;088;Ennordres;210;7;217
24;Centre-Val de Loire;18;2;08;089;Épineuil-le-Fleuriel;436;10;446
24;Centre-Val de Loire;18;1;02;090;Étréchy;413;10;423
24;Centre-Val de Loire;18;2;12;091;Farges-Allichamps;253;6;259
24;Centre-Val de Loire;18;1;02;092;Farges-en-Septaine;995;24;1019
24;Centre-Val de Loire;18;2;08;093;Faverdines;137;0;137
24;Centre-Val de Loire;18;1;16;094;Feux;334;8;342
24;Centre-Val de Loire;18;2;10;095;Flavigny;168;4;172
24;Centre-Val de Loire;18;3;11;096;Foëcy;2086;34;2120
24;Centre-Val de Loire;18;1;15;097;Fussy;1952;32;1984
24;Centre-Val de Loire;18;1;16;098;Gardefort;127;3;130
24;Centre-Val de Loire;18;1;02;099;Garigny;221;4;225
24;Centre-Val de Loire;18;3;19;100;Genouilly;676;17;693
24;Centre-Val de Loire;18;2;10;101;Germigny-l'Exempt;290;10;300
24;Centre-Val de Loire;18;2;09;102;Givardon;303;3;306
24;Centre-Val de Loire;18;3;19;103;Graçay;1369;14;1383
24;Centre-Val de Loire;18;1;02;104;Groises;134;2;136
24;Centre-Val de Loire;18;1;02;105;Gron;459;17;476
24;Centre-Val de Loire;18;2;09;106;Grossouvre;263;3;266
24;Centre-Val de Loire;18;2;12;107;La Groutte;123;8;131
24;Centre-Val de Loire;18;2;10;108;La Guerche-sur-l'Aubois;3168;33;3201
24;Centre-Val de Loire;18;1;14;109;Henrichemont;1720;20;1740
24;Centre-Val de Loire;18;1;02;110;Herry;965;18;983
24;Centre-Val de Loire;18;1;14;111;Humbligny;187;1;188
24;Centre-Val de Loire;18;2;08;112;Ids-Saint-Roch;282;1;283
24;Centre-Val de Loire;18;2;10;113;Ignol;179;5;184
24;Centre-Val de Loire;18;2;08;114;Ineuil;223;4;227
24;Centre-Val de Loire;18;3;01;115;Ivoy-le-Pré;786;7;793
24;Centre-Val de Loire;18;1;16;116;Jalognes;273;2;275
24;Centre-Val de Loire;18;1;16;117;Jars;503;5;508
24;Centre-Val de Loire;18;2;10;118;Jouet-sur-l'Aubois;1317;32;1349
24;Centre-Val de Loire;18;1;02;119;Jussy-Champagne;204;5;209
24;Centre-Val de Loire;18;1;02;120;Jussy-le-Chaudrier;588;13;601
24;Centre-Val de Loire;18;2;09;121;Lantan;93;4;97
24;Centre-Val de Loire;18;1;17;122;Lapan;220;2;222
24;Centre-Val de Loire;18;3;11;124;Lazenay;297;3;300
24;Centre-Val de Loire;18;1;16;125;Léré;1075;25;1100
24;Centre-Val de Loire;18;1;17;126;Levet;1373;44;1417
24;Centre-Val de Loire;18;2;08;127;Lignières;1358;28;1386
24;Centre-Val de Loire;18;3;11;128;Limeux;168;0;168
24;Centre-Val de Loire;18;1;17;129;Lissay-Lochy;228;5;233
24;Centre-Val de Loire;18;2;08;130;Loye-sur-Arnon;298;6;304
24;Centre-Val de Loire;18;2;10;131;Lugny-Bourbonnais;34;0;34
24;Centre-Val de Loire;18;1;02;132;Lugny-Champagne;136;1;137
24;Centre-Val de Loire;18;1;07;133;Lunery;1593;13;1606
24;Centre-Val de Loire;18;3;11;134;Lury-sur-Arnon;661;16;677
24;Centre-Val de Loire;18;2;08;135;Maisonnais;236;6;242
24;Centre-Val de Loire;18;2;12;136;Marçais;304;5;309
24;Centre-Val de Loire;18;1;07;137;Mareuil-sur-Arnon;495;9;504
24;Centre-Val de Loire;18;1;13;138;Marmagne;1916;53;1969
24;Centre-Val de Loire;18;1;02;139;Marseilles-lès-Aubigny;652;12;664
24;Centre-Val de Loire;18;3;11;140;Massay;1353;24;1377
24;Centre-Val de Loire;18;3;11;141;Mehun-sur-Yèvre;6502;88;6590
24;Centre-Val de Loire;18;2;12;142;Meillant;673;15;688
24;Centre-Val de Loire;18;2;10;143;Menetou-Couture;386;7;393
24;Centre-Val de Loire;18;1;16;144;Menetou-Râtel;466;10;476
24;Centre-Val de Loire;18;1;15;145;Menetou-Salon;1614;39;1653
24;Centre-Val de Loire;18;1;16;146;Ménétréol-sous-Sancerre;310;13;323
24;Centre-Val de Loire;18;3;01;147;Ménétréol-sur-Sauldre;201;3;204
24;Centre-Val de Loire;18;3;11;148;Méreau;2620;63;2683
24;Centre-Val de Loire;18;3;01;149;Méry-ès-Bois;562;8;570
24;Centre-Val de Loire;18;3;19;150;Méry-sur-Cher;703;14;717
24;Centre-Val de Loire;18;1;14;151;Montigny;335;12;347
24;Centre-Val de Loire;18;2;08;152;Montlouis;109;2;111
24;Centre-Val de Loire;18;2;08;153;Morlac;312;5;317
24;Centre-Val de Loire;18;2;10;154;Mornay-Berry;173;4;177
24;Centre-Val de Loire;18;2;09;155;Mornay-sur-Allier;426;3;429
24;Centre-Val de Loire;18;1;14;156;Morogues;432;4;436
24;Centre-Val de Loire;18;1;07;157;Morthomiers;765;23;788
24;Centre-Val de Loire;18;1;02;158;Moulins-sur-Yèvre;848;23;871
24;Centre-Val de Loire;18;3;01;159;Nançay;813;28;841
24;Centre-Val de Loire;18;2;10;160;Nérondes;1448;19;1467
24;Centre-Val de Loire;18;2;09;161;Neuilly-en-Dun;216;2;218
24;Centre-Val de Loire;18;1;14;162;Neuilly-en-Sancerre;252;1;253
24;Centre-Val de Loire;18;1;14;163;Neuvy-Deux-Clochers;269;5;274
24;Centre-Val de Loire;18;2;09;164;Neuvy-le-Barrois;137;2;139
24;Centre-Val de Loire;18;3;01;165;Neuvy-sur-Barangeon;1106;31;1137
24;Centre-Val de Loire;18;1;02;166;Nohant-en-Goût;561;10;571
24;Centre-Val de Loire;18;3;19;167;Nohant-en-Graçay;297;2;299
24;Centre-Val de Loire;18;1;16;168;Le Noyer;215;1;216
24;Centre-Val de Loire;18;2;12;169;Nozières;220;3;223
24;Centre-Val de Loire;18;3;01;170;Oizon;668;7;675
24;Centre-Val de Loire;18;2;12;171;Orcenais;249;7;256
24;Centre-Val de Loire;18;2;12;172;Orval;1745;35;1780
24;Centre-Val de Loire;18;2;09;173;Osmery;242;2;244
24;Centre-Val de Loire;18;1;02;174;Osmoy;264;3;267
24;Centre-Val de Loire;18;2;10;175;Ourouer-les-Bourdelins;611;9;620
24;Centre-Val de Loire;18;1;14;176;Parassy;410;5;415
24;Centre-Val de Loire;18;2;09;177;Parnay;54;0;54
24;Centre-Val de Loire;18;2;08;178;La Perche;194;3;197
24;Centre-Val de Loire;18;1;15;179;Pigny;994;16;1010
24;Centre-Val de Loire;18;1;17;180;Plaimpied-Givaudins;2091;67;2158
24;Centre-Val de Loire;18;1;07;181;Plou;545;10;555
24;Centre-Val de Loire;18;1;07;182;Poisieux;216;4;220
24;Centre-Val de Loire;18;2;09;183;Le Pondy;149;3;152
24;Centre-Val de Loire;18;1;02;184;Précy;349;1;350
24;Centre-Val de Loire;18;3;01;185;Presly;235;1;236
24;Centre-Val de Loire;18;3;11;186;Preuilly;439;6;445
24;Centre-Val de Loire;18;2;08;187;Préveranges;513;10;523
24;Centre-Val de Loire;18;1;07;188;Primelles;222;3;225
24;Centre-Val de Loire;18;1;15;189;Quantilly;481;4;485
24;Centre-Val de Loire;18;3;11;190;Quincy;828;21;849
24;Centre-Val de Loire;18;2;09;191;Raymond;177;3;180
24;Centre-Val de Loire;18;2;08;192;Reigny;233;3;236
24;Centre-Val de Loire;18;2;08;193;Rezay;202;5;207
24;Centre-Val de Loire;18;1;14;194;Rians;973;18;991
24;Centre-Val de Loire;18;2;09;195;Sagonne;189;5;194
24;Centre-Val de Loire;18;2;09;196;Saint-Aignan-des-Noyers;79;2;81
24;Centre-Val de Loire;18;2;12;197;Saint-Amand-Montrond;9490;295;9785
24;Centre-Val de Loire;18;1;07;198;Saint-Ambroix;374;16;390
24;Centre-Val de Loire;18;2;08;199;Saint-Baudel;251;3;254
24;Centre-Val de Loire;18;1;16;200;Saint-Bouize;293;7;300
24;Centre-Val de Loire;18;1;17;201;Saint-Caprais;778;15;793
24;Centre-Val de Loire;18;1;14;202;Saint-Céols;13;0;13
24;Centre-Val de Loire;18;2;08;203;Saint-Christophe-le-Chaudry;94;1;95
24;Centre-Val de Loire;18;2;09;204;Saint-Denis-de-Palin;286;8;294
24;Centre-Val de Loire;18;1;13;205;Saint-Doulchard;9664;226;9890
24;Centre-Val de Loire;18;1;15;206;Saint-Éloy-de-Gy;1553;54;1607
24;Centre-Val de Loire;18;1;07;207;Saint-Florent-sur-Cher;6432;95;6527
24;Centre-Val de Loire;18;1;16;208;Sainte-Gemme-en-Sancerrois;408;7;415
24;Centre-Val de Loire;18;2;08;209;Saint-Georges-de-Poisieux;442;15;457
24;Centre-Val de Loire;18;3;19;210;Saint-Georges-sur-la-Prée;603;12;615
24;Centre-Val de Loire;18;1;15;211;Saint-Georges-sur-Moulon;695;16;711
24;Centre-Val de Loire;18;2;09;212;Saint-Germain-des-Bois;637;14;651
24;Centre-Val de Loire;18;1;14;213;Saint-Germain-du-Puy;4995;111;5106
24;Centre-Val de Loire;18;3;19;214;Saint-Hilaire-de-Court;593;3;596
24;Centre-Val de Loire;18;2;10;215;Saint-Hilaire-de-Gondilly;142;2;144
24;Centre-Val de Loire;18;2;08;216;Saint-Hilaire-en-Lignières;484;13;497
24;Centre-Val de Loire;18;2;08;217;Saint-Jeanvrin;153;4;157
24;Centre-Val de Loire;18;1;17;218;Saint-Just;653;13;666
24;Centre-Val de Loire;18;3;15;219;Saint-Laurent;510;11;521
24;Centre-Val de Loire;18;1;02;220;Saint-Léger-le-Petit;346;4;350
24;Centre-Val de Loire;18;2;17;221;Saint-Loup-des-Chaumes;298;2;300
24;Centre-Val de Loire;18;1;15;223;Saint-Martin-d'Auxigny;2484;35;2519
24;Centre-Val de Loire;18;1;02;224;Saint-Martin-des-Champs;295;9;304
24;Centre-Val de Loire;18;2;08;225;Saint-Maur;268;8;276
24;Centre-Val de Loire;18;1;14;226;Saint-Michel-de-Volangis;463;15;478
24;Centre-Val de Loire;18;3;01;227;Sainte-Montaine;168;4;172
24;Centre-Val de Loire;18;3;19;228;Saint-Outrille;218;4;222
24;Centre-Val de Loire;18;1;15;229;Saint-Palais;615;19;634
24;Centre-Val de Loire;18;2;08;230;Saint-Pierre-les-Bois;283;11;294
24;Centre-Val de Loire;18;2;09;231;Saint-Pierre-les-Étieux;742;19;761
24;Centre-Val de Loire;18;2;08;232;Saint-Priest-la-Marche;244;2;246
24;Centre-Val de Loire;18;1;16;233;Saint-Satur;1396;26;1422
24;Centre-Val de Loire;18;2;08;234;Saint-Saturnin;429;8;437
24;Centre-Val de Loire;18;1;14;235;Sainte-Solange;1122;19;1141
24;Centre-Val de Loire;18;2;17;236;Saint-Symphorien;133;2;135
24;Centre-Val de Loire;18;3;11;237;Sainte-Thorette;476;10;486
24;Centre-Val de Loire;18;2;08;238;Saint-Vitte;127;4;131
24;Centre-Val de Loire;18;1;02;240;Sancergues;641;8;649
24;Centre-Val de Loire;18;1;16;241;Sancerre;1340;30;1370
24;Centre-Val de Loire;18;2;09;242;Sancoins;2943;33;2976
24;Centre-Val de Loire;18;1;16;243;Santranges;413;2;415
24;Centre-Val de Loire;18;1;07;244;Saugy;79;0;79
24;Centre-Val de Loire;18;2;08;245;Saulzais-le-Potier;484;9;493
24;Centre-Val de Loire;18;1;16;246;Savigny-en-Sancerre;1112;21;1133
24;Centre-Val de Loire;18;1;02;247;Savigny-en-Septaine;729;15;744
24;Centre-Val de Loire;18;1;17;248;Senneçay;468;6;474
24;Centre-Val de Loire;18;1;16;249;Sens-Beaujeu;402;13;415
24;Centre-Val de Loire;18;2;17;250;Serruelles;68;2;70
24;Centre-Val de Loire;18;1;02;251;Sévry;56;2;58
24;Centre-Val de Loire;18;2;08;252;Sidiailles;295;7;302
24;Centre-Val de Loire;18;1;14;253;Soulangis;466;12;478
24;Centre-Val de Loire;18;1;17;254;Soye-en-Septaine;595;15;610
24;Centre-Val de Loire;18;1;07;255;Le Subdray;990;204;1194
24;Centre-Val de Loire;18;1;16;256;Subligny;337;7;344
24;Centre-Val de Loire;18;1;16;257;Sury-près-Léré;662;14;676
24;Centre-Val de Loire;18;1;16;258;Sury-en-Vaux;690;17;707
24;Centre-Val de Loire;18;1;16;259;Sury-ès-Bois;279;3;282
24;Centre-Val de Loire;18;2;10;260;Tendron;88;1;89
24;Centre-Val de Loire;18;2;09;261;Thaumiers;403;6;409
24;Centre-Val de Loire;18;1;16;262;Thauvenay;325;8;333
24;Centre-Val de Loire;18;3;19;263;Thénioux;662;3;665
24;Centre-Val de Loire;18;1;16;264;Thou;81;2;83
24;Centre-Val de Loire;18;2;10;265;Torteron;792;12;804
24;Centre-Val de Loire;18;2;08;266;Touchay;232;7;239
24;Centre-Val de Loire;18;1;17;267;Trouy;3977;91;4068
24;Centre-Val de Loire;18;2;17;268;Uzay-le-Venon;405;10;415
24;Centre-Val de Loire;18;1;16;269;Vailly-sur-Sauldre;651;14;665
24;Centre-Val de Loire;18;2;17;270;Vallenay;708;21;729
24;Centre-Val de Loire;18;1;15;271;Vasselay;1528;33;1561
24;Centre-Val de Loire;18;1;16;272;Veaugues;630;22;652
24;Centre-Val de Loire;18;2;17;273;Venesmes;809;17;826
24;Centre-Val de Loire;18;1;16;274;Verdigny;312;3;315
24;Centre-Val de Loire;18;2;09;275;Vereaux;141;7;148
24;Centre-Val de Loire;18;2;09;276;Vernais;187;2;189
24;Centre-Val de Loire;18;2;09;277;Verneuil;35;0;35
24;Centre-Val de Loire;18;2;08;278;Vesdun;549;12;561
24;Centre-Val de Loire;18;3;99;279;Vierzon;25045;497;25542
24;Centre-Val de Loire;18;1;15;280;Vignoux-sous-les-Aix;715;21;736
24;Centre-Val de Loire;18;3;15;281;Vignoux-sur-Barangeon;2138;37;2175
24;Centre-Val de Loire;18;1;02;282;Villabon;575;14;589
24;Centre-Val de Loire;18;2;08;283;Villecelin;82;0;82
24;Centre-Val de Loire;18;1;16;284;Villegenon;212;4;216
24;Centre-Val de Loire;18;1;07;285;Villeneuve-sur-Cher;411;5;416
24;Centre-Val de Loire;18;1;02;286;Villequiers;460;7;467
24;Centre-Val de Loire;18;1;16;287;Vinon;294;7;301
24;Centre-Val de Loire;18;1;17;288;Vorly;249;6;255
24;Centre-Val de Loire;18;1;02;289;Vornay;590;16;606
24;Centre-Val de Loire;18;3;15;290;Vouzeron;593;10;603
75;Nouvelle-Aquitaine;19;2;15;001;Affieux;357;14;371
75;Nouvelle-Aquitaine;19;3;17;002;Aix;397;8;405
75;Nouvelle-Aquitaine;19;1;10;003;Albignac;231;9;240
75;Nouvelle-Aquitaine;19;2;02;004;Albussac;740;10;750
75;Nouvelle-Aquitaine;19;1;01;005;Allassac;3996;100;4096
75;Nouvelle-Aquitaine;19;3;12;006;Alleyrat;105;0;105
75;Nouvelle-Aquitaine;19;1;02;007;Altillac;829;21;850
75;Nouvelle-Aquitaine;19;3;12;008;Ambrugeat;207;4;211
75;Nouvelle-Aquitaine;19;2;11;009;Les Angles-sur-Corrèze;123;2;125
75;Nouvelle-Aquitaine;19;2;02;010;Argentat-sur-Dordogne;2887;113;3000
75;Nouvelle-Aquitaine;19;1;18;011;Arnac-Pompadour;1145;11;1156
75;Nouvelle-Aquitaine;19;1;10;012;Astaillac;213;4;217
75;Nouvelle-Aquitaine;19;1;10;013;Aubazines;873;21;894
75;Nouvelle-Aquitaine;19;2;02;014;Auriac;224;6;230
75;Nouvelle-Aquitaine;19;1;19;015;Ayen;703;7;710
75;Nouvelle-Aquitaine;19;2;11;016;Bar;303;9;312
75;Nouvelle-Aquitaine;19;2;02;017;Bassignac-le-Bas;85;1;86
75;Nouvelle-Aquitaine;19;2;02;018;Bassignac-le-Haut;156;4;160
75;Nouvelle-Aquitaine;19;1;10;019;Beaulieu-sur-Dordogne;1290;15;1305
75;Nouvelle-Aquitaine;19;2;15;020;Beaumont;112;8;120
75;Nouvelle-Aquitaine;19;3;12;021;Bellechassagne;94;2;96
75;Nouvelle-Aquitaine;19;1;18;022;Benayes;221;5;226
75;Nouvelle-Aquitaine;19;1;10;023;Beynat;1250;19;1269
75;Nouvelle-Aquitaine;19;1;18;024;Beyssac;592;23;615
75;Nouvelle-Aquitaine;19;1;18;025;Beyssenac;357;4;361
75;Nouvelle-Aquitaine;19;1;10;026;Bilhac;253;4;257
75;Nouvelle-Aquitaine;19;2;12;027;Bonnefond;115;0;115
75;Nouvelle-Aquitaine;19;3;08;028;Bort-les-Orgues;2595;101;2696
75;Nouvelle-Aquitaine;19;1;10;029;Branceilles;278;6;284
75;Nouvelle-Aquitaine;19;1;19;030;Brignac-la-Plaine;966;15;981
75;Nouvelle-Aquitaine;19;1;99;031;Brive-la-Gaillarde;45910;1265;47175
75;Nouvelle-Aquitaine;19;3;12;033;Bugeat;785;12;797
75;Nouvelle-Aquitaine;19;2;02;034;Camps-Saint-Mathurin-Léobazel;212;11;223
75;Nouvelle-Aquitaine;19;1;19;035;Chabrignac;540;20;560
75;Nouvelle-Aquitaine;19;2;15;036;Chamberet;1399;15;1414
75;Nouvelle-Aquitaine;19;2;15;037;Chamboulive;1168;28;1196
75;Nouvelle-Aquitaine;19;2;11;038;Chameyrat;1515;53;1568
75;Nouvelle-Aquitaine;19;3;07;039;Champagnac-la-Noaille;226;8;234
75;Nouvelle-Aquitaine;19;2;14;040;Champagnac-la-Prune;151;5;156
75;Nouvelle-Aquitaine;19;2;14;041;Chanac-les-Mines;433;18;451
75;Nouvelle-Aquitaine;19;2;15;042;Chanteix;629;13;642
75;Nouvelle-Aquitaine;19;1;05;043;La Chapelle-aux-Brocs;442;9;451
75;Nouvelle-Aquitaine;19;1;10;044;La Chapelle-aux-Saints;273;3;276
75;Nouvelle-Aquitaine;19;2;02;045;La Chapelle-Saint-Géraud;197;5;202
75;Nouvelle-Aquitaine;19;3;07;046;Chapelle-Spinasse;112;1;113
75;Nouvelle-Aquitaine;19;1;13;047;Chartrier-Ferrière;361;7;368
75;Nouvelle-Aquitaine;19;2;14;048;Le Chastang;351;12;363
75;Nouvelle-Aquitaine;19;1;13;049;Chasteaux;751;21;772
75;Nouvelle-Aquitaine;19;1;10;050;Chauffour-sur-Vell;414;8;422
75;Nouvelle-Aquitaine;19;3;07;051;Chaumeil;164;4;168
75;Nouvelle-Aquitaine;19;3;12;052;Chavanac;50;1;51
75;Nouvelle-Aquitaine;19;3;12;053;Chaveroche;271;5;276
75;Nouvelle-Aquitaine;19;1;10;054;Chenailler-Mascheix;211;4;215
75;Nouvelle-Aquitaine;19;3;08;055;Chirac-Bellevue;287;8;295
75;Nouvelle-Aquitaine;19;2;14;056;Clergoux;405;11;416
75;Nouvelle-Aquitaine;19;1;10;057;Collonges-la-Rouge;483;20;503
75;Nouvelle-Aquitaine;19;3;12;058;Combressol;355;10;365
75;Nouvelle-Aquitaine;19;1;19;059;Concèze;389;9;398
75;Nouvelle-Aquitaine;19;2;18;060;Condat-sur-Ganaveix;677;15;692
75;Nouvelle-Aquitaine;19;2;14;061;Cornil;1308;12;1320
75;Nouvelle-Aquitaine;19;2;11;062;Corrèze;1151;38;1189
75;Nouvelle-Aquitaine;19;1;05;063;Cosnac;3010;98;3108
75;Nouvelle-Aquitaine;19;3;17;064;Couffy-sur-Sarsonne;71;2;73
75;Nouvelle-Aquitaine;19;3;17;065;Courteix;69;1;70
75;Nouvelle-Aquitaine;19;1;13;066;Cublac;1727;37;1764
75;Nouvelle-Aquitaine;19;1;10;067;Curemonte;208;9;217
75;Nouvelle-Aquitaine;19;1;09;068;Dampniat;708;7;715
75;Nouvelle-Aquitaine;19;2;02;069;Darazac;141;3;144
75;Nouvelle-Aquitaine;19;3;12;070;Darnets;323;12;335
75;Nouvelle-Aquitaine;19;3;12;071;Davignac;211;4;215
75;Nouvelle-Aquitaine;19;1;01;072;Donzenac;2691;71;2762
75;Nouvelle-Aquitaine;19;3;07;073;Égletons;4274;734;5008
75;Nouvelle-Aquitaine;19;2;15;074;L'Église-aux-Bois;53;0;53
75;Nouvelle-Aquitaine;19;2;14;075;Espagnac;383;14;397
75;Nouvelle-Aquitaine;19;2;18;076;Espartignac;411;9;420
75;Nouvelle-Aquitaine;19;1;13;077;Estivals;132;7;139
75;Nouvelle-Aquitaine;19;1;01;078;Estivaux;412;8;420
75;Nouvelle-Aquitaine;19;2;18;079;Eyburie;491;10;501
75;Nouvelle-Aquitaine;19;3;17;080;Eygurande;691;11;702
75;Nouvelle-Aquitaine;19;2;14;081;Eyrein;506;15;521
75;Nouvelle-Aquitaine;19;2;11;082;Favars;1114;22;1136
75;Nouvelle-Aquitaine;19;3;17;083;Feyt;127;1;128
75;Nouvelle-Aquitaine;19;2;02;084;Forgès;260;12;272
75;Nouvelle-Aquitaine;19;2;11;085;Gimel-les-Cascades;782;16;798
75;Nouvelle-Aquitaine;19;2;02;086;Goulles;334;6;340
75;Nouvelle-Aquitaine;19;2;12;087;Gourdon-Murat;87;2;89
75;Nouvelle-Aquitaine;19;2;12;088;Grandsaigne;52;1;53
75;Nouvelle-Aquitaine;19;2;14;089;Gros-Chastang;190;4;194
75;Nouvelle-Aquitaine;19;2;14;090;Gumond;95;2;97
75;Nouvelle-Aquitaine;19;2;02;091;Hautefage;316;12;328
75;Nouvelle-Aquitaine;19;1;13;093;Jugeals-Nazareth;960;34;994
75;Nouvelle-Aquitaine;19;1;19;094;Juillac;1125;26;1151
75;Nouvelle-Aquitaine;19;2;15;095;Lacelle;131;1;132
75;Nouvelle-Aquitaine;19;2;14;096;Ladignac-sur-Rondelles;408;11;419
75;Nouvelle-Aquitaine;19;3;07;097;Lafage-sur-Sombre;135;1;136
75;Nouvelle-Aquitaine;19;2;14;098;Lagarde-Marc-la-Tour;958;23;981
75;Nouvelle-Aquitaine;19;1;10;099;Lagleygeolle;222;10;232
75;Nouvelle-Aquitaine;19;2;15;100;Lagraulière;1128;25;1153
75;Nouvelle-Aquitaine;19;2;14;101;Laguenne-sur-Avalouze;1541;47;1588
75;Nouvelle-Aquitaine;19;3;08;102;Lamazière-Basse;291;6;297
75;Nouvelle-Aquitaine;19;3;17;103;Lamazière-Haute;68;2;70
75;Nouvelle-Aquitaine;19;2;18;104;Lamongerie;118;2;120
75;Nouvelle-Aquitaine;19;1;10;105;Lanteuil;479;13;492
75;Nouvelle-Aquitaine;19;3;07;106;Lapleau;373;2;375
75;Nouvelle-Aquitaine;19;1;13;107;Larche;1629;40;1669
75;Nouvelle-Aquitaine;19;3;17;108;Laroche-près-Feyt;66;1;67
75;Nouvelle-Aquitaine;19;1;19;109;Lascaux;224;7;231
75;Nouvelle-Aquitaine;19;3;08;110;Latronche;126;1;127
75;Nouvelle-Aquitaine;19;3;07;111;Laval-sur-Luzège;102;2;104
75;Nouvelle-Aquitaine;19;2;12;112;Lestards;110;0;110
75;Nouvelle-Aquitaine;19;3;08;113;Liginiac;648;37;685
75;Nouvelle-Aquitaine;19;3;12;114;Lignareix;164;10;174
75;Nouvelle-Aquitaine;19;1;10;115;Ligneyrac;300;8;308
75;Nouvelle-Aquitaine;19;1;10;116;Liourdres;256;4;260
75;Nouvelle-Aquitaine;19;1;13;117;Lissac-sur-Couze;682;23;705
75;Nouvelle-Aquitaine;19;2;15;118;Le Lonzac;813;10;823
75;Nouvelle-Aquitaine;19;1;10;119;Lostanges;150;0;150
75;Nouvelle-Aquitaine;19;1;19;120;Louignac;241;6;247
75;Nouvelle-Aquitaine;19;1;18;121;Lubersac;2246;42;2288
75;Nouvelle-Aquitaine;19;2;15;122;Madranges;184;7;191
75;Nouvelle-Aquitaine;19;1;09;123;Malemort;8050;166;8216
75;Nouvelle-Aquitaine;19;1;13;124;Mansac;1479;21;1500
75;Nouvelle-Aquitaine;19;3;07;125;Marcillac-la-Croisille;807;14;821
75;Nouvelle-Aquitaine;19;1;10;126;Marcillac-la-Croze;172;0;172
75;Nouvelle-Aquitaine;19;3;08;128;Margerides;309;6;315
75;Nouvelle-Aquitaine;19;2;18;129;Masseret;660;8;668
75;Nouvelle-Aquitaine;19;3;12;130;Maussac;441;11;452
75;Nouvelle-Aquitaine;19;2;18;131;Meilhards;537;23;560
75;Nouvelle-Aquitaine;19;1;10;132;Ménoire;133;1;134
75;Nouvelle-Aquitaine;19;2;02;133;Mercœur;241;1;242
75;Nouvelle-Aquitaine;19;3;17;134;Merlines;697;18;715
75;Nouvelle-Aquitaine;19;3;08;135;Mestes;345;6;351
75;Nouvelle-Aquitaine;19;3;12;136;Meymac;2291;203;2494
75;Nouvelle-Aquitaine;19;3;11;137;Meyrignac-l'Église;63;0;63
75;Nouvelle-Aquitaine;19;1;10;138;Meyssac;1261;53;1314
75;Nouvelle-Aquitaine;19;3;12;139;Millevaches;73;1;74
75;Nouvelle-Aquitaine;19;2;02;140;Monceaux-sur-Dordogne;633;19;652
75;Nouvelle-Aquitaine;19;3;17;141;Monestier-Merlines;282;6;288
75;Nouvelle-Aquitaine;19;3;08;142;Monestier-Port-Dieu;111;1;112
75;Nouvelle-Aquitaine;19;3;07;143;Montaignac-sur-Doustre;655;12;667
75;Nouvelle-Aquitaine;19;1;18;144;Montgibaud;239;5;244
75;Nouvelle-Aquitaine;19;3;07;145;Moustier-Ventadour;442;77;519
75;Nouvelle-Aquitaine;19;2;11;146;Naves;2339;213;2552
75;Nouvelle-Aquitaine;19;1;13;147;Nespouls;637;12;649
75;Nouvelle-Aquitaine;19;3;08;148;Neuvic;1664;252;1916
75;Nouvelle-Aquitaine;19;2;02;149;Neuville;205;4;209
75;Nouvelle-Aquitaine;19;1;10;150;Noailhac;355;16;371
75;Nouvelle-Aquitaine;19;1;13;151;Noailles;936;19;955
75;Nouvelle-Aquitaine;19;1;10;152;Nonards;449;7;456
75;Nouvelle-Aquitaine;19;1;19;153;Objat;3662;81;3743
75;Nouvelle-Aquitaine;19;2;01;154;Orgnac-sur-Vézère;321;9;330
75;Nouvelle-Aquitaine;19;2;11;155;Orliac-de-Bar;262;5;267
75;Nouvelle-Aquitaine;19;1;10;156;Palazinges;165;2;167
75;Nouvelle-Aquitaine;19;3;08;157;Palisse;221;2;223
75;Nouvelle-Aquitaine;19;2;14;158;Pandrignes;166;4;170
75;Nouvelle-Aquitaine;19;3;12;159;Péret-Bel-Air;87;1;88
75;Nouvelle-Aquitaine;19;3;12;160;Pérols-sur-Vézère;194;2;196
75;Nouvelle-Aquitaine;19;1;19;161;Perpezac-le-Blanc;453;8;461
75;Nouvelle-Aquitaine;19;2;01;162;Perpezac-le-Noir;1223;17;1240
75;Nouvelle-Aquitaine;19;1;10;163;Le Pescher;313;3;316
75;Nouvelle-Aquitaine;19;3;12;164;Peyrelevade;830;11;841
75;Nouvelle-Aquitaine;19;2;15;165;Peyrissac;119;3;122
75;Nouvelle-Aquitaine;19;2;15;166;Pierrefitte;92;0;92
75;Nouvelle-Aquitaine;19;3;08;167;Confolent-Port-Dieu;42;0;42
75;Nouvelle-Aquitaine;19;2;12;168;Pradines;81;4;85
75;Nouvelle-Aquitaine;19;1;10;169;Puy-d'Arnac;291;2;293
75;Nouvelle-Aquitaine;19;1;10;170;Queyssac-les-Vignes;222;10;232
75;Nouvelle-Aquitaine;19;2;02;171;Reygade;187;3;190
75;Nouvelle-Aquitaine;19;2;15;172;Rilhac-Treignac;114;5;119
75;Nouvelle-Aquitaine;19;2;02;173;Rilhac-Xaintrie;307;10;317
75;Nouvelle-Aquitaine;19;2;14;174;La Roche-Canillac;127;1;128
75;Nouvelle-Aquitaine;19;3;08;175;Roche-le-Peyroux;97;0;97
75;Nouvelle-Aquitaine;19;3;07;176;Rosiers-d'Égletons;1095;34;1129
75;Nouvelle-Aquitaine;19;1;19;177;Rosiers-de-Juillac;175;4;179
75;Nouvelle-Aquitaine;19;1;01;178;Sadroc;981;23;1004
75;Nouvelle-Aquitaine;19;1;10;179;Saillac;201;6;207
75;Nouvelle-Aquitaine;19;3;12;180;Saint-Angel;702;18;720
75;Nouvelle-Aquitaine;19;2;11;181;Saint-Augustin;419;7;426
75;Nouvelle-Aquitaine;19;1;19;182;Saint-Aulaire;760;24;784
75;Nouvelle-Aquitaine;19;1;10;184;Saint-Bazile-de-Meyssac;127;4;131
75;Nouvelle-Aquitaine;19;2;02;186;Saint-Bonnet-Elvert;213;4;217
75;Nouvelle-Aquitaine;19;1;19;187;Saint-Bonnet-la-Rivière;412;5;417
75;Nouvelle-Aquitaine;19;1;01;188;Saint-Bonnet-l'Enfantier;419;6;425
75;Nouvelle-Aquitaine;19;2;02;189;Saint-Bonnet-les-Tours-de-Merle;41;1;42
75;Nouvelle-Aquitaine;19;3;08;190;Saint-Bonnet-près-Bort;189;5;194
75;Nouvelle-Aquitaine;19;1;13;191;Saint-Cernin-de-Larche;644;13;657
75;Nouvelle-Aquitaine;19;2;02;192;Saint-Chamant;503;6;509
75;Nouvelle-Aquitaine;19;2;02;193;Saint-Cirgues-la-Loutre;172;5;177
75;Nouvelle-Aquitaine;19;2;15;194;Saint-Clément;1342;42;1384
75;Nouvelle-Aquitaine;19;1;19;195;Saint-Cyprien;386;6;392
75;Nouvelle-Aquitaine;19;1;19;196;Saint-Cyr-la-Roche;469;21;490
75;Nouvelle-Aquitaine;19;1;18;198;Saint-Éloy-les-Tuileries;106;0;106
75;Nouvelle-Aquitaine;19;3;08;199;Saint-Étienne-aux-Clos;245;4;249
75;Nouvelle-Aquitaine;19;3;08;200;Saint-Étienne-la-Geneste;88;8;96
75;Nouvelle-Aquitaine;19;3;08;201;Saint-Exupéry-les-Roches;593;12;605
75;Nouvelle-Aquitaine;19;1;01;202;Sainte-Féréole;2019;45;2064
75;Nouvelle-Aquitaine;19;2;14;203;Sainte-Fortunade;1773;92;1865
75;Nouvelle-Aquitaine;19;3;08;204;Saint-Fréjoux;266;3;269
75;Nouvelle-Aquitaine;19;2;02;205;Saint-Geniez-ô-Merle;89;2;91
75;Nouvelle-Aquitaine;19;3;12;206;Saint-Germain-Lavolps;92;1;93
75;Nouvelle-Aquitaine;19;2;11;207;Saint-Germain-les-Vergnes;1136;33;1169
75;Nouvelle-Aquitaine;19;3;07;208;Saint-Hilaire-Foissac;182;3;185
75;Nouvelle-Aquitaine;19;2;15;209;Saint-Hilaire-les-Courbes;166;2;168
75;Nouvelle-Aquitaine;19;3;08;210;Saint-Hilaire-Luc;65;0;65
75;Nouvelle-Aquitaine;19;2;11;211;Saint-Hilaire-Peyroux;1009;21;1030
75;Nouvelle-Aquitaine;19;2;02;212;Saint-Hilaire-Taurieux;104;6;110
75;Nouvelle-Aquitaine;19;2;15;213;Saint-Jal;616;13;629
75;Nouvelle-Aquitaine;19;2;02;214;Saint-Julien-aux-Bois;445;3;448
75;Nouvelle-Aquitaine;19;2;02;215;Saint-Julien-le-Pèlerin;119;2;121
75;Nouvelle-Aquitaine;19;1;18;216;Saint-Julien-le-Vendômois;244;5;249
75;Nouvelle-Aquitaine;19;1;10;217;Saint-Julien-Maumont;151;5;156
75;Nouvelle-Aquitaine;19;3;08;219;Sainte-Marie-Lapanouze;55;0;55
75;Nouvelle-Aquitaine;19;2;14;220;Saint-Martial-de-Gimel;478;10;488
75;Nouvelle-Aquitaine;19;2;02;221;Saint-Martial-Entraygues;93;2;95
75;Nouvelle-Aquitaine;19;2;14;222;Saint-Martin-la-Méanne;338;12;350
75;Nouvelle-Aquitaine;19;1;18;223;Saint-Martin-Sepert;264;2;266
75;Nouvelle-Aquitaine;19;3;07;225;Saint-Merd-de-Lapleau;168;3;171
75;Nouvelle-Aquitaine;19;3;12;226;Saint-Merd-les-Oussines;122;1;123
75;Nouvelle-Aquitaine;19;2;11;227;Saint-Mexant;1319;36;1355
75;Nouvelle-Aquitaine;19;3;08;228;Saint-Pantaléon-de-Lapleau;66;0;66
75;Nouvelle-Aquitaine;19;1;13;229;Saint-Pantaléon-de-Larche;4808;98;4906
75;Nouvelle-Aquitaine;19;1;18;230;Saint-Pardoux-Corbier;390;8;398
75;Nouvelle-Aquitaine;19;2;14;231;Saint-Pardoux-la-Croisille;176;2;178
75;Nouvelle-Aquitaine;19;3;17;232;Saint-Pardoux-le-Neuf;78;2;80
75;Nouvelle-Aquitaine;19;3;12;233;Saint-Pardoux-le-Vieux;294;13;307
75;Nouvelle-Aquitaine;19;1;01;234;Saint-Pardoux-l'Ortigier;482;6;488
75;Nouvelle-Aquitaine;19;2;14;235;Saint-Paul;235;6;241
75;Nouvelle-Aquitaine;19;2;14;236;Saint-Priest-de-Gimel;475;10;485
75;Nouvelle-Aquitaine;19;2;02;237;Saint-Privat;1047;21;1068
75;Nouvelle-Aquitaine;19;3;12;238;Saint-Rémy;221;8;229
75;Nouvelle-Aquitaine;19;1;19;239;Saint-Robert;294;8;302
75;Nouvelle-Aquitaine;19;2;15;240;Saint-Salvadour;288;14;302
75;Nouvelle-Aquitaine;19;3;12;241;Saint-Setiers;282;4;286
75;Nouvelle-Aquitaine;19;1;19;242;Saint-Solve;455;18;473
75;Nouvelle-Aquitaine;19;1;18;243;Saint-Sornin-Lavolps;848;17;865
75;Nouvelle-Aquitaine;19;3;12;244;Saint-Sulpice-les-Bois;82;1;83
75;Nouvelle-Aquitaine;19;2;02;245;Saint-Sylvain;133;5;138
75;Nouvelle-Aquitaine;19;1;01;246;Saint-Viance;1883;43;1926
75;Nouvelle-Aquitaine;19;3;08;247;Saint-Victour;194;8;202
75;Nouvelle-Aquitaine;19;2;18;248;Saint-Ybard;694;13;707
75;Nouvelle-Aquitaine;19;3;07;249;Saint-Yrieix-le-Déjalat;338;4;342
75;Nouvelle-Aquitaine;19;2;18;250;Salon-la-Tour;675;6;681
75;Nouvelle-Aquitaine;19;3;07;251;Sarran;274;8;282
75;Nouvelle-Aquitaine;19;3;08;252;Sarroux - Saint Julien;853;16;869
75;Nouvelle-Aquitaine;19;1;19;253;Segonzac;222;2;224
75;Nouvelle-Aquitaine;19;1;18;254;Ségur-le-Château;202;1;203
75;Nouvelle-Aquitaine;19;2;15;255;Seilhac;1789;37;1826
75;Nouvelle-Aquitaine;19;3;08;256;Sérandon;345;6;351
75;Nouvelle-Aquitaine;19;1;10;257;Sérilhac;272;4;276
75;Nouvelle-Aquitaine;19;2;02;258;Servières-le-Château;595;9;604
75;Nouvelle-Aquitaine;19;2;02;259;Sexcles;232;4;236
75;Nouvelle-Aquitaine;19;1;10;260;Sioniac;218;7;225
75;Nouvelle-Aquitaine;19;3;12;261;Sornac;755;8;763
75;Nouvelle-Aquitaine;19;2;15;262;Soudaine-Lavinadière;145;16;161
75;Nouvelle-Aquitaine;19;3;12;263;Soudeilles;293;11;304
75;Nouvelle-Aquitaine;19;3;07;264;Soursac;508;4;512
75;Nouvelle-Aquitaine;19;2;12;265;Tarnac;348;8;356
75;Nouvelle-Aquitaine;19;3;08;266;Thalamy;103;4;107
75;Nouvelle-Aquitaine;19;2;12;268;Toy-Viam;37;0;37
75;Nouvelle-Aquitaine;19;2;15;269;Treignac;1268;84;1352
75;Nouvelle-Aquitaine;19;1;01;270;Troche;545;6;551
75;Nouvelle-Aquitaine;19;1;10;271;Tudeils;250;5;255
75;Nouvelle-Aquitaine;19;2;16;272;Tulle;14314;659;14973
75;Nouvelle-Aquitaine;19;1;13;273;Turenne;809;20;829
75;Nouvelle-Aquitaine;19;1;09;274;Ussac;4234;120;4354
75;Nouvelle-Aquitaine;19;3;17;275;Ussel;9162;368;9530
75;Nouvelle-Aquitaine;19;2;18;276;Uzerche;2787;59;2846
75;Nouvelle-Aquitaine;19;3;08;277;Valiergues;146;5;151
75;Nouvelle-Aquitaine;19;1;09;278;Varetz;2495;43;2538
75;Nouvelle-Aquitaine;19;1;19;279;Vars-sur-Roseix;396;10;406
75;Nouvelle-Aquitaine;19;1;10;280;Végennes;179;4;183
75;Nouvelle-Aquitaine;19;2;15;281;Veix;71;7;78
75;Nouvelle-Aquitaine;19;3;08;283;Veyrières;77;1;78
75;Nouvelle-Aquitaine;19;2;12;284;Viam;84;3;87
75;Nouvelle-Aquitaine;19;2;01;285;Vigeois;1285;32;1317
75;Nouvelle-Aquitaine;19;1;19;286;Vignols;533;9;542
75;Nouvelle-Aquitaine;19;2;07;287;Vitrac-sur-Montane;272;6;278
75;Nouvelle-Aquitaine;19;1;19;288;Voutezac;1235;169;1404
75;Nouvelle-Aquitaine;19;1;19;289;Yssandon;678;21;699
27;Bourgogne-Franche-Comté;21;1;20;001;Agencourt;457;52;509
27;Bourgogne-Franche-Comté;21;2;23;002;Agey;264;3;267
27;Bourgogne-Franche-Comté;21;2;14;003;Ahuy;1591;29;1620
27;Bourgogne-Franche-Comté;21;3;05;004;Aignay-le-Duc;266;6;272
27;Bourgogne-Franche-Comté;21;2;15;005;Aiserey;1467;16;1483
27;Bourgogne-Franche-Comté;21;3;05;006;Aisey-sur-Seine;172;1;173
27;Bourgogne-Franche-Comté;21;3;22;007;Aisy-sous-Thil;219;18;237
27;Bourgogne-Franche-Comté;21;3;19;008;Alise-Sainte-Reine;572;7;579
27;Bourgogne-Franche-Comté;21;1;01;009;Allerey;178;1;179
27;Bourgogne-Franche-Comté;21;1;17;010;Aloxe-Corton;134;6;140
27;Bourgogne-Franche-Comté;21;3;05;011;Ampilly-les-Bordes;83;0;83
27;Bourgogne-Franche-Comté;21;3;05;012;Ampilly-le-Sec;343;13;356
27;Bourgogne-Franche-Comté;21;2;23;013;Ancey;449;8;457
27;Bourgogne-Franche-Comté;21;1;01;014;Antheuil;62;0;62
27;Bourgogne-Franche-Comté;21;1;01;015;Antigny-la-Ville;90;0;90
27;Bourgogne-Franche-Comté;21;2;21;016;Arceau;987;17;1004
27;Bourgogne-Franche-Comté;21;1;20;017;Arcenant;505;18;523
27;Bourgogne-Franche-Comté;21;2;23;018;Arcey;53;1;54
27;Bourgogne-Franche-Comté;21;1;01;020;Arconcey;222;8;230
27;Bourgogne-Franche-Comté;21;2;21;021;Arc-sur-Tille;2608;48;2656
27;Bourgogne-Franche-Comté;21;1;20;022;Argilly;538;11;549
27;Bourgogne-Franche-Comté;21;1;01;023;Arnay-le-Duc;1377;30;1407
27;Bourgogne-Franche-Comté;21;3;22;024;Arnay-sous-Vitteaux;113;0;113
27;Bourgogne-Franche-Comté;21;3;19;025;Arrans;66;2;68
27;Bourgogne-Franche-Comté;21;3;19;026;Asnières-en-Montagne;190;8;198
27;Bourgogne-Franche-Comté;21;2;14;027;Asnières-lès-Dijon;1315;23;1338
27;Bourgogne-Franche-Comté;21;2;02;028;Athée;782;10;792
27;Bourgogne-Franche-Comté;21;3;19;029;Athie;77;1;78
27;Bourgogne-Franche-Comté;21;1;01;030;Aubaine;88;1;89
27;Bourgogne-Franche-Comté;21;1;04;031;Aubigny-en-Plaine;535;5;540
27;Bourgogne-Franche-Comté;21;1;01;032;Aubigny-la-Ronce;167;5;172
27;Bourgogne-Franche-Comté;21;2;23;033;Aubigny-lès-Sombernon;157;2;159
27;Bourgogne-Franche-Comté;21;3;05;034;Autricourt;133;1;134
27;Bourgogne-Franche-Comté;21;1;04;035;Auvillars-sur-Saône;336;4;340
27;Bourgogne-Franche-Comté;21;1;01;036;Auxant;79;3;82
27;Bourgogne-Franche-Comté;21;1;17;037;Auxey-Duresses;295;12;307
27;Bourgogne-Franche-Comté;21;2;02;038;Auxonne;7621;88;7709
27;Bourgogne-Franche-Comté;21;2;16;039;Avelanges;37;0;37
27;Bourgogne-Franche-Comté;21;3;22;040;Avosnes;98;2;100
27;Bourgogne-Franche-Comté;21;2;16;041;Avot;188;3;191
27;Bourgogne-Franche-Comté;21;1;04;042;Bagnot;159;4;163
27;Bourgogne-Franche-Comté;21;3;05;043;Baigneux-les-Juifs;210;9;219
27;Bourgogne-Franche-Comté;21;3;05;044;Balot;100;1;101
27;Bourgogne-Franche-Comté;21;2;23;045;Barbirey-sur-Ouche;208;8;216
27;Bourgogne-Franche-Comté;21;1;01;046;Bard-le-Régulier;71;1;72
27;Bourgogne-Franche-Comté;21;3;22;047;Bard-lès-Époisses;69;1;70
27;Bourgogne-Franche-Comté;21;1;20;048;Barges;655;10;665
27;Bourgogne-Franche-Comté;21;2;16;049;Barjon;43;2;45
27;Bourgogne-Franche-Comté;21;1;01;050;Baubigny;209;6;215
27;Bourgogne-Franche-Comté;21;2;23;051;Baulme-la-Roche;87;3;90
27;Bourgogne-Franche-Comté;21;3;05;052;Beaulieu;24;4;28
27;Bourgogne-Franche-Comté;21;2;21;053;Beaumont-sur-Vingeanne;200;3;203
27;Bourgogne-Franche-Comté;21;1;03;054;Beaune;20122;686;20808
27;Bourgogne-Franche-Comté;21;3;05;055;Beaunotte;14;0;14
27;Bourgogne-Franche-Comté;21;2;21;056;Beire-le-Châtel;886;13;899
27;Bourgogne-Franche-Comté;21;2;15;057;Beire-le-Fort;352;4;356
27;Bourgogne-Franche-Comté;21;3;05;058;Belan-sur-Ource;245;5;250
27;Bourgogne-Franche-Comté;21;2;14;059;Bellefond;895;26;921
27;Bourgogne-Franche-Comté;21;2;21;060;Belleneuve;1604;25;1629
27;Bourgogne-Franche-Comté;21;3;05;061;Bellenod-sur-Seine;67;2;69
27;Bourgogne-Franche-Comté;21;1;01;062;Bellenot-sous-Pouilly;215;9;224
27;Bourgogne-Franche-Comté;21;3;05;063;Beneuvre;89;6;95
27;Bourgogne-Franche-Comté;21;3;19;064;Benoisey;107;3;110
27;Bourgogne-Franche-Comté;21;1;01;065;Bessey-en-Chaume;124;4;128
27;Bourgogne-Franche-Comté;21;1;01;066;Bessey-la-Cour;51;1;52
27;Bourgogne-Franche-Comté;21;2;15;067;Bessey-lès-Cîteaux;686;9;695
27;Bourgogne-Franche-Comté;21;1;01;068;Beurey-Bauguay;101;5;106
27;Bourgogne-Franche-Comté;21;3;22;069;Beurizot;122;1;123
27;Bourgogne-Franche-Comté;21;1;18;070;Bévy;136;4;140
27;Bourgogne-Franche-Comté;21;2;21;071;Bèze;711;18;729
27;Bourgogne-Franche-Comté;21;2;21;072;Bézouotte;188;4;192
27;Bourgogne-Franche-Comté;21;2;02;074;Billey;251;4;255
27;Bourgogne-Franche-Comté;21;3;05;075;Billy-lès-Chanceaux;69;1;70
27;Bourgogne-Franche-Comté;21;2;02;076;Binges;845;8;853
27;Bourgogne-Franche-Comté;21;3;05;077;Bissey-la-Côte;130;2;132
27;Bourgogne-Franche-Comté;21;3;05;078;Bissey-la-Pierre;73;5;78
27;Bourgogne-Franche-Comté;21;2;21;079;Blagny-sur-Vingeanne;128;2;130
27;Bourgogne-Franche-Comté;21;2;23;080;Blaisy-Bas;639;14;653
27;Bourgogne-Franche-Comté;21;2;23;081;Blaisy-Haut;127;1;128
27;Bourgogne-Franche-Comté;21;1;01;082;Blancey;58;2;60
27;Bourgogne-Franche-Comté;21;1;01;083;Blanot;123;1;124
27;Bourgogne-Franche-Comté;21;3;19;084;Source-Seine;62;1;63
27;Bourgogne-Franche-Comté;21;2;14;085;Bligny-le-Sec;141;6;147
27;Bourgogne-Franche-Comté;21;1;17;086;Bligny-lès-Beaune;1243;28;1271
27;Bourgogne-Franche-Comté;21;1;01;087;Bligny-sur-Ouche;815;11;826
27;Bourgogne-Franche-Comté;21;1;20;088;Boncourt-le-Bois;278;7;285
27;Bourgogne-Franche-Comté;21;1;04;089;Bonnencontre;435;7;442
27;Bourgogne-Franche-Comté;21;3;05;090;Boudreville;61;3;64
27;Bourgogne-Franche-Comté;21;1;01;091;Bouhey;47;0;47
27;Bourgogne-Franche-Comté;21;1;17;092;Bouilland;228;5;233
27;Bourgogne-Franche-Comté;21;3;05;093;Bouix;150;4;154
27;Bourgogne-Franche-Comté;21;2;21;094;Bourberain;403;5;408
27;Bourgogne-Franche-Comté;21;1;04;095;Bousselange;47;2;49
27;Bourgogne-Franche-Comté;21;2;16;096;Boussenois;106;1;107
27;Bourgogne-Franche-Comté;21;3;22;097;Boussey;39;2;41
27;Bourgogne-Franche-Comté;21;3;19;098;Boux-sous-Salmaise;126;2;128
27;Bourgogne-Franche-Comté;21;1;17;099;Bouze-lès-Beaune;305;6;311
27;Bourgogne-Franche-Comté;21;3;22;100;Brain;34;0;34
27;Bourgogne-Franche-Comté;21;3;22;101;Braux;165;4;169
27;Bourgogne-Franche-Comté;21;1;01;102;Brazey-en-Morvan;140;3;143
27;Bourgogne-Franche-Comté;21;1;04;103;Brazey-en-Plaine;2378;28;2406
27;Bourgogne-Franche-Comté;21;3;05;104;Brémur-et-Vaurois;42;0;42
27;Bourgogne-Franche-Comté;21;2;07;105;Bressey-sur-Tille;1134;13;1147
27;Bourgogne-Franche-Comté;21;2;18;106;Bretenière;925;12;937
27;Bourgogne-Franche-Comté;21;2;14;107;Bretigny;905;24;929
27;Bourgogne-Franche-Comté;21;3;22;108;Brianny;111;1;112
27;Bourgogne-Franche-Comté;21;3;05;109;Brion-sur-Ource;216;7;223
27;Bourgogne-Franche-Comté;21;1;18;110;Brochon;660;130;790
27;Bourgogne-Franche-Comté;21;2;14;111;Brognon;319;3;322
27;Bourgogne-Franche-Comté;21;1;04;112;Broin;407;9;416
27;Bourgogne-Franche-Comté;21;1;20;113;Broindon;194;1;195
27;Bourgogne-Franche-Comté;21;3;19;114;Buffon;157;1;158
27;Bourgogne-Franche-Comté;21;3;05;115;Buncey;365;6;371
27;Bourgogne-Franche-Comté;21;3;05;116;Bure-les-Templiers;134;0;134
27;Bourgogne-Franche-Comté;21;3;05;117;Busseaut;48;2;50
27;Bourgogne-Franche-Comté;21;2;16;118;Busserotte-et-Montenaille;25;0;25
27;Bourgogne-Franche-Comté;21;2;16;119;Bussières;44;0;44
27;Bourgogne-Franche-Comté;21;1;01;120;La Bussière-sur-Ouche;160;2;162
27;Bourgogne-Franche-Comté;21;2;23;121;Bussy-la-Pesle;77;1;78
27;Bourgogne-Franche-Comté;21;3;19;122;Bussy-le-Grand;308;8;316
27;Bourgogne-Franche-Comté;21;3;05;123;Buxerolles;33;5;38
27;Bourgogne-Franche-Comté;21;1;01;124;Censerey;177;6;183
27;Bourgogne-Franche-Comté;21;3;05;125;Cérilly;218;8;226
27;Bourgogne-Franche-Comté;21;2;15;126;Cessey-sur-Tille;611;7;618
27;Bourgogne-Franche-Comté;21;2;16;127;Chaignay;517;7;524
27;Bourgogne-Franche-Comté;21;1;01;128;Chailly-sur-Armançon;253;8;261
27;Bourgogne-Franche-Comté;21;3;05;129;Chambain;21;0;21
27;Bourgogne-Franche-Comté;21;2;15;130;Chambeire;398;4;402
27;Bourgogne-Franche-Comté;21;1;04;131;Chamblanc;467;63;530
27;Bourgogne-Franche-Comté;21;1;18;132;Chambœuf;393;6;399
27;Bourgogne-Franche-Comté;21;1;18;133;Chambolle-Musigny;285;2;287
27;Bourgogne-Franche-Comté;21;3;05;134;Chamesson;241;8;249
27;Bourgogne-Franche-Comté;21;2;21;135;Champagne-sur-Vingeanne;309;9;318
27;Bourgogne-Franche-Comté;21;2;14;136;Champagny;26;0;26
27;Bourgogne-Franche-Comté;21;3;19;137;Champ-d'Oiseau;102;1;103
27;Bourgogne-Franche-Comté;21;2;02;138;Champdôtre;593;8;601
27;Bourgogne-Franche-Comté;21;3;22;139;Champeau-en-Morvan;222;5;227
27;Bourgogne-Franche-Comté;21;1;01;140;Champignolles;76;1;77
27;Bourgogne-Franche-Comté;21;3;22;141;Champrenault;36;1;37
27;Bourgogne-Franche-Comté;21;2;16;142;Chanceaux;214;3;217
27;Bourgogne-Franche-Comté;21;3;05;143;Channay;61;3;64
27;Bourgogne-Franche-Comté;21;3;19;144;Charencey;38;1;39
27;Bourgogne-Franche-Comté;21;3;22;145;Charigny;37;1;38
27;Bourgogne-Franche-Comté;21;2;21;146;Charmes;123;3;126
27;Bourgogne-Franche-Comté;21;3;22;147;Charny;35;1;36
27;Bourgogne-Franche-Comté;21;1;04;148;Charrey-sur-Saône;341;4;345
27;Bourgogne-Franche-Comté;21;3;05;149;Charrey-sur-Seine;137;3;140
27;Bourgogne-Franche-Comté;21;1;17;150;Chassagne-Montrachet;288;4;292
27;Bourgogne-Franche-Comté;21;3;22;151;Chassey;92;5;97
27;Bourgogne-Franche-Comté;21;1;01;152;Châteauneuf;80;2;82
27;Bourgogne-Franche-Comté;21;1;01;153;Châtellenot;155;6;161
27;Bourgogne-Franche-Comté;21;3;05;154;Châtillon-sur-Seine;5352;338;5690
27;Bourgogne-Franche-Comté;21;1;01;155;Chaudenay-la-Ville;39;5;44
27;Bourgogne-Franche-Comté;21;1;01;156;Chaudenay-le-Château;49;0;49
27;Bourgogne-Franche-Comté;21;3;05;157;Chaugey;18;1;19
27;Bourgogne-Franche-Comté;21;2;21;158;Chaume-et-Courchamp;180;5;185
27;Bourgogne-Franche-Comté;21;3;05;159;La Chaume;98;3;101
27;Bourgogne-Franche-Comté;21;3;05;160;Chaume-lès-Baigneux;101;1;102
27;Bourgogne-Franche-Comté;21;3;05;161;Chaumont-le-Bois;78;5;83
27;Bourgogne-Franche-Comté;21;1;20;162;Chaux;482;8;490
27;Bourgogne-Franche-Comté;21;2;16;163;Chazeuil;189;5;194
27;Bourgogne-Franche-Comté;21;1;01;164;Chazilly;143;3;146
27;Bourgogne-Franche-Comté;21;3;05;165;Chemin-d'Aisey;70;1;71
27;Bourgogne-Franche-Comté;21;2;06;166;Chenôve;14323;168;14491
27;Bourgogne-Franche-Comté;21;2;21;167;Cheuge;124;4;128
27;Bourgogne-Franche-Comté;21;3;22;168;Chevannay;37;0;37
27;Bourgogne-Franche-Comté;21;1;18;169;Chevannes;166;5;171
27;Bourgogne-Franche-Comté;21;1;17;170;Chevigny-en-Valière;391;4;395
27;Bourgogne-Franche-Comté;21;2;07;171;Chevigny-Saint-Sauveur;11055;206;11261
27;Bourgogne-Franche-Comté;21;1;04;172;Chivres;294;4;298
27;Bourgogne-Franche-Comté;21;1;17;173;Chorey-les-Beaune;625;23;648
27;Bourgogne-Franche-Comté;21;2;02;175;Cirey-lès-Pontailler;186;1;187
27;Bourgogne-Franche-Comté;21;1;01;176;Civry-en-Montagne;124;2;126
27;Bourgogne-Franche-Comté;21;3;22;177;Clamerey;177;1;178
27;Bourgogne-Franche-Comté;21;1;18;178;Valforêt;313;10;323
27;Bourgogne-Franche-Comté;21;2;14;179;Clénay;905;11;916
27;Bourgogne-Franche-Comté;21;2;02;180;Cléry;155;4;159
27;Bourgogne-Franche-Comté;21;1;01;181;Clomot;134;2;136
27;Bourgogne-Franche-Comté;21;1;18;182;Collonges-lès-Bévy;95;1;96
27;Bourgogne-Franche-Comté;21;2;15;183;Collonges-et-Premières;1064;13;1077
27;Bourgogne-Franche-Comté;21;1;01;184;Colombier;68;1;69
27;Bourgogne-Franche-Comté;21;1;17;185;Combertault;520;20;540
27;Bourgogne-Franche-Comté;21;1;20;186;Comblanchien;607;17;624
27;Bourgogne-Franche-Comté;21;1;01;187;Commarin;120;5;125
27;Bourgogne-Franche-Comté;21;1;17;189;Corberon;433;9;442
27;Bourgogne-Franche-Comté;21;1;17;190;Corcelles-les-Arts;441;19;460
27;Bourgogne-Franche-Comté;21;1;20;191;Corcelles-lès-Cîteaux;811;26;837
27;Bourgogne-Franche-Comté;21;2;13;192;Corcelles-les-Monts;632;10;642
27;Bourgogne-Franche-Comté;21;1;17;193;Corgengoux;365;16;381
27;Bourgogne-Franche-Comté;21;1;20;194;Corgoloin;951;13;964
27;Bourgogne-Franche-Comté;21;1;01;195;Cormot-Vauchignon;216;4;220
27;Bourgogne-Franche-Comté;21;1;17;196;Corpeau;975;16;991
27;Bourgogne-Franche-Comté;21;3;19;197;Corpoyer-la-Chapelle;34;0;34
27;Bourgogne-Franche-Comté;21;3;22;198;Corrombles;251;10;261
27;Bourgogne-Franche-Comté;21;3;22;199;Corsaint;150;1;151
27;Bourgogne-Franche-Comté;21;1;18;200;Couchey;1104;25;1129
27;Bourgogne-Franche-Comté;21;3;05;201;Coulmier-le-Sec;240;5;245
27;Bourgogne-Franche-Comté;21;3;05;202;Courban;145;1;146
27;Bourgogne-Franche-Comté;21;3;22;203;Courcelles-Frémoy;130;1;131
27;Bourgogne-Franche-Comté;21;3;19;204;Courcelles-lès-Montbard;87;1;88
27;Bourgogne-Franche-Comté;21;3;22;205;Courcelles-lès-Semur;240;6;246
27;Bourgogne-Franche-Comté;21;2;16;207;Courlon;76;4;80
27;Bourgogne-Franche-Comté;21;2;16;208;Courtivron;162;4;166
27;Bourgogne-Franche-Comté;21;2;21;209;Couternon;1920;41;1961
27;Bourgogne-Franche-Comté;21;1;01;210;Créancey;528;15;543
27;Bourgogne-Franche-Comté;21;2;16;211;Crécey-sur-Tille;128;2;130
27;Bourgogne-Franche-Comté;21;3;19;212;Crépand;320;5;325
27;Bourgogne-Franche-Comté;21;1;01;214;Crugey;168;4;172
27;Bourgogne-Franche-Comté;21;2;21;215;Cuiserey;182;5;187
27;Bourgogne-Franche-Comté;21;1;01;216;Culètre;107;2;109
27;Bourgogne-Franche-Comté;21;1;18;217;Curley;132;4;136
27;Bourgogne-Franche-Comté;21;2;14;218;Curtil-Saint-Seine;116;0;116
27;Bourgogne-Franche-Comté;21;1;18;219;Curtil-Vergy;141;0;141
27;Bourgogne-Franche-Comté;21;2;16;220;Cussey-les-Forges;143;3;146
27;Bourgogne-Franche-Comté;21;1;01;221;Cussy-la-Colonne;39;2;41
27;Bourgogne-Franche-Comté;21;1;01;222;Cussy-le-Châtel;119;3;122
27;Bourgogne-Franche-Comté;21;2;14;223;Daix;1541;34;1575
27;Bourgogne-Franche-Comté;21;3;22;224;Dampierre-en-Montagne;61;4;65
27;Bourgogne-Franche-Comté;21;2;21;225;Dampierre-et-Flée;130;2;132
27;Bourgogne-Franche-Comté;21;3;19;226;Darcey;338;11;349
27;Bourgogne-Franche-Comté;21;2;14;227;Darois;500;8;508
27;Bourgogne-Franche-Comté;21;1;18;228;Détain-et-Bruant;142;0;142
27;Bourgogne-Franche-Comté;21;1;01;229;Diancey;95;2;97
27;Bourgogne-Franche-Comté;21;2;16;230;Diénay;378;8;386
27;Bourgogne-Franche-Comté;21;2;99;231;Dijon;159106;3348;162454
27;Bourgogne-Franche-Comté;21;3;22;232;Dompierre-en-Morvan;201;5;206
27;Bourgogne-Franche-Comté;21;2;02;233;Drambon;200;1;201
27;Bourgogne-Franche-Comté;21;2;23;234;Drée;63;0;63
27;Bourgogne-Franche-Comté;21;3;05;235;Duesme;51;3;54
27;Bourgogne-Franche-Comté;21;1;17;236;Ébaty;252;6;258
27;Bourgogne-Franche-Comté;21;3;05;237;Échalot;95;3;98
27;Bourgogne-Franche-Comté;21;2;23;238;Échannay;141;2;143
27;Bourgogne-Franche-Comté;21;1;04;239;Échenon;776;9;785
27;Bourgogne-Franche-Comté;21;2;16;240;Échevannes;322;2;324
27;Bourgogne-Franche-Comté;21;1;17;241;Échevronne;296;16;312
27;Bourgogne-Franche-Comté;21;2;15;242;Échigey;300;7;307
27;Bourgogne-Franche-Comté;21;1;01;243;Écutigny;75;2;77
27;Bourgogne-Franche-Comté;21;1;01;244;Éguilly;69;0;69
27;Bourgogne-Franche-Comté;21;2;16;245;Épagny;320;3;323
27;Bourgogne-Franche-Comté;21;1;20;246;Épernay-sous-Gevrey;174;4;178
27;Bourgogne-Franche-Comté;21;3;22;247;Époisses;769;7;776
27;Bourgogne-Franche-Comté;21;3;19;248;Éringes;59;1;60
27;Bourgogne-Franche-Comté;21;1;04;249;Esbarres;666;22;688
27;Bourgogne-Franche-Comté;21;3;05;250;Essarois;83;2;85
27;Bourgogne-Franche-Comté;21;1;01;251;Essey;284;27;311
27;Bourgogne-Franche-Comté;21;3;19;252;Étais;76;4;80
27;Bourgogne-Franche-Comté;21;3;05;253;Étalante;129;4;133
27;Bourgogne-Franche-Comté;21;1;18;254;L'Étang-Vergy;205;10;215
27;Bourgogne-Franche-Comté;21;2;14;255;Étaules;348;4;352
27;Bourgogne-Franche-Comté;21;2;02;256;Étevaux;314;7;321
27;Bourgogne-Franche-Comté;21;3;05;257;Étormay;68;2;70
27;Bourgogne-Franche-Comté;21;3;05;258;Étrochey;219;4;223
27;Bourgogne-Franche-Comté;21;3;19;259;Fain-lès-Montbard;280;10;290
27;Bourgogne-Franche-Comté;21;3;19;260;Fain-lès-Moutiers;150;4;154
27;Bourgogne-Franche-Comté;21;2;15;261;Fauverney;619;11;630
27;Bourgogne-Franche-Comté;21;3;05;262;Faverolles-lès-Lucey;30;0;30
27;Bourgogne-Franche-Comté;21;2;18;263;Fénay;1673;40;1713
27;Bourgogne-Franche-Comté;21;1;01;264;Le Fête;41;0;41
27;Bourgogne-Franche-Comté;21;1;18;265;Fixin;748;21;769
27;Bourgogne-Franche-Comté;21;2;14;266;Flacey;198;2;200
27;Bourgogne-Franche-Comté;21;1;20;267;Flagey-Echézeaux;501;13;514
27;Bourgogne-Franche-Comté;21;2;02;268;Flagey-lès-Auxonne;191;3;194
27;Bourgogne-Franche-Comté;21;2;02;269;Flammerans;450;9;459
27;Bourgogne-Franche-Comté;21;2;13;270;Flavignerot;215;4;219
27;Bourgogne-Franche-Comté;21;3;19;271;Flavigny-sur-Ozerain;274;3;277
27;Bourgogne-Franche-Comté;21;3;22;272;Le Val-Larrey;267;5;272
27;Bourgogne-Franche-Comté;21;2;23;273;Fleurey-sur-Ouche;1442;18;1460
27;Bourgogne-Franche-Comté;21;1;01;274;Foissy;164;3;167
27;Bourgogne-Franche-Comté;21;2;16;275;Foncegrive;132;3;135
27;Bourgogne-Franche-Comté;21;3;05;276;Fontaines-en-Duesmois;117;4;121
27;Bourgogne-Franche-Comté;21;2;21;277;Fontaine-Française;883;19;902
27;Bourgogne-Franche-Comté;21;2;14;278;Fontaine-lès-Dijon;8756;201;8957
27;Bourgogne-Franche-Comté;21;3;19;279;Fontaines-les-Sèches;25;0;25
27;Bourgogne-Franche-Comté;21;3;22;280;Fontangy;142;2;144
27;Bourgogne-Franche-Comté;21;2;21;281;Fontenelle;170;1;171
27;Bourgogne-Franche-Comté;21;3;22;282;Forléans;105;2;107
27;Bourgogne-Franche-Comté;21;2;16;283;Fraignot-et-Vesvrotte;66;1;67
27;Bourgogne-Franche-Comté;21;2;16;284;Francheville;280;8;288
27;Bourgogne-Franche-Comté;21;1;04;285;Franxault;501;6;507
27;Bourgogne-Franche-Comté;21;2;16;286;Frénois;88;1;89
27;Bourgogne-Franche-Comté;21;3;19;287;Fresnes;155;7;162
27;Bourgogne-Franche-Comté;21;3;19;288;Frôlois;162;1;163
27;Bourgogne-Franche-Comté;21;1;20;289;Fussey;116;8;124
27;Bourgogne-Franche-Comté;21;2;16;290;Gemeaux;923;15;938
27;Bourgogne-Franche-Comté;21;3;22;291;Genay;367;10;377
27;Bourgogne-Franche-Comté;21;2;15;292;Genlis;5190;44;5234
27;Bourgogne-Franche-Comté;21;2;23;293;Gergueil;119;0;119
27;Bourgogne-Franche-Comté;21;1;20;294;Gerland;435;9;444
27;Bourgogne-Franche-Comté;21;1;18;295;Gevrey-Chambertin;3115;44;3159
27;Bourgogne-Franche-Comté;21;3;05;296;Gevrolles;176;0;176
27;Bourgogne-Franche-Comté;21;1;20;297;Gilly-lès-Cîteaux;729;5;734
27;Bourgogne-Franche-Comté;21;3;22;298;Gissey-le-Vieil;105;3;108
27;Bourgogne-Franche-Comté;21;3;19;299;Gissey-sous-Flavigny;88;1;89
27;Bourgogne-Franche-Comté;21;2;23;300;Gissey-sur-Ouche;354;9;363
27;Bourgogne-Franche-Comté;21;1;04;301;Glanon;270;3;273
27;Bourgogne-Franche-Comté;21;3;05;302;Gomméville;122;2;124
27;Bourgogne-Franche-Comté;21;3;05;303;Les Goulles;12;0;12
27;Bourgogne-Franche-Comté;21;2;16;304;Grancey-le-Château-Neuvelle;257;9;266
27;Bourgogne-Franche-Comté;21;3;05;305;Grancey-sur-Ource;193;1;194
27;Bourgogne-Franche-Comté;21;2;23;306;Grenant-lès-Sombernon;212;4;216
27;Bourgogne-Franche-Comté;21;3;19;307;Grésigny-Sainte-Reine;144;4;148
27;Bourgogne-Franche-Comté;21;3;19;308;Grignon;200;12;212
27;Bourgogne-Franche-Comté;21;3;05;309;Griselles;86;4;90
27;Bourgogne-Franche-Comté;21;2;23;310;Grosbois-en-Montagne;113;2;115
27;Bourgogne-Franche-Comté;21;1;04;311;Grosbois-lès-Tichey;71;2;73
27;Bourgogne-Franche-Comté;21;3;05;312;Gurgy-la-Ville;26;3;29
27;Bourgogne-Franche-Comté;21;3;05;313;Gurgy-le-Château;46;0;46
27;Bourgogne-Franche-Comté;21;3;19;314;Hauteroche;79;2;81
27;Bourgogne-Franche-Comté;21;2;14;315;Hauteville-lès-Dijon;1228;17;1245
27;Bourgogne-Franche-Comté;21;2;02;316;Heuilley-sur-Saône;325;4;329
27;Bourgogne-Franche-Comté;21;2;16;317;Is-sur-Tille;4360;76;4436
27;Bourgogne-Franche-Comté;21;2;15;319;Izeure;905;14;919
27;Bourgogne-Franche-Comté;21;2;15;320;Izier;790;13;803
27;Bourgogne-Franche-Comté;21;3;19;321;Jailly-les-Moulins;75;2;77
27;Bourgogne-Franche-Comté;21;1;04;322;Jallanges;308;13;321
27;Bourgogne-Franche-Comté;21;2;21;323;Jancigny;143;2;145
27;Bourgogne-Franche-Comté;21;3;22;324;Jeux-lès-Bard;52;1;53
27;Bourgogne-Franche-Comté;21;1;01;325;Jouey;184;2;186
27;Bourgogne-Franche-Comté;21;3;05;326;Jours-lès-Baigneux;72;4;76
27;Bourgogne-Franche-Comté;21;1;01;327;Val-Mont;252;4;256
27;Bourgogne-Franche-Comté;21;3;22;328;Juillenay;49;0;49
27;Bourgogne-Franche-Comté;21;3;22;329;Juilly;39;2;41
27;Bourgogne-Franche-Comté;21;2;15;330;Labergement-Foigney;376;3;379
27;Bourgogne-Franche-Comté;21;2;02;331;Labergement-lès-Auxonne;333;4;337
27;Bourgogne-Franche-Comté;21;1;04;332;Labergement-lès-Seurre;1002;12;1014
27;Bourgogne-Franche-Comté;21;1;04;333;Labruyère;225;5;230
27;Bourgogne-Franche-Comté;21;1;01;334;Lacanche;488;12;500
27;Bourgogne-Franche-Comté;21;3;22;335;Lacour-d'Arcenay;112;3;115
27;Bourgogne-Franche-Comté;21;3;05;336;Laignes;664;11;675
27;Bourgogne-Franche-Comté;21;2;02;337;Lamarche-sur-Saône;1359;17;1376
27;Bourgogne-Franche-Comté;21;2;16;338;Lamargelle;157;8;165
27;Bourgogne-Franche-Comté;21;2;23;339;Lantenay;511;19;530
27;Bourgogne-Franche-Comté;21;1;04;340;Lanthes;251;5;256
27;Bourgogne-Franche-Comté;21;3;22;341;Lantilly;103;4;107
27;Bourgogne-Franche-Comté;21;1;04;342;Laperrière-sur-Saône;433;8;441
27;Bourgogne-Franche-Comté;21;3;05;343;Larrey;95;2;97
27;Bourgogne-Franche-Comté;21;1;04;344;Lechâtelet;222;5;227
27;Bourgogne-Franche-Comté;21;2;16;345;Léry;193;1;194
27;Bourgogne-Franche-Comté;21;3;05;346;Leuglay;298;3;301
27;Bourgogne-Franche-Comté;21;1;17;347;Levernois;342;17;359
27;Bourgogne-Franche-Comté;21;2;21;348;Licey-sur-Vingeanne;103;1;104
27;Bourgogne-Franche-Comté;21;1;01;349;Liernais;480;5;485
27;Bourgogne-Franche-Comté;21;3;05;350;Lignerolles;55;1;56
27;Bourgogne-Franche-Comté;21;2;15;351;Longchamp;1163;121;1284
27;Bourgogne-Franche-Comté;21;2;15;352;Longeault-Pluvault;1143;23;1166
27;Bourgogne-Franche-Comté;21;2;15;353;Longecourt-en-Plaine;1220;24;1244
27;Bourgogne-Franche-Comté;21;1;01;354;Longecourt-lès-Culêtre;55;0;55
27;Bourgogne-Franche-Comté;21;2;18;355;Longvic;8631;131;8762
27;Bourgogne-Franche-Comté;21;1;04;356;Losne;1635;18;1653
27;Bourgogne-Franche-Comté;21;3;05;357;Louesme;116;2;118
27;Bourgogne-Franche-Comté;21;3;19;358;Lucenay-le-Duc;187;4;191
27;Bourgogne-Franche-Comté;21;3;05;359;Lucey;57;3;60
27;Bourgogne-Franche-Comté;21;1;01;360;Lusigny-sur-Ouche;119;3;122
27;Bourgogne-Franche-Comté;21;2;16;361;Lux;512;11;523
27;Bourgogne-Franche-Comté;21;1;01;362;Maconge;132;3;135
27;Bourgogne-Franche-Comté;21;1;01;363;Magnien;318;4;322
27;Bourgogne-Franche-Comté;21;3;05;364;Magny-Lambert;81;3;84
27;Bourgogne-Franche-Comté;21;3;22;365;Magny-la-Ville;78;0;78
27;Bourgogne-Franche-Comté;21;1;04;366;Magny-lès-Aubigny;218;6;224
27;Bourgogne-Franche-Comté;21;2;02;367;Magny-Montarlot;260;5;265
27;Bourgogne-Franche-Comté;21;1;20;368;Magny-lès-Villers;242;12;254
27;Bourgogne-Franche-Comté;21;2;21;369;Magny-Saint-Médard;315;4;319
27;Bourgogne-Franche-Comté;21;2;07;370;Magny-sur-Tille;894;19;913
27;Bourgogne-Franche-Comté;21;2;02;371;Les Maillys;804;20;824
27;Bourgogne-Franche-Comté;21;3;05;372;Maisey-le-Duc;82;5;87
27;Bourgogne-Franche-Comté;21;2;23;373;Mâlain;784;15;799
27;Bourgogne-Franche-Comté;21;1;01;374;Maligny;180;6;186
27;Bourgogne-Franche-Comté;21;1;01;375;Manlay;195;5;200
27;Bourgogne-Franche-Comté;21;2;02;376;Marandeuil;102;1;103
27;Bourgogne-Franche-Comté;21;3;22;377;Marcellois;46;0;46
27;Bourgogne-Franche-Comté;21;3;05;378;Marcenay;90;2;92
27;Bourgogne-Franche-Comté;21;1;01;379;Marcheseuil;155;1;156
27;Bourgogne-Franche-Comté;21;3;22;380;Marcigny-sous-Thil;55;2;57
27;Bourgogne-Franche-Comté;21;3;22;381;Marcilly-et-Dracy;90;4;94
27;Bourgogne-Franche-Comté;21;1;01;382;Marcilly-Ogny;188;3;191
27;Bourgogne-Franche-Comté;21;2;16;383;Marcilly-sur-Tille;1713;19;1732
27;Bourgogne-Franche-Comté;21;1;20;384;Marey-lès-Fussey;65;1;66
27;Bourgogne-Franche-Comté;21;2;16;385;Marey-sur-Tille;326;7;333
27;Bourgogne-Franche-Comté;21;3;19;386;Marigny-le-Cahouët;326;12;338
27;Bourgogne-Franche-Comté;21;1;17;387;Marigny-lès-Reullée;218;5;223
27;Bourgogne-Franche-Comté;21;2;15;388;Marliens;597;11;608
27;Bourgogne-Franche-Comté;21;3;19;389;Marmagne;203;1;204
27;Bourgogne-Franche-Comté;21;2;06;390;Marsannay-la-Côte;5311;74;5385
27;Bourgogne-Franche-Comté;21;2;16;391;Marsannay-le-Bois;841;10;851
27;Bourgogne-Franche-Comté;21;1;01;392;Martrois;60;2;62
27;Bourgogne-Franche-Comté;21;3;05;393;Massingy;159;4;163
27;Bourgogne-Franche-Comté;21;3;22;394;Massingy-lès-Semur;156;5;161
27;Bourgogne-Franche-Comté;21;3;22;395;Massingy-lès-Vitteaux;92;1;93
27;Bourgogne-Franche-Comté;21;3;05;396;Mauvilly;68;2;70
27;Bourgogne-Franche-Comté;21;1;17;397;Mavilly-Mandelot;177;3;180
27;Bourgogne-Franche-Comté;21;2;02;398;Maxilly-sur-Saône;362;8;370
27;Bourgogne-Franche-Comté;21;1;01;399;Meilly-sur-Rouvres;220;2;222
27;Bourgogne-Franche-Comté;21;2;16;400;Le Meix;46;0;46
27;Bourgogne-Franche-Comté;21;1;17;401;Meloisey;320;10;330
27;Bourgogne-Franche-Comté;21;3;05;402;Menesble;12;0;12
27;Bourgogne-Franche-Comté;21;1;01;403;Ménessaire;86;1;87
27;Bourgogne-Franche-Comté;21;3;19;404;Ménétreux-le-Pitois;409;9;418
27;Bourgogne-Franche-Comté;21;1;17;405;Merceuil;804;22;826
27;Bourgogne-Franche-Comté;21;2;23;406;Mesmont;254;2;256
27;Bourgogne-Franche-Comté;21;1;18;407;Messanges;240;9;249
27;Bourgogne-Franche-Comté;21;2;14;408;Messigny-et-Vantoux;1705;29;1734
27;Bourgogne-Franche-Comté;21;1;20;409;Meuilley;448;7;455
27;Bourgogne-Franche-Comté;21;3;05;410;Meulson;29;2;31
27;Bourgogne-Franche-Comté;21;1;17;411;Meursanges;570;18;588
27;Bourgogne-Franche-Comté;21;1;17;412;Meursault;1404;45;1449
27;Bourgogne-Franche-Comté;21;3;22;413;Millery;405;15;420
27;Bourgogne-Franche-Comté;21;1;01;414;Mimeure;319;9;328
27;Bourgogne-Franche-Comté;21;3;05;415;Minot;181;7;188
27;Bourgogne-Franche-Comté;21;2;21;416;Mirebeau-sur-Bèze;1972;36;2008
27;Bourgogne-Franche-Comté;21;3;22;417;Missery;107;0;107
27;Bourgogne-Franche-Comté;21;3;05;418;Moitron;58;4;62
27;Bourgogne-Franche-Comté;21;3;05;419;Molesme;264;5;269
27;Bourgogne-Franche-Comté;21;1;01;420;Molinot;160;4;164
27;Bourgogne-Franche-Comté;21;2;16;421;Moloy;237;3;240
27;Bourgogne-Franche-Comté;21;3;22;422;Molphey;130;4;134
27;Bourgogne-Franche-Comté;21;1;17;423;Montagny-lès-Beaune;756;19;775
27;Bourgogne-Franche-Comté;21;1;04;424;Montagny-lès-Seurre;112;2;114
27;Bourgogne-Franche-Comté;21;3;19;425;Montbard;4831;134;4965
27;Bourgogne-Franche-Comté;21;3;22;426;Montberthault;208;4;212
27;Bourgogne-Franche-Comté;21;1;01;427;Montceau-et-Écharnant;192;5;197
27;Bourgogne-Franche-Comté;21;1;17;428;Monthelie;159;2;161
27;Bourgogne-Franche-Comté;21;3;19;429;Montigny-Montfort;295;6;301
27;Bourgogne-Franche-Comté;21;3;22;430;Montigny-Saint-Barthélemy;85;5;90
27;Bourgogne-Franche-Comté;21;3;22;431;Montigny-sur-Armançon;150;4;154
27;Bourgogne-Franche-Comté;21;3;05;432;Montigny-sur-Aube;250;4;254
27;Bourgogne-Franche-Comté;21;2;21;433;Montigny-Mornay-Villeneuve-sur-Vingeanne;383;7;390
27;Bourgogne-Franche-Comté;21;3;22;434;Montlay-en-Auxois;193;2;195
27;Bourgogne-Franche-Comté;21;3;05;435;Montliot-et-Courcelles;298;6;304
27;Bourgogne-Franche-Comté;21;1;04;436;Montmain;150;1;151
27;Bourgogne-Franche-Comté;21;2;02;437;Montmançon;244;5;249
27;Bourgogne-Franche-Comté;21;3;05;438;Montmoyen;73;2;75
27;Bourgogne-Franche-Comté;21;2;23;439;Montoillot;91;0;91
27;Bourgogne-Franche-Comté;21;1;04;440;Montot;198;5;203
27;Bourgogne-Franche-Comté;21;1;01;441;Mont-Saint-Jean;236;7;243
27;Bourgogne-Franche-Comté;21;1;18;442;Morey-Saint-Denis;669;10;679
27;Bourgogne-Franche-Comté;21;3;05;444;Mosson;68;0;68
27;Bourgogne-Franche-Comté;21;3;22;445;La Motte-Ternant;147;2;149
27;Bourgogne-Franche-Comté;21;3;19;446;Moutiers-Saint-Jean;260;5;265
27;Bourgogne-Franche-Comté;21;1;01;447;Musigny;84;0;84
27;Bourgogne-Franche-Comté;21;3;19;448;Mussy-la-Fosse;90;2;92
27;Bourgogne-Franche-Comté;21;3;22;449;Nan-sous-Thil;178;6;184
27;Bourgogne-Franche-Comté;21;1;17;450;Nantoux;166;4;170
27;Bourgogne-Franche-Comté;21;3;19;451;Nesle-et-Massoult;77;1;78
27;Bourgogne-Franche-Comté;21;2;07;452;Neuilly-Crimolois;3104;37;3141
27;Bourgogne-Franche-Comté;21;3;05;454;Nicey;109;0;109
27;Bourgogne-Franche-Comté;21;3;05;455;Nod-sur-Seine;202;3;205
27;Bourgogne-Franche-Comté;21;3;19;456;Nogent-lès-Montbard;153;8;161
27;Bourgogne-Franche-Comté;21;3;22;457;Noidan;73;5;78
27;Bourgogne-Franche-Comté;21;1;20;458;Noiron-sous-Gevrey;1150;28;1178
27;Bourgogne-Franche-Comté;21;2;21;459;Noiron-sur-Bèze;231;5;236
27;Bourgogne-Franche-Comté;21;3;05;460;Noiron-sur-Seine;63;1;64
27;Bourgogne-Franche-Comté;21;1;01;461;Nolay;1426;22;1448
27;Bourgogne-Franche-Comté;21;2;14;462;Norges-la-Ville;948;18;966
27;Bourgogne-Franche-Comté;21;3;22;463;Normier;58;1;59
27;Bourgogne-Franche-Comté;21;1;20;464;Nuits-Saint-Georges;5332;89;5421
27;Bourgogne-Franche-Comté;21;3;05;465;Obtrée;78;1;79
27;Bourgogne-Franche-Comté;21;3;05;466;Oigny;42;4;46
27;Bourgogne-Franche-Comté;21;2;21;467;Oisilly;126;4;130
27;Bourgogne-Franche-Comté;21;2;21;468;Orain;86;1;87
27;Bourgogne-Franche-Comté;21;2;14;469;Orgeux;455;13;468
27;Bourgogne-Franche-Comté;21;3;05;470;Origny;52;4;56
27;Bourgogne-Franche-Comté;21;3;05;471;Orret;14;0;14
27;Bourgogne-Franche-Comté;21;2;16;472;Orville;172;1;173
27;Bourgogne-Franche-Comté;21;2;18;473;Ouges;1616;11;1627
27;Bourgogne-Franche-Comté;21;1;04;474;Pagny-la-Ville;414;11;425
27;Bourgogne-Franche-Comté;21;1;04;475;Pagny-le-Château;500;10;510
27;Bourgogne-Franche-Comté;21;1;01;476;Painblanc;164;5;169
27;Bourgogne-Franche-Comté;21;2;14;477;Panges;82;2;84
27;Bourgogne-Franche-Comté;21;2;23;478;Pasques;282;5;287
27;Bourgogne-Franche-Comté;21;2;16;479;Pellerey;83;1;84
27;Bourgogne-Franche-Comté;21;1;17;480;Pernand-Vergelesses;237;9;246
27;Bourgogne-Franche-Comté;21;2;18;481;Perrigny-lès-Dijon;2178;23;2201
27;Bourgogne-Franche-Comté;21;2;02;482;Perrigny-sur-l'Ognon;626;15;641
27;Bourgogne-Franche-Comté;21;2;16;483;Pichanges;299;5;304
27;Bourgogne-Franche-Comté;21;3;19;484;Planay;64;5;69
27;Bourgogne-Franche-Comté;21;2;23;485;Plombières-lès-Dijon;2535;46;2581
27;Bourgogne-Franche-Comté;21;2;15;487;Pluvet;418;6;424
27;Bourgogne-Franche-Comté;21;3;05;488;Poinçon-lès-Larrey;192;2;194
27;Bourgogne-Franche-Comté;21;2;16;489;Poiseul-la-Grange;53;4;57
27;Bourgogne-Franche-Comté;21;3;05;490;Poiseul-la-Ville-et-Laperrière;156;6;162
27;Bourgogne-Franche-Comté;21;2;16;491;Poiseul-lès-Saulx;70;1;71
27;Bourgogne-Franche-Comté;21;1;17;492;Pommard;449;12;461
27;Bourgogne-Franche-Comté;21;2;02;493;Poncey-lès-Athée;568;8;576
27;Bourgogne-Franche-Comté;21;2;16;494;Poncey-sur-l'Ignon;84;0;84
27;Bourgogne-Franche-Comté;21;2;02;495;Pont;159;1;160
27;Bourgogne-Franche-Comté;21;2;02;496;Pontailler-sur-Saône;1297;16;1313
27;Bourgogne-Franche-Comté;21;3;22;497;Pont-et-Massène;172;15;187
27;Bourgogne-Franche-Comté;21;3;22;498;Posanges;49;2;51
27;Bourgogne-Franche-Comté;21;3;05;499;Pothières;201;5;206
27;Bourgogne-Franche-Comté;21;3;19;500;Pouillenay;558;9;567
27;Bourgogne-Franche-Comté;21;1;01;501;Pouilly-en-Auxois;1537;119;1656
27;Bourgogne-Franche-Comté;21;1;04;502;Pouilly-sur-Saône;607;7;614
27;Bourgogne-Franche-Comté;21;2;21;503;Pouilly-sur-Vingeanne;135;4;139
27;Bourgogne-Franche-Comté;21;2;23;504;Prâlon;90;3;93
27;Bourgogne-Franche-Comté;21;3;22;505;Précy-sous-Thil;709;10;719
27;Bourgogne-Franche-Comté;21;1;20;506;Premeaux-Prissey;362;5;367
27;Bourgogne-Franche-Comté;21;2;14;508;Prenois;462;9;471
27;Bourgogne-Franche-Comté;21;3;05;510;Prusly-sur-Ource;153;1;154
27;Bourgogne-Franche-Comté;21;3;05;511;Puits;131;4;135
27;Bourgogne-Franche-Comté;21;1;17;512;Puligny-Montrachet;378;10;388
27;Bourgogne-Franche-Comté;21;3;05;514;Quemigny-sur-Seine;102;3;105
27;Bourgogne-Franche-Comté;21;2;07;515;Quetigny;8936;351;9287
27;Bourgogne-Franche-Comté;21;3;19;516;Quincerot;79;4;83
27;Bourgogne-Franche-Comté;21;1;20;517;Quincey;505;14;519
27;Bourgogne-Franche-Comté;21;3;19;518;Quincy-le-Vicomte;200;2;202
27;Bourgogne-Franche-Comté;21;3;05;519;Recey-sur-Ource;345;5;350
27;Bourgogne-Franche-Comté;21;2;23;520;Remilly-en-Montagne;152;0;152
27;Bourgogne-Franche-Comté;21;2;21;521;Remilly-sur-Tille;899;11;910
27;Bourgogne-Franche-Comté;21;2;21;522;Renève;459;9;468
27;Bourgogne-Franche-Comté;21;1;18;523;Reulle-Vergy;158;2;160
27;Bourgogne-Franche-Comté;21;3;05;524;Riel-les-Eaux;91;0;91
27;Bourgogne-Franche-Comté;21;3;22;525;La Roche-en-Brenil;899;13;912
27;Bourgogne-Franche-Comté;21;3;05;526;Rochefort-sur-Brévon;42;0;42
27;Bourgogne-Franche-Comté;21;1;01;527;La Rochepot;281;9;290
27;Bourgogne-Franche-Comté;21;3;19;528;La Roche-Vanneau;138;2;140
27;Bourgogne-Franche-Comté;21;3;22;529;Roilly;50;1;51
27;Bourgogne-Franche-Comté;21;3;19;530;Rougemont;145;1;146
27;Bourgogne-Franche-Comté;21;3;22;531;Rouvray;490;4;494
27;Bourgogne-Franche-Comté;21;2;15;532;Rouvres-en-Plaine;1155;12;1167
27;Bourgogne-Franche-Comté;21;1;01;533;Rouvres-sous-Meilly;87;3;90
27;Bourgogne-Franche-Comté;21;1;17;534;Ruffey-lès-Beaune;739;43;782
27;Bourgogne-Franche-Comté;21;2;14;535;Ruffey-lès-Echirey;1340;11;1351
27;Bourgogne-Franche-Comté;21;2;16;536;Sacquenay;289;10;299
27;Bourgogne-Franche-Comté;21;3;22;537;Saffres;117;2;119
27;Bourgogne-Franche-Comté;21;3;22;538;Saint-Andeux;117;3;120
27;Bourgogne-Franche-Comté;21;2;23;539;Saint-Anthot;55;1;56
27;Bourgogne-Franche-Comté;21;2;21;540;Saint-Apollinaire;7518;99;7617
27;Bourgogne-Franche-Comté;21;1;17;541;Saint-Aubin;213;9;222
27;Bourgogne-Franche-Comté;21;1;20;542;Saint-Bernard;453;6;459
27;Bourgogne-Franche-Comté;21;3;05;543;Saint-Broing-les-Moines;192;8;200
27;Bourgogne-Franche-Comté;21;3;22;544;Sainte-Colombe-en-Auxois;56;1;57
27;Bourgogne-Franche-Comté;21;3;05;545;Sainte-Colombe-sur-Seine;923;16;939
27;Bourgogne-Franche-Comté;21;3;22;546;Saint-Didier;205;7;212
27;Bourgogne-Franche-Comté;21;3;22;547;Saint-Euphrône;209;3;212
27;Bourgogne-Franche-Comté;21;3;22;548;Saint-Germain-de-Modéon;179;3;182
27;Bourgogne-Franche-Comté;21;3;05;549;Saint-Germain-le-Rocheux;82;4;86
27;Bourgogne-Franche-Comté;21;3;19;550;Saint-Germain-lès-Senailly;125;4;129
27;Bourgogne-Franche-Comté;21;3;22;552;Saint-Hélier;36;1;37
27;Bourgogne-Franche-Comté;21;2;23;553;Saint-Jean-de-Bœuf;107;4;111
27;Bourgogne-Franche-Comté;21;1;04;554;Saint-Jean-de-Losne;1039;10;1049
27;Bourgogne-Franche-Comté;21;2;14;555;Saint-Julien;1513;20;1533
27;Bourgogne-Franche-Comté;21;2;02;556;Saint-Léger-Triey;245;3;248
27;Bourgogne-Franche-Comté;21;3;05;557;Saint-Marc-sur-Seine;109;3;112
27;Bourgogne-Franche-Comté;21;1;17;558;Sainte-Marie-la-Blanche;897;31;928
27;Bourgogne-Franche-Comté;21;2;23;559;Sainte-Marie-sur-Ouche;695;14;709
27;Bourgogne-Franche-Comté;21;1;01;560;Saint-Martin-de-la-Mer;303;2;305
27;Bourgogne-Franche-Comté;21;2;14;561;Saint-Martin-du-Mont;462;1;463
27;Bourgogne-Franche-Comté;21;2;21;562;Saint-Maurice-sur-Vingeanne;199;6;205
27;Bourgogne-Franche-Comté;21;3;22;563;Saint-Mesmin;117;2;119
27;Bourgogne-Franche-Comté;21;1;20;564;Saint-Nicolas-lès-Cîteaux;398;9;407
27;Bourgogne-Franche-Comté;21;1;20;565;Saint-Philibert;519;8;527
27;Bourgogne-Franche-Comté;21;1;01;566;Saint-Pierre-en-Vaux;139;3;142
27;Bourgogne-Franche-Comté;21;1;01;567;Saint-Prix-lès-Arnay;209;5;214
27;Bourgogne-Franche-Comté;21;3;19;568;Saint-Rémy;688;11;699
27;Bourgogne-Franche-Comté;21;1;17;569;Saint-Romain;212;11;223
27;Bourgogne-Franche-Comté;21;1;01;570;Sainte-Sabine;172;16;188
27;Bourgogne-Franche-Comté;21;2;02;571;Saint-Sauveur;231;2;233
27;Bourgogne-Franche-Comté;21;1;04;572;Saint-Seine-en-Bâche;395;5;400
27;Bourgogne-Franche-Comté;21;2;14;573;Saint-Seine-l'Abbaye;368;5;373
27;Bourgogne-Franche-Comté;21;2;21;574;Saint-Seine-sur-Vingeanne;383;9;392
27;Bourgogne-Franche-Comté;21;1;04;575;Saint-Symphorien-sur-Saône;334;4;338
27;Bourgogne-Franche-Comté;21;3;22;576;Saint-Thibault;159;4;163
27;Bourgogne-Franche-Comté;21;1;04;577;Saint-Usage;1332;30;1362
27;Bourgogne-Franche-Comté;21;2;23;578;Saint-Victor-sur-Ouche;328;4;332
27;Bourgogne-Franche-Comté;21;2;16;579;Salives;207;6;213
27;Bourgogne-Franche-Comté;21;3;19;580;Salmaise;133;2;135
27;Bourgogne-Franche-Comté;21;1;04;581;Samerey;141;4;145
27;Bourgogne-Franche-Comté;21;1;17;582;Santenay;913;11;924
27;Bourgogne-Franche-Comté;21;1;01;583;Santosse;57;2;59
27;Bourgogne-Franche-Comté;21;3;22;584;Saulieu;2346;108;2454
27;Bourgogne-Franche-Comté;21;1;20;585;Saulon-la-Chapelle;988;22;1010
27;Bourgogne-Franche-Comté;21;1;20;586;Saulon-la-Rue;713;10;723
27;Bourgogne-Franche-Comté;21;2;16;587;Saulx-le-Duc;250;4;254
27;Bourgogne-Franche-Comté;21;1;01;588;Saussey;67;1;68
27;Bourgogne-Franche-Comté;21;2;14;589;Saussy;101;1;102
27;Bourgogne-Franche-Comté;21;1;17;590;Savigny-lès-Beaune;1288;41;1329
27;Bourgogne-Franche-Comté;21;2;14;591;Savigny-le-Sec;862;14;876
27;Bourgogne-Franche-Comté;21;2;23;592;Savigny-sous-Mâlain;231;11;242
27;Bourgogne-Franche-Comté;21;1;01;593;Savilly;79;0;79
27;Bourgogne-Franche-Comté;21;3;05;594;Savoisy;194;3;197
27;Bourgogne-Franche-Comté;21;2;21;595;Savolles;157;2;159
27;Bourgogne-Franche-Comté;21;1;20;596;Savouges;382;6;388
27;Bourgogne-Franche-Comté;21;1;18;597;Segrois;54;1;55
27;Bourgogne-Franche-Comté;21;3;19;598;Seigny;167;1;168
27;Bourgogne-Franche-Comté;21;2;16;599;Selongey;2392;33;2425
27;Bourgogne-Franche-Comté;21;1;01;600;Semarey;125;4;129
27;Bourgogne-Franche-Comté;21;1;18;601;Semezanges;94;4;98
27;Bourgogne-Franche-Comté;21;3;05;602;Semond;28;0;28
27;Bourgogne-Franche-Comté;21;3;22;603;Semur-en-Auxois;4114;352;4466
27;Bourgogne-Franche-Comté;21;3;19;604;Senailly;137;3;140
27;Bourgogne-Franche-Comté;21;2;07;605;Sennecey-lès-Dijon;2068;54;2122
27;Bourgogne-Franche-Comté;21;1;17;606;Ladoix-Serrigny;1796;47;1843
27;Bourgogne-Franche-Comté;21;1;04;607;Seurre;2313;22;2335
27;Bourgogne-Franche-Comté;21;3;22;608;Sincey-lès-Rouvray;99;1;100
27;Bourgogne-Franche-Comté;21;2;02;609;Soirans;502;7;509
27;Bourgogne-Franche-Comté;21;2;02;610;Soissons-sur-Nacey;361;8;369
27;Bourgogne-Franche-Comté;21;2;23;611;Sombernon;915;13;928
27;Bourgogne-Franche-Comté;21;3;22;612;Souhey;85;1;86
27;Bourgogne-Franche-Comté;21;3;22;613;Soussey-sur-Brionne;158;8;166
27;Bourgogne-Franche-Comté;21;2;16;614;Spoy;401;4;405
27;Bourgogne-Franche-Comté;21;1;01;615;Sussey;239;8;247
27;Bourgogne-Franche-Comté;21;1;17;616;Tailly;196;7;203
27;Bourgogne-Franche-Comté;21;2;23;617;Talant;11788;216;12004
27;Bourgogne-Franche-Comté;21;2;02;618;Talmay;564;10;574
27;Bourgogne-Franche-Comté;21;2;21;619;Tanay;216;6;222
27;Bourgogne-Franche-Comté;21;2;16;620;Tarsul;157;5;162
27;Bourgogne-Franche-Comté;21;2;15;622;Tart-le-Bas;251;5;256
27;Bourgogne-Franche-Comté;21;2;15;623;Tart;1563;31;1594
27;Bourgogne-Franche-Comté;21;2;02;624;Tellecey;141;1;142
27;Bourgogne-Franche-Comté;21;1;18;625;Ternant;84;3;87
27;Bourgogne-Franche-Comté;21;3;05;626;Terrefondrée;62;2;64
27;Bourgogne-Franche-Comté;21;3;19;627;Thenissey;92;9;101
27;Bourgogne-Franche-Comté;21;3;05;628;Thoires;65;0;65
27;Bourgogne-Franche-Comté;21;3;22;629;Thoisy-la-Berchère;307;5;312
27;Bourgogne-Franche-Comté;21;1;01;630;Thoisy-le-Désert;216;8;224
27;Bourgogne-Franche-Comté;21;1;01;631;Thomirey;55;0;55
27;Bourgogne-Franche-Comté;21;2;15;632;Thorey-en-Plaine;1050;31;1081
27;Bourgogne-Franche-Comté;21;3;22;633;Thorey-sous-Charny;191;1;192
27;Bourgogne-Franche-Comté;21;1;01;634;Thorey-sur-Ouche;137;0;137
27;Bourgogne-Franche-Comté;21;3;22;635;Thoste;102;6;108
27;Bourgogne-Franche-Comté;21;1;01;636;Thury;254;8;262
27;Bourgogne-Franche-Comté;21;1;04;637;Tichey;214;5;219
27;Bourgogne-Franche-Comté;21;2;16;638;Til-Châtel;1144;8;1152
27;Bourgogne-Franche-Comté;21;2;02;639;Tillenay;738;15;753
27;Bourgogne-Franche-Comté;21;3;22;640;Torcy-et-Pouligny;217;5;222
27;Bourgogne-Franche-Comté;21;3;19;641;Touillon;461;6;467
27;Bourgogne-Franche-Comté;21;3;22;642;Toutry;413;8;421
27;Bourgogne-Franche-Comté;21;2;02;643;Tréclun;433;8;441
27;Bourgogne-Franche-Comté;21;2;21;644;Trochères;169;4;173
27;Bourgogne-Franche-Comté;21;1;04;645;Trouhans;594;13;607
27;Bourgogne-Franche-Comté;21;2;14;646;Trouhaut;126;3;129
27;Bourgogne-Franche-Comté;21;1;04;647;Trugny;119;2;121
27;Bourgogne-Franche-Comté;21;2;14;648;Turcey;175;1;176
27;Bourgogne-Franche-Comté;21;3;22;649;Uncey-le-Franc;53;0;53
27;Bourgogne-Franche-Comté;21;1;18;650;Urcy;147;4;151
27;Bourgogne-Franche-Comté;21;2;14;651;Val-Suzon;199;4;203
27;Bourgogne-Franche-Comté;21;1;01;652;Vandenesse-en-Auxois;295;7;302
27;Bourgogne-Franche-Comté;21;3;05;653;Vannaire;50;1;51
27;Bourgogne-Franche-Comté;21;3;05;655;Vanvey;231;9;240
27;Bourgogne-Franche-Comté;21;2;15;656;Varanges;691;13;704
27;Bourgogne-Franche-Comté;21;2;21;657;Varois-et-Chaignot;1990;34;2024
27;Bourgogne-Franche-Comté;21;2;16;659;Vaux-Saules;167;12;179
27;Bourgogne-Franche-Comté;21;1;01;660;Veilly;53;1;54
27;Bourgogne-Franche-Comté;21;2;23;661;Velars-sur-Ouche;1777;29;1806
27;Bourgogne-Franche-Comté;21;3;22;662;Velogny;32;0;32
27;Bourgogne-Franche-Comté;21;3;19;663;Venarey-les-Laumes;2811;42;2853
27;Bourgogne-Franche-Comté;21;3;19;664;Verdonnet;82;4;86
27;Bourgogne-Franche-Comté;21;2;16;665;Vernois-lès-Vesvres;165;2;167
27;Bourgogne-Franche-Comté;21;2;16;666;Vernot;94;3;97
27;Bourgogne-Franche-Comté;21;2;16;667;Véronnes;396;7;403
27;Bourgogne-Franche-Comté;21;2;23;669;Verrey-sous-Drée;84;0;84
27;Bourgogne-Franche-Comté;21;3;19;670;Verrey-sous-Salmaise;288;5;293
27;Bourgogne-Franche-Comté;21;3;05;671;Vertault;50;1;51
27;Bourgogne-Franche-Comté;21;3;22;672;Vesvres;28;1;29
27;Bourgogne-Franche-Comté;21;1;01;673;Veuvey-sur-Ouche;214;3;217
27;Bourgogne-Franche-Comté;21;3;05;674;Veuxhaulles-sur-Aube;199;2;201
27;Bourgogne-Franche-Comté;21;1;01;675;Vianges;38;1;39
27;Bourgogne-Franche-Comté;21;3;22;676;Vic-de-Chassenay;211;5;216
27;Bourgogne-Franche-Comté;21;1;01;677;Vic-des-Prés;115;1;116
27;Bourgogne-Franche-Comté;21;3;22;678;Vic-sous-Thil;184;3;187
27;Bourgogne-Franche-Comté;21;2;23;679;Vieilmoulin;134;2;136
27;Bourgogne-Franche-Comté;21;2;02;680;Vielverge;504;7;511
27;Bourgogne-Franche-Comté;21;3;22;681;Vieux-Château;86;1;87
27;Bourgogne-Franche-Comté;21;2;21;682;Viévigne;271;1;272
27;Bourgogne-Franche-Comté;21;1;01;683;Viévy;357;3;360
27;Bourgogne-Franche-Comté;21;1;17;684;Vignoles;938;48;986
27;Bourgogne-Franche-Comté;21;3;05;685;Villaines-en-Duesmois;253;6;259
27;Bourgogne-Franche-Comté;21;3;19;686;Villaines-les-Prévôtes;146;2;148
27;Bourgogne-Franche-Comté;21;3;22;687;Villargoix;137;5;142
27;Bourgogne-Franche-Comté;21;1;20;688;Villars-Fontaine;114;4;118
27;Bourgogne-Franche-Comté;21;3;22;689;Villars-et-Villenotte;167;7;174
27;Bourgogne-Franche-Comté;21;3;22;690;Villeberny;91;2;93
27;Bourgogne-Franche-Comté;21;1;20;691;Villebichot;398;7;405
27;Bourgogne-Franche-Comté;21;2;16;692;Villecomte;248;4;252
27;Bourgogne-Franche-Comté;21;3;05;693;Villedieu;69;1;70
27;Bourgogne-Franche-Comté;21;3;22;694;Villeferry;24;0;24
27;Bourgogne-Franche-Comté;21;3;19;695;La Villeneuve-les-Convers;62;1;63
27;Bourgogne-Franche-Comté;21;3;22;696;Villeneuve-sous-Charigny;96;2;98
27;Bourgogne-Franche-Comté;21;1;20;698;Villers-la-Faye;389;9;398
27;Bourgogne-Franche-Comté;21;2;02;699;Villers-les-Pots;1177;13;1190
27;Bourgogne-Franche-Comté;21;3;05;700;Villers-Patras;82;3;85
27;Bourgogne-Franche-Comté;21;2;02;701;Villers-Rotin;125;5;130
27;Bourgogne-Franche-Comté;21;2;16;702;Villey-sur-Tille;263;7;270
27;Bourgogne-Franche-Comté;21;1;01;703;Villiers-en-Morvan;49;0;49
27;Bourgogne-Franche-Comté;21;3;05;704;Villiers-le-Duc;103;0;103
27;Bourgogne-Franche-Comté;21;2;14;705;Villotte-Saint-Seine;74;0;74
27;Bourgogne-Franche-Comté;21;3;05;706;Villotte-sur-Ource;114;2;116
27;Bourgogne-Franche-Comté;21;3;22;707;Villy-en-Auxois;216;4;220
27;Bourgogne-Franche-Comté;21;1;20;708;Villy-le-Moutier;326;12;338
27;Bourgogne-Franche-Comté;21;3;19;709;Viserny;179;4;183
27;Bourgogne-Franche-Comté;21;3;22;710;Vitteaux;1059;18;1077
27;Bourgogne-Franche-Comté;21;3;05;711;Vix;100;3;103
27;Bourgogne-Franche-Comté;21;1;17;712;Volnay;229;15;244
27;Bourgogne-Franche-Comté;21;2;02;713;Vonges;348;4;352
27;Bourgogne-Franche-Comté;21;1;20;714;Vosne-Romanée;338;9;347
27;Bourgogne-Franche-Comté;21;1;01;715;Voudenay;192;1;193
27;Bourgogne-Franche-Comté;21;1;20;716;Vougeot;162;5;167
27;Bourgogne-Franche-Comté;21;3;05;717;Voulaines-les-Templiers;270;11;281
53;Bretagne;22;4;10;001;Allineuc;596;20;616
53;Bretagne;22;4;06;002;Andel;1148;36;1184
53;Bretagne;22;1;04;003;Aucaleuc;920;77;997
53;Bretagne;22;2;01;004;Bégard;4810;91;4901
53;Bretagne;22;2;03;005;Belle-Isle-en-Terre;1029;19;1048
53;Bretagne;22;3;01;006;Berhet;273;9;282
53;Bretagne;22;1;08;008;Bobital;1137;41;1178
53;Bretagne;22;4;13;009;Le Bodéo;162;1;163
53;Bretagne;22;2;15;011;Boqueho;1054;26;1080
53;Bretagne;22;4;17;012;La Bouillie;886;18;904
53;Bretagne;22;2;03;013;Bourbriac;2125;44;2169
53;Bretagne;22;1;14;014;Bourseul;1182;30;1212
53;Bretagne;22;4;16;015;Bréhand;1696;29;1725
53;Bretagne;22;4;11;016;Île-de-Bréhat;377;9;386
53;Bretagne;22;2;01;018;Brélidy;291;5;296
53;Bretagne;22;2;15;019;Bringolo;495;11;506
53;Bretagne;22;1;02;020;Broons;2910;67;2977
53;Bretagne;22;1;08;021;Brusvily;1166;25;1191
53;Bretagne;22;2;03;023;Bulat-Pestivien;415;1;416
53;Bretagne;22;2;03;024;Calanhel;227;1;228
53;Bretagne;22;2;03;025;Callac;2233;30;2263
53;Bretagne;22;1;08;026;Calorguen;737;14;751
53;Bretagne;22;4;09;027;Le Cambout;414;11;425
53;Bretagne;22;3;27;028;Camlez;842;26;868
53;Bretagne;22;2;23;029;Canihuel;345;13;358
53;Bretagne;22;3;01;030;Caouënnec-Lanvézéac;899;22;921
53;Bretagne;22;2;03;031;Carnoët;653;6;659
53;Bretagne;22;1;02;032;Caulnes;2503;134;2637
53;Bretagne;22;4;10;033;Caurel;361;9;370
53;Bretagne;22;3;01;034;Cavan;1516;57;1573
53;Bretagne;22;1;08;035;Les Champs-Géraux;1042;23;1065
53;Bretagne;22;1;02;036;La Chapelle-Blanche;210;7;217
53;Bretagne;22;2;03;037;La Chapelle-Neuve;384;4;388
53;Bretagne;22;4;09;039;La Chèze;561;9;570
53;Bretagne;22;2;03;040;Coadout;567;14;581
53;Bretagne;22;3;01;041;Coatascorn;261;3;264
53;Bretagne;22;3;27;042;Coatréven;500;14;514
53;Bretagne;22;4;09;043;Coëtlogon;209;6;215
53;Bretagne;22;4;06;044;Coëtmieux;1792;50;1842
53;Bretagne;22;2;15;045;Cohiniac;363;4;367
53;Bretagne;22;4;16;046;Le Mené;6412;115;6527
53;Bretagne;22;4;10;047;Corlay;922;16;938
53;Bretagne;22;1;14;048;Corseul;2223;47;2270
53;Bretagne;22;1;14;049;Créhen;1643;35;1678
53;Bretagne;22;1;04;050;Dinan;14682;574;15256
53;Bretagne;22;2;03;052;Duault;376;6;382
53;Bretagne;22;4;02;053;Éréac;682;12;694
53;Bretagne;22;4;17;054;Erquy;3916;91;4007
53;Bretagne;22;4;22;055;Binic-Étables-sur-Mer;6862;213;7075
53;Bretagne;22;1;08;056;Évran;1783;26;1809
53;Bretagne;22;2;22;057;Le Faouët;400;12;412
53;Bretagne;22;4;15;059;Le Fœil;1403;40;1443
53;Bretagne;22;4;10;060;Gausson;619;9;628
53;Bretagne;22;2;23;061;Glomel;1350;40;1390
53;Bretagne;22;4;02;062;Gomené;543;11;554
53;Bretagne;22;2;22;063;Gommenec'h;554;9;563
53;Bretagne;22;2;23;064;Gouarec;952;31;983
53;Bretagne;22;2;05;065;Goudelin;1725;37;1762
53;Bretagne;22;2;05;067;Grâces;2548;59;2607
53;Bretagne;22;4;10;068;Grâce-Uzel;430;8;438
53;Bretagne;22;1;02;069;Guenroc;216;5;221
53;Bretagne;22;2;05;070;Guingamp;7115;567;7682
53;Bretagne;22;1;02;071;Guitté;718;8;726
53;Bretagne;22;2;03;072;Gurunhuel;405;8;413
53;Bretagne;22;4;15;073;La Harmoye;373;17;390
53;Bretagne;22;4;10;074;Le Haut-Corlay;645;17;662
53;Bretagne;22;4;10;075;Hémonstoir;724;7;731
53;Bretagne;22;4;17;076;Hénanbihen;1328;37;1365
53;Bretagne;22;4;06;077;Hénansal;1201;15;1216
53;Bretagne;22;4;13;079;Hénon;2298;36;2334
53;Bretagne;22;4;26;081;Hillion;4246;99;4345
53;Bretagne;22;1;08;082;Le Hinglé;907;32;939
53;Bretagne;22;4;02;083;Illifaut;674;12;686
53;Bretagne;22;4;16;084;Jugon-les-Lacs - Commune nouvelle;2533;50;2583
53;Bretagne;22;3;27;085;Kerbors;288;8;296
53;Bretagne;22;2;11;086;Kerfot;655;12;667
53;Bretagne;22;2;23;087;Kergrist-Moëlou;654;26;680
53;Bretagne;22;2;03;088;Kerien;250;3;253
53;Bretagne;22;3;12;090;Kermaria-Sulard;1074;21;1095
53;Bretagne;22;2;01;091;Kermoroc'h;436;9;445
53;Bretagne;22;2;03;092;Kerpert;269;3;272
53;Bretagne;22;4;89;093;Lamballe-Armor;16689;480;17169
53;Bretagne;22;1;19;094;Lancieux;1582;63;1645
53;Bretagne;22;2;01;095;Landebaëron;175;10;185
53;Bretagne;22;1;14;096;Landébia;454;2;456
53;Bretagne;22;1;14;097;La Landec;726;18;744
53;Bretagne;22;4;06;098;Landéhen;1424;34;1458
53;Bretagne;22;4;15;099;Lanfains;1099;18;1117
53;Bretagne;22;3;27;101;Langoat;1139;25;1164
53;Bretagne;22;1;19;103;Langrolay-sur-Rance;974;40;1014
53;Bretagne;22;1;14;104;Languédias;540;28;568
53;Bretagne;22;1;14;105;Languenan;1149;23;1172
53;Bretagne;22;4;26;106;Langueux;7824;250;8074
53;Bretagne;22;2;23;107;Bon Repos sur Blavet;1249;36;1285
53;Bretagne;22;2;11;108;Lanleff;122;2;124
53;Bretagne;22;2;11;109;Lanloup;224;6;230
53;Bretagne;22;3;27;110;Lanmérin;592;14;606
53;Bretagne;22;3;27;111;Lanmodez;402;6;408
53;Bretagne;22;2;22;112;Lannebert;439;4;443
53;Bretagne;22;3;07;113;Lannion;20451;905;21356
53;Bretagne;22;4;02;114;Lanrelas;852;17;869
53;Bretagne;22;2;23;115;Lanrivain;449;12;461
53;Bretagne;22;2;15;116;Lanrodec;1364;23;1387
53;Bretagne;22;4;22;117;Lantic;1744;33;1777
53;Bretagne;22;1;08;118;Lanvallay;4209;101;4310
53;Bretagne;22;3;20;119;Lanvellec;595;10;605
53;Bretagne;22;2;22;121;Lanvollon;1781;28;1809
53;Bretagne;22;4;02;122;Laurenan;737;13;750
53;Bretagne;22;2;23;124;Lescouët-Gouarec;215;8;223
53;Bretagne;22;4;15;126;Le Leslay;157;3;160
53;Bretagne;22;3;27;127;Lézardrieux;1532;34;1566
53;Bretagne;22;2;23;128;Locarn;410;13;423
53;Bretagne;22;2;03;129;Loc-Envel;69;2;71
53;Bretagne;22;3;20;131;Loguivy-Plougras;802;13;815
53;Bretagne;22;2;03;132;Lohuec;247;3;250
53;Bretagne;22;4;02;133;Loscouët-sur-Meu;628;15;643
53;Bretagne;22;3;12;134;Louannec;3086;117;3203
53;Bretagne;22;2;03;135;Louargat;2328;39;2367
53;Bretagne;22;4;09;136;Loudéac;9652;379;10031
53;Bretagne;22;2;23;137;Maël-Carhaix;1466;30;1496
53;Bretagne;22;2;03;138;Maël-Pestivien;354;5;359
53;Bretagne;22;2;03;139;Magoar;84;2;86
53;Bretagne;22;4;06;140;La Malhoure;611;16;627
53;Bretagne;22;3;01;141;Mantallot;236;6;242
53;Bretagne;22;1;17;143;Matignon;1704;22;1726
53;Bretagne;22;4;21;144;La Méaugon;1331;35;1366
53;Bretagne;22;1;02;145;Mégrit;827;21;848
53;Bretagne;22;2;23;146;Mellionnec;395;17;412
53;Bretagne;22;4;02;147;Merdrignac;2954;232;3186
53;Bretagne;22;4;02;148;Mérillac;234;4;238
53;Bretagne;22;4;10;149;Merléac;428;16;444
53;Bretagne;22;2;05;150;Le Merzer;946;27;973
53;Bretagne;22;3;27;152;Minihy-Tréguier;1254;41;1295
53;Bretagne;22;4;13;153;Moncontour;752;16;768
53;Bretagne;22;4;10;155;La Motte;2146;33;2179
53;Bretagne;22;2;03;156;Moustéru;644;15;659
53;Bretagne;22;2;23;157;Le Moustoir;667;24;691
53;Bretagne;22;4;10;158;Guerlédan;2467;63;2530
53;Bretagne;22;4;06;160;Noyal;956;19;975
53;Bretagne;22;2;05;161;Pabu;2753;108;2861
53;Bretagne;22;2;11;162;Paimpol;7142;329;7471
53;Bretagne;22;2;23;163;Paule;682;21;703
53;Bretagne;22;2;01;164;Pédernec;1856;42;1898
53;Bretagne;22;4;16;165;Penguily;606;19;625
53;Bretagne;22;3;27;166;Penvénan;2473;64;2537
53;Bretagne;22;3;12;168;Perros-Guirec;7149;193;7342
53;Bretagne;22;2;23;169;Peumerit-Quintin;172;4;176
53;Bretagne;22;4;15;170;Plaine-Haute;1647;34;1681
53;Bretagne;22;4;13;171;Plaintel;4501;91;4592
53;Bretagne;22;1;14;172;Plancoët;3018;53;3071
53;Bretagne;22;1;17;174;Pléboulle;819;12;831
53;Bretagne;22;4;16;175;Plédéliac;1478;16;1494
53;Bretagne;22;4;21;176;Plédran;6920;110;7030
53;Bretagne;22;2;22;177;Pléguien;1383;31;1414
53;Bretagne;22;2;11;178;Pléhédel;1335;35;1370
53;Bretagne;22;1;17;179;Fréhel;1602;26;1628
53;Bretagne;22;1;14;180;Plélan-le-Petit;1917;30;1947
53;Bretagne;22;2;23;181;Plélauff;628;28;656
53;Bretagne;22;2;15;182;Plélo;3239;77;3316
53;Bretagne;22;4;09;183;Plémet;3728;90;3818
53;Bretagne;22;4;13;184;Plémy;1591;31;1622
53;Bretagne;22;4;16;185;Plénée-Jugon;2434;73;2507
53;Bretagne;22;4;17;186;Pléneuf-Val-André;4069;128;4197
53;Bretagne;22;4;18;187;Plérin;14459;457;14916
53;Bretagne;22;2;15;188;Plerneuf;1112;11;1123
53;Bretagne;22;2;03;189;Plésidy;562;10;572
53;Bretagne;22;1;19;190;Pleslin-Trigavou;3867;80;3947
53;Bretagne;22;4;16;193;Plestan;1635;25;1660
53;Bretagne;22;3;20;194;Plestin-les-Grèves;3635;99;3734
53;Bretagne;22;3;27;195;Pleubian;2283;41;2324
53;Bretagne;22;3;27;196;Pleudaniel;934;17;951
53;Bretagne;22;1;08;197;Pleudihen-sur-Rance;3009;83;3092
53;Bretagne;22;3;12;198;Pleumeur-Bodou;3837;163;4000
53;Bretagne;22;3;27;199;Pleumeur-Gautier;1189;18;1207
53;Bretagne;22;1;14;200;Pléven;599;10;609
53;Bretagne;22;1;17;201;Plévenon;756;13;769
53;Bretagne;22;2;23;202;Plévin;750;11;761
53;Bretagne;22;4;13;203;Plœuc-L'Hermitage;4108;70;4178
53;Bretagne;22;2;01;204;Ploëzal;1222;21;1243
53;Bretagne;22;1;14;205;Plorec-sur-Arguenon;420;3;423
53;Bretagne;22;2;15;206;Châtelaudren-Plouagat;3955;55;4010
53;Bretagne;22;3;20;207;Plouaret;2195;44;2239
53;Bretagne;22;1;08;208;Plouasne;1721;34;1755
53;Bretagne;22;1;19;209;Beaussais-sur-Mer;3956;63;4019
53;Bretagne;22;2;11;210;Ploubazlanec;3040;124;3164
53;Bretagne;22;3;20;211;Ploubezre;3736;118;3854
53;Bretagne;22;2;01;212;Plouëc-du-Trieux;1143;33;1176
53;Bretagne;22;1;19;213;Plouër-sur-Rance;3515;106;3621
53;Bretagne;22;2;11;214;Plouézec;3126;57;3183
53;Bretagne;22;4;21;215;Ploufragan;11487;350;11837
53;Bretagne;22;2;03;216;Plougonver;743;16;759
53;Bretagne;22;3;20;217;Plougras;415;9;424
53;Bretagne;22;3;27;218;Plougrescant;1160;34;1194
53;Bretagne;22;4;10;219;Plouguenast-Langast;2429;57;2486
53;Bretagne;22;2;23;220;Plouguernével;1610;50;1660
53;Bretagne;22;3;27;221;Plouguiel;1744;37;1781
53;Bretagne;22;2;22;222;Plouha;4560;86;4646
53;Bretagne;22;2;05;223;Plouisy;2002;275;2277
53;Bretagne;22;3;07;224;Ploulec'h;1581;57;1638
53;Bretagne;22;2;05;225;Ploumagoar;5405;109;5514
53;Bretagne;22;3;20;226;Ploumilliau;2452;56;2508
53;Bretagne;22;3;20;227;Plounérin;787;12;799
53;Bretagne;22;3;20;228;Plounévez-Moëdec;1463;26;1489
53;Bretagne;22;2;23;229;Plounévez-Quintin;1065;27;1092
53;Bretagne;22;2;03;231;Plourac'h;328;4;332
53;Bretagne;22;4;22;232;Plourhan;2040;33;2073
53;Bretagne;22;2;11;233;Plourivo;2262;55;2317
53;Bretagne;22;2;15;234;Plouvara;1158;11;1169
53;Bretagne;22;3;20;235;Plouzélambre;225;5;230
53;Bretagne;22;2;22;236;Pludual;723;9;732
53;Bretagne;22;1;14;237;Pluduno;2216;65;2281
53;Bretagne;22;3;20;238;Plufur;533;12;545
53;Bretagne;22;1;02;239;Plumaudan;1367;38;1405
53;Bretagne;22;1;02;240;Plumaugat;1103;16;1119
53;Bretagne;22;4;09;241;Plumieux;1028;30;1058
53;Bretagne;22;4;17;242;Plurien;1543;29;1572
53;Bretagne;22;2;03;243;Plusquellec;546;16;562
53;Bretagne;22;4;10;244;Plussulien;480;19;499
53;Bretagne;22;3;01;245;Pluzunet;959;14;973
53;Bretagne;22;4;06;246;Pommeret;2124;34;2158
53;Bretagne;22;2;05;248;Pommerit-le-Vicomte;1830;38;1868
53;Bretagne;22;2;03;249;Pont-Melvez;615;10;625
53;Bretagne;22;2;01;250;Pontrieux;1000;25;1025
53;Bretagne;22;4;18;251;Pordic;7315;208;7523
53;Bretagne;22;3;01;254;Prat;1117;22;1139
53;Bretagne;22;4;09;255;La Prénessaye;876;18;894
53;Bretagne;22;2;01;256;Quemper-Guézennec;1061;26;1087
53;Bretagne;22;3;01;257;Quemperven;393;9;402
53;Bretagne;22;4;13;258;Quessoy;3868;224;4092
53;Bretagne;22;1;04;259;Quévert;3970;87;4057
53;Bretagne;22;4;10;260;Le Quillio;567;10;577
53;Bretagne;22;4;06;261;Quintenic;360;11;371
53;Bretagne;22;4;15;262;Quintin;2822;207;3029
53;Bretagne;22;1;08;263;Le Quiou;347;3;350
53;Bretagne;22;3;27;264;La Roche-Jaudy;2671;611;3282
53;Bretagne;22;3;07;265;Rospez;1778;56;1834
53;Bretagne;22;2;23;266;Rostrenen;3132;296;3428
53;Bretagne;22;4;02;267;Rouillac;389;3;392
53;Bretagne;22;1;17;268;Ruca;596;10;606
53;Bretagne;22;2;01;269;Runan;253;6;259
53;Bretagne;22;2;03;271;Saint-Adrien;350;6;356
53;Bretagne;22;2;05;272;Saint-Agathon;2286;53;2339
53;Bretagne;22;4;17;273;Saint-Alban;2241;39;2280
53;Bretagne;22;1;08;274;Saint-André-des-Eaux;387;6;393
53;Bretagne;22;4;09;275;Saint-Barnabé;1225;25;1250
53;Bretagne;22;4;15;276;Saint-Bihy;266;7;273
53;Bretagne;22;4;15;277;Saint-Brandan;2298;49;2347
53;Bretagne;22;4;99;278;Saint-Brieuc;44166;1436;45602
53;Bretagne;22;4;10;279;Saint-Caradec;1119;39;1158
53;Bretagne;22;1;08;280;Saint-Carné;1077;37;1114
53;Bretagne;22;4;13;281;Saint-Carreuc;1522;24;1546
53;Bretagne;22;1;17;282;Saint-Cast-le-Guildo;3313;75;3388
53;Bretagne;22;2;01;283;Saint-Clet;870;26;896
53;Bretagne;22;2;23;284;Saint-Connan;293;8;301
53;Bretagne;22;4;10;285;Saint-Connec;260;8;268
53;Bretagne;22;4;17;286;Saint-Denoual;479;14;493
53;Bretagne;22;4;21;287;Saint-Donan;1447;36;1483
53;Bretagne;22;4;09;288;Saint-Étienne-du-Gué-de-l'Isle;358;5;363
53;Bretagne;22;2;15;289;Saint-Fiacre;214;1;215
53;Bretagne;22;4;15;291;Saint-Gildas;247;8;255
53;Bretagne;22;2;22;293;Saint-Gilles-les-Bois;396;13;409
53;Bretagne;22;2;23;294;Saint-Gilles-Pligeaux;304;6;310
53;Bretagne;22;4;10;295;Saint-Gilles-Vieux-Marché;342;15;357
53;Bretagne;22;4;16;296;Saint-Glen;654;10;664
53;Bretagne;22;1;08;299;Saint-Hélen;1528;44;1572
53;Bretagne;22;4;10;300;Saint-Hervé;388;9;397
53;Bretagne;22;1;14;302;Saint-Jacut-de-la-Mer;910;18;928
53;Bretagne;22;2;15;304;Saint-Jean-Kerdaniel;668;9;677
53;Bretagne;22;1;02;305;Saint-Jouan-de-l'Isle;482;9;491
53;Bretagne;22;1;08;306;Saint-Judoce;565;10;575
53;Bretagne;22;4;21;307;Saint-Julien;2046;50;2096
53;Bretagne;22;1;08;308;Saint-Juvat;648;18;666
53;Bretagne;22;4;02;309;Saint-Launeuc;192;4;196
53;Bretagne;22;2;01;310;Saint-Laurent;491;7;498
53;Bretagne;22;1;14;311;Saint-Lormel;881;36;917
53;Bretagne;22;1;02;312;Saint-Maden;223;9;232
53;Bretagne;22;4;10;313;Saint-Martin-des-Prés;311;8;319
53;Bretagne;22;4;09;314;Saint-Maudan;398;7;405
53;Bretagne;22;1;14;315;Saint-Maudez;283;11;294
53;Bretagne;22;4;10;316;Saint-Mayeux;466;7;473
53;Bretagne;22;1;14;317;Saint-Méloir-des-Bois;267;5;272
53;Bretagne;22;1;14;318;Saint-Michel-de-Plélan;308;8;316
53;Bretagne;22;3;20;319;Saint-Michel-en-Grève;453;13;466
53;Bretagne;22;2;03;320;Saint-Nicodème;180;5;185
53;Bretagne;22;2;23;321;Saint-Nicolas-du-Pélem;1555;44;1599
53;Bretagne;22;2;15;322;Saint-Péver;383;8;391
53;Bretagne;22;1;17;323;Saint-Pôtan;821;14;835
53;Bretagne;22;3;12;324;Saint-Quay-Perros;1289;55;1344
53;Bretagne;22;4;22;325;Saint-Quay-Portrieux;3159;223;3382
53;Bretagne;22;4;06;326;Saint-Rieul;544;5;549
53;Bretagne;22;1;19;327;Saint-Samson-sur-Rance;1639;27;1666
53;Bretagne;22;2;03;328;Saint-Servais;410;5;415
53;Bretagne;22;4;10;330;Saint-Thélo;383;11;394
53;Bretagne;22;2;23;331;Sainte-Tréphine;184;2;186
53;Bretagne;22;4;16;332;Saint-Trimoël;510;9;519
53;Bretagne;22;4;02;333;Saint-Vran;762;29;791
53;Bretagne;22;2;23;334;Saint-Igeaux;123;8;131
53;Bretagne;22;2;03;335;Senven-Léhart;237;0;237
53;Bretagne;22;4;02;337;Sévignac;1116;25;1141
53;Bretagne;22;2;01;338;Squiffiec;762;25;787
53;Bretagne;22;1;19;339;Taden;2521;75;2596
53;Bretagne;22;3;01;340;Tonquédec;1201;27;1228
53;Bretagne;22;4;16;341;Tramain;695;15;710
53;Bretagne;22;1;14;342;Trébédan;430;7;437
53;Bretagne;22;3;12;343;Trébeurden;3701;122;3823
53;Bretagne;22;2;23;344;Trébrivan;756;17;773
53;Bretagne;22;4;16;345;Trébry;779;15;794
53;Bretagne;22;4;13;346;Trédaniel;897;23;920
53;Bretagne;22;3;27;347;Trédarzec;1054;18;1072
53;Bretagne;22;4;02;348;Trédias;499;9;508
53;Bretagne;22;3;20;349;Trédrez-Locquémeau;1457;39;1496
53;Bretagne;22;3;20;350;Tréduder;193;4;197
53;Bretagne;22;2;23;351;Treffrin;540;14;554
53;Bretagne;22;1;08;352;Tréfumel;274;2;276
53;Bretagne;22;3;12;353;Trégastel;2549;73;2622
53;Bretagne;22;2;03;354;Tréglamus;1094;22;1116
53;Bretagne;22;2;15;356;Trégomeur;945;24;969
53;Bretagne;22;2;01;358;Trégonneau;559;7;566
53;Bretagne;22;3;20;359;Trégrom;412;5;417
53;Bretagne;22;4;26;360;Trégueux;8470;169;8639
53;Bretagne;22;2;22;361;Tréguidel;633;12;645
53;Bretagne;22;3;27;362;Tréguier;2411;267;2678
53;Bretagne;22;3;12;363;Trélévern;1242;26;1268
53;Bretagne;22;1;04;364;Trélivan;2899;80;2979
53;Bretagne;22;2;23;365;Trémargat;181;12;193
53;Bretagne;22;3;20;366;Trémel;403;5;408
53;Bretagne;22;1;19;368;Tréméreuc;724;29;753
53;Bretagne;22;4;02;369;Trémeur;787;12;799
53;Bretagne;22;2;22;370;Tréméven;351;8;359
53;Bretagne;22;4;02;371;Trémorel;1147;20;1167
53;Bretagne;22;4;18;372;Trémuson;2187;37;2224
53;Bretagne;22;2;23;373;Tréogan;104;3;107
53;Bretagne;22;2;22;375;Tressignaux;706;11;717
53;Bretagne;22;4;10;376;Trévé;1688;42;1730
53;Bretagne;22;4;22;377;Tréveneuc;798;21;819
53;Bretagne;22;2;22;378;Trévérec;215;7;222
53;Bretagne;22;3;12;379;Trévou-Tréguignec;1522;41;1563
53;Bretagne;22;1;08;380;Trévron;685;14;699
53;Bretagne;22;3;27;381;Trézény;353;10;363
53;Bretagne;22;3;27;383;Troguéry;217;5;222
53;Bretagne;22;4;10;384;Uzel;1080;27;1107
53;Bretagne;22;1;19;385;La Vicomté-sur-Rance;1113;25;1138
53;Bretagne;22;4;15;386;Le Vieux-Bourg;777;20;797
53;Bretagne;22;3;20;387;Le Vieux-Marché;1280;30;1310
53;Bretagne;22;1;04;388;Vildé-Guingalan;1257;28;1285
53;Bretagne;22;4;26;389;Yffiniac;4977;103;5080
53;Bretagne;22;2;11;390;Yvias;779;16;795
53;Bretagne;22;1;02;391;Yvignac-la-Tour;1123;16;1139
75;Nouvelle-Aquitaine;23;2;01;001;Ahun;1421;230;1651
75;Nouvelle-Aquitaine;23;2;14;002;Ajain;1043;12;1055
75;Nouvelle-Aquitaine;23;1;02;003;Alleyrat;138;0;138
75;Nouvelle-Aquitaine;23;2;14;004;Anzême;543;9;552
75;Nouvelle-Aquitaine;23;1;08;005;Arfeuille-Châtain;199;4;203
75;Nouvelle-Aquitaine;23;2;11;006;Arrènes;210;4;214
75;Nouvelle-Aquitaine;23;2;01;007;Ars;234;10;244
75;Nouvelle-Aquitaine;23;1;02;008;Aubusson;3181;154;3335
75;Nouvelle-Aquitaine;23;1;08;009;Auge;91;0;91
75;Nouvelle-Aquitaine;23;2;11;010;Augères;119;2;121
75;Nouvelle-Aquitaine;23;2;11;011;Aulon;163;4;167
75;Nouvelle-Aquitaine;23;2;05;012;Auriat;109;2;111
75;Nouvelle-Aquitaine;23;1;03;013;Auzances;1201;25;1226
75;Nouvelle-Aquitaine;23;2;11;014;Azat-Châtenet;122;3;125
75;Nouvelle-Aquitaine;23;2;07;015;Azerables;811;15;826
75;Nouvelle-Aquitaine;23;2;01;016;Banize;181;3;184
75;Nouvelle-Aquitaine;23;1;03;017;Basville;167;2;169
75;Nouvelle-Aquitaine;23;2;07;018;Bazelat;244;11;255
75;Nouvelle-Aquitaine;23;1;03;019;Beissat;27;0;27
75;Nouvelle-Aquitaine;23;1;02;020;Bellegarde-en-Marche;392;3;395
75;Nouvelle-Aquitaine;23;2;11;021;Bénévent-l'Abbaye;761;9;770
75;Nouvelle-Aquitaine;23;1;06;022;Bétête;378;6;384
75;Nouvelle-Aquitaine;23;1;10;023;Blaudeix;106;1;107
75;Nouvelle-Aquitaine;23;1;02;024;Blessac;539;15;554
75;Nouvelle-Aquitaine;23;2;04;025;Bonnat;1348;24;1372
75;Nouvelle-Aquitaine;23;1;06;026;Bord-Saint-Georges;358;4;362
75;Nouvelle-Aquitaine;23;2;05;027;Bosmoreau-les-Mines;232;7;239
75;Nouvelle-Aquitaine;23;1;02;028;Bosroger;110;3;113
75;Nouvelle-Aquitaine;23;2;04;029;Le Bourg-d'Hem;222;2;224
75;Nouvelle-Aquitaine;23;2;05;030;Bourganeuf;2462;212;2674
75;Nouvelle-Aquitaine;23;1;06;031;Boussac;1246;17;1263
75;Nouvelle-Aquitaine;23;1;06;032;Boussac-Bourg;692;11;703
75;Nouvelle-Aquitaine;23;2;14;033;La Brionne;451;8;459
75;Nouvelle-Aquitaine;23;1;03;034;Brousse;29;1;30
75;Nouvelle-Aquitaine;23;1;08;035;Budelière;702;10;712
75;Nouvelle-Aquitaine;23;2;14;036;Bussière-Dunoise;1035;15;1050
75;Nouvelle-Aquitaine;23;1;03;037;Bussière-Nouvelle;78;3;81
75;Nouvelle-Aquitaine;23;1;06;038;Bussière-Saint-Georges;252;3;255
75;Nouvelle-Aquitaine;23;2;07;039;La Celle-Dunoise;537;24;561
75;Nouvelle-Aquitaine;23;1;10;040;La Celle-sous-Gouzon;155;1;156
75;Nouvelle-Aquitaine;23;2;04;041;La Cellette;239;5;244
75;Nouvelle-Aquitaine;23;2;11;042;Ceyroux;126;1;127
75;Nouvelle-Aquitaine;23;2;01;043;Chamberaud;96;0;96
75;Nouvelle-Aquitaine;23;2;04;044;Chambon-Sainte-Croix;82;1;83
75;Nouvelle-Aquitaine;23;1;08;045;Chambon-sur-Voueize;863;12;875
75;Nouvelle-Aquitaine;23;1;08;046;Chambonchard;80;4;84
75;Nouvelle-Aquitaine;23;2;11;047;Chamborand;242;3;245
75;Nouvelle-Aquitaine;23;1;02;048;Champagnat;474;10;484
75;Nouvelle-Aquitaine;23;2;04;049;Champsanglard;251;8;259
75;Nouvelle-Aquitaine;23;2;07;050;La Chapelle-Baloue;125;1;126
75;Nouvelle-Aquitaine;23;2;01;051;La Chapelle-Saint-Martial;77;1;78
75;Nouvelle-Aquitaine;23;2;13;052;La Chapelle-Taillefert;435;10;445
75;Nouvelle-Aquitaine;23;1;03;053;Chard;202;2;204
75;Nouvelle-Aquitaine;23;1;03;054;Charron;218;2;220
75;Nouvelle-Aquitaine;23;1;03;055;Châtelard;30;0;30
75;Nouvelle-Aquitaine;23;2;11;056;Châtelus-le-Marcheix;289;5;294
75;Nouvelle-Aquitaine;23;2;04;057;Châtelus-Malvaleix;546;11;557
75;Nouvelle-Aquitaine;23;1;10;058;Le Chauchet;101;1;102
75;Nouvelle-Aquitaine;23;1;02;059;La Chaussade;99;6;105
75;Nouvelle-Aquitaine;23;2;01;060;Chavanat;141;5;146
75;Nouvelle-Aquitaine;23;1;10;061;Chénérailles;752;14;766
75;Nouvelle-Aquitaine;23;2;04;062;Chéniers;557;9;566
75;Nouvelle-Aquitaine;23;1;03;063;Clairavaux;154;1;155
75;Nouvelle-Aquitaine;23;1;06;064;Clugnat;653;3;656
75;Nouvelle-Aquitaine;23;2;07;065;Colondannes;277;9;286
75;Nouvelle-Aquitaine;23;1;03;066;Le Compas;194;12;206
75;Nouvelle-Aquitaine;23;1;03;067;La Courtine;798;8;806
75;Nouvelle-Aquitaine;23;1;10;068;Cressat;516;7;523
75;Nouvelle-Aquitaine;23;1;03;069;Crocq;404;3;407
75;Nouvelle-Aquitaine;23;2;07;070;Crozant;437;14;451
75;Nouvelle-Aquitaine;23;1;09;071;Croze;190;6;196
75;Nouvelle-Aquitaine;23;1;10;072;Domeyrot;234;2;236
75;Nouvelle-Aquitaine;23;1;03;073;Dontreix;418;10;428
75;Nouvelle-Aquitaine;23;2;01;074;Le Donzeil;186;3;189
75;Nouvelle-Aquitaine;23;2;07;075;Dun-le-Palestel;1090;24;1114
75;Nouvelle-Aquitaine;23;1;08;076;Évaux-les-Bains;1297;25;1322
75;Nouvelle-Aquitaine;23;1;09;077;Faux-la-Montagne;446;10;456
75;Nouvelle-Aquitaine;23;2;05;078;Faux-Mazuras;189;4;193
75;Nouvelle-Aquitaine;23;1;09;079;Felletin;1547;183;1730
75;Nouvelle-Aquitaine;23;1;09;080;Féniers;99;2;101
75;Nouvelle-Aquitaine;23;1;03;081;Flayat;300;6;306
75;Nouvelle-Aquitaine;23;2;11;082;Fleurat;313;6;319
75;Nouvelle-Aquitaine;23;1;08;083;Fontanières;245;2;247
75;Nouvelle-Aquitaine;23;2;04;084;La Forêt-du-Temple;145;2;147
75;Nouvelle-Aquitaine;23;2;01;086;Fransèches;243;3;246
75;Nouvelle-Aquitaine;23;2;07;087;Fresselines;484;10;494
75;Nouvelle-Aquitaine;23;2;14;088;Gartempe;119;1;120
75;Nouvelle-Aquitaine;23;2;04;089;Genouillac;727;10;737
75;Nouvelle-Aquitaine;23;1;09;090;Gentioux-Pigerolles;376;6;382
75;Nouvelle-Aquitaine;23;1;09;091;Gioux;161;3;164
75;Nouvelle-Aquitaine;23;2;14;092;Glénic;685;13;698
75;Nouvelle-Aquitaine;23;1;10;093;Gouzon;1568;22;1590
75;Nouvelle-Aquitaine;23;2;11;095;Le Grand-Bourg;1208;42;1250
75;Nouvelle-Aquitaine;23;2;99;096;Guéret;12698;629;13327
75;Nouvelle-Aquitaine;23;1;10;097;Issoudun-Létrieix;295;3;298
75;Nouvelle-Aquitaine;23;2;06;098;Jalesches;91;3;94
75;Nouvelle-Aquitaine;23;2;01;099;Janaillat;317;5;322
75;Nouvelle-Aquitaine;23;1;10;100;Jarnages;435;10;445
75;Nouvelle-Aquitaine;23;2;14;101;Jouillat;383;13;396
75;Nouvelle-Aquitaine;23;1;10;102;Ladapeyre;347;3;350
75;Nouvelle-Aquitaine;23;2;07;103;Lafat;322;14;336
75;Nouvelle-Aquitaine;23;1;06;104;Lavaufranche;239;1;240
75;Nouvelle-Aquitaine;23;1;10;105;Lavaveix-les-Mines;638;3;641
75;Nouvelle-Aquitaine;23;1;08;106;Lépaud;366;4;370
75;Nouvelle-Aquitaine;23;2;01;107;Lépinas;128;5;133
75;Nouvelle-Aquitaine;23;1;06;108;Leyrat;143;1;144
75;Nouvelle-Aquitaine;23;2;04;109;Linard-Malval;209;4;213
75;Nouvelle-Aquitaine;23;1;03;110;Lioux-les-Monges;62;1;63
75;Nouvelle-Aquitaine;23;2;11;111;Lizières;240;1;241
75;Nouvelle-Aquitaine;23;2;04;112;Lourdoueix-Saint-Pierre;733;13;746
75;Nouvelle-Aquitaine;23;1;02;113;Lupersat;298;6;304
75;Nouvelle-Aquitaine;23;1;08;114;Lussat;404;8;412
75;Nouvelle-Aquitaine;23;1;03;115;Magnat-l'Étrange;249;2;251
75;Nouvelle-Aquitaine;23;1;02;116;Mainsat;539;9;548
75;Nouvelle-Aquitaine;23;2;07;117;Maison-Feyne;296;9;305
75;Nouvelle-Aquitaine;23;2;01;118;Maisonnisses;177;6;183
75;Nouvelle-Aquitaine;23;1;03;119;Malleret;42;0;42
75;Nouvelle-Aquitaine;23;1;06;120;Malleret-Boussac;182;3;185
75;Nouvelle-Aquitaine;23;2;05;122;Mansat-la-Courrière;67;4;71
75;Nouvelle-Aquitaine;23;1;03;123;Les Mars;183;2;185
75;Nouvelle-Aquitaine;23;2;11;124;Marsac;640;17;657
75;Nouvelle-Aquitaine;23;1;03;125;Le Mas-d'Artige;98;1;99
75;Nouvelle-Aquitaine;23;1;02;127;Mautes;197;6;203
75;Nouvelle-Aquitaine;23;2;01;128;Mazeirat;125;5;130
75;Nouvelle-Aquitaine;23;1;03;129;La Mazière-aux-Bons-Hommes;64;1;65
75;Nouvelle-Aquitaine;23;2;04;130;Méasnes;527;6;533
75;Nouvelle-Aquitaine;23;1;03;131;Mérinchal;682;14;696
75;Nouvelle-Aquitaine;23;2;13;132;Montaigut-le-Blanc;398;6;404
75;Nouvelle-Aquitaine;23;2;05;133;Montboucher;354;10;364
75;Nouvelle-Aquitaine;23;2;09;134;Le Monteil-au-Vicomte;213;24;237
75;Nouvelle-Aquitaine;23;2;04;136;Mortroux;273;10;283
75;Nouvelle-Aquitaine;23;2;11;137;Mourioux-Vieilleville;518;12;530
75;Nouvelle-Aquitaine;23;2;01;138;Moutier-d'Ahun;161;1;162
75;Nouvelle-Aquitaine;23;2;04;139;Moutier-Malcard;541;5;546
75;Nouvelle-Aquitaine;23;1;09;140;Moutier-Rozeille;424;8;432
75;Nouvelle-Aquitaine;23;2;07;141;Naillat;628;16;644
75;Nouvelle-Aquitaine;23;1;02;142;Néoux;284;8;292
75;Nouvelle-Aquitaine;23;2;15;143;Noth;489;13;502
75;Nouvelle-Aquitaine;23;1;09;144;La Nouaille;235;3;238
75;Nouvelle-Aquitaine;23;1;08;145;Nouhant;277;8;285
75;Nouvelle-Aquitaine;23;1;06;146;Nouzerines;237;7;244
75;Nouvelle-Aquitaine;23;2;07;147;Nouzerolles;96;2;98
75;Nouvelle-Aquitaine;23;2;04;148;Nouziers;246;2;248
75;Nouvelle-Aquitaine;23;1;10;149;Parsac-Rimondeix;712;14;726
75;Nouvelle-Aquitaine;23;2;01;150;Peyrabout;155;3;158
75;Nouvelle-Aquitaine;23;1;10;151;Peyrat-la-Nonière;427;9;436
75;Nouvelle-Aquitaine;23;1;10;152;Pierrefitte;70;0;70
75;Nouvelle-Aquitaine;23;1;10;154;Pionnat;730;11;741
75;Nouvelle-Aquitaine;23;2;01;155;Pontarion;364;6;370
75;Nouvelle-Aquitaine;23;1;03;156;Pontcharraud;83;0;83
75;Nouvelle-Aquitaine;23;2;01;157;La Pouge;96;0;96
75;Nouvelle-Aquitaine;23;1;09;158;Poussanges;156;2;158
75;Nouvelle-Aquitaine;23;1;10;159;Puy-Malsignat;149;3;152
75;Nouvelle-Aquitaine;23;1;08;160;Reterre;269;1;270
75;Nouvelle-Aquitaine;23;2;04;162;Roches;372;3;375
75;Nouvelle-Aquitaine;23;1;03;164;Rougnat;479;10;489
75;Nouvelle-Aquitaine;23;2;09;165;Royère-de-Vassivière;578;7;585
75;Nouvelle-Aquitaine;23;2;07;166;Sagnat;192;7;199
75;Nouvelle-Aquitaine;23;1;08;167;Sannat;339;2;341
75;Nouvelle-Aquitaine;23;2;01;168;Sardent;760;18;778
75;Nouvelle-Aquitaine;23;2;12;169;La Saunière;645;13;658
75;Nouvelle-Aquitaine;23;2;12;170;Savennes;212;11;223
75;Nouvelle-Aquitaine;23;1;03;171;Sermur;108;1;109
75;Nouvelle-Aquitaine;23;1;02;172;La Serre-Bussière-Vieille;122;1;123
75;Nouvelle-Aquitaine;23;2;05;173;Soubrebost;139;3;142
75;Nouvelle-Aquitaine;23;1;06;174;Soumans;578;7;585
75;Nouvelle-Aquitaine;23;2;01;175;Sous-Parsat;114;0;114
75;Nouvelle-Aquitaine;23;2;15;176;La Souterraine;4953;229;5182
75;Nouvelle-Aquitaine;23;2;15;177;Saint-Agnant-de-Versillat;1085;30;1115
75;Nouvelle-Aquitaine;23;1;03;178;Saint-Agnant-près-Crocq;171;0;171
75;Nouvelle-Aquitaine;23;1;02;179;Saint-Alpinien;282;4;286
75;Nouvelle-Aquitaine;23;1;02;180;Saint-Amand;475;9;484
75;Nouvelle-Aquitaine;23;2;05;181;Saint-Amand-Jartoudeix;156;2;158
75;Nouvelle-Aquitaine;23;1;02;182;Saint-Avit-de-Tardes;169;2;171
75;Nouvelle-Aquitaine;23;2;01;183;Saint-Avit-le-Pauvre;77;2;79
75;Nouvelle-Aquitaine;23;1;03;184;Saint-Bard;97;3;100
75;Nouvelle-Aquitaine;23;1;10;185;Saint-Chabrais;295;2;297
75;Nouvelle-Aquitaine;23;2;13;186;Saint-Christophe;154;6;160
75;Nouvelle-Aquitaine;23;1;10;187;Saint-Dizier-la-Tour;186;2;188
75;Nouvelle-Aquitaine;23;2;04;188;Saint-Dizier-les-Domaines;196;2;198
75;Nouvelle-Aquitaine;23;2;05;189;Saint-Dizier-Masbaraud;1131;25;1156
75;Nouvelle-Aquitaine;23;1;02;190;Saint-Domet;163;1;164
75;Nouvelle-Aquitaine;23;2;13;191;Saint-Éloi;180;7;187
75;Nouvelle-Aquitaine;23;2;11;192;Fursac;1445;22;1467
75;Nouvelle-Aquitaine;23;2;12;193;Sainte-Feyre;2493;59;2552
75;Nouvelle-Aquitaine;23;1;09;194;Sainte-Feyre-la-Montagne;122;3;125
75;Nouvelle-Aquitaine;23;2;14;195;Saint-Fiel;1049;26;1075
75;Nouvelle-Aquitaine;23;1;09;196;Saint-Frion;255;5;260
75;Nouvelle-Aquitaine;23;2;01;197;Saint-Georges-la-Pouge;370;3;373
75;Nouvelle-Aquitaine;23;1;03;198;Saint-Georges-Nigremont;143;2;145
75;Nouvelle-Aquitaine;23;2;07;199;Saint-Germain-Beaupré;361;8;369
75;Nouvelle-Aquitaine;23;2;11;200;Saint-Goussaud;166;8;174
75;Nouvelle-Aquitaine;23;2;01;201;Saint-Hilaire-la-Plaine;213;5;218
75;Nouvelle-Aquitaine;23;2;01;202;Saint-Hilaire-le-Château;226;8;234
75;Nouvelle-Aquitaine;23;1;08;203;Saint-Julien-la-Genête;219;7;226
75;Nouvelle-Aquitaine;23;1;10;204;Saint-Julien-le-Châtel;141;3;144
75;Nouvelle-Aquitaine;23;2;05;205;Saint-Junien-la-Bregère;143;3;146
75;Nouvelle-Aquitaine;23;2;12;206;Saint-Laurent;693;15;708
75;Nouvelle-Aquitaine;23;2;15;207;Saint-Léger-Bridereix;185;6;191
75;Nouvelle-Aquitaine;23;2;14;208;Saint-Léger-le-Guérétois;409;9;418
75;Nouvelle-Aquitaine;23;1;10;209;Saint-Loup;183;1;184
75;Nouvelle-Aquitaine;23;1;02;210;Saint-Maixant;256;3;259
75;Nouvelle-Aquitaine;23;1;02;211;Saint-Marc-à-Frongier;426;9;435
75;Nouvelle-Aquitaine;23;1;09;212;Saint-Marc-à-Loubaud;125;1;126
75;Nouvelle-Aquitaine;23;1;06;213;Saint-Marien;187;3;190
75;Nouvelle-Aquitaine;23;2;01;214;Saint-Martial-le-Mont;269;3;272
75;Nouvelle-Aquitaine;23;1;03;215;Saint-Martial-le-Vieux;143;6;149
75;Nouvelle-Aquitaine;23;2;09;216;Saint-Martin-Château;147;5;152
75;Nouvelle-Aquitaine;23;2;05;217;Saint-Martin-Sainte-Catherine;338;4;342
75;Nouvelle-Aquitaine;23;1;03;218;Saint-Maurice-près-Crocq;97;2;99
75;Nouvelle-Aquitaine;23;2;15;219;Saint-Maurice-la-Souterraine;1190;19;1209
75;Nouvelle-Aquitaine;23;1;10;220;Saint-Médard-la-Rochette;559;12;571
75;Nouvelle-Aquitaine;23;1;03;221;Saint-Merd-la-Breuille;192;5;197
75;Nouvelle-Aquitaine;23;2;01;222;Saint-Michel-de-Veisse;163;4;167
75;Nouvelle-Aquitaine;23;2;05;223;Saint-Moreil;215;1;216
75;Nouvelle-Aquitaine;23;1;03;224;Saint-Oradoux-de-Chirouze;72;0;72
75;Nouvelle-Aquitaine;23;1;03;225;Saint-Oradoux-près-Crocq;107;1;108
75;Nouvelle-Aquitaine;23;1;03;226;Saint-Pardoux-d'Arnet;167;6;173
75;Nouvelle-Aquitaine;23;2;05;227;Saint-Pardoux-Morterolles;205;5;210
75;Nouvelle-Aquitaine;23;1;02;228;Saint-Pardoux-le-Neuf;201;9;210
75;Nouvelle-Aquitaine;23;1;10;229;Saint-Pardoux-les-Cards;285;2;287
75;Nouvelle-Aquitaine;23;2;05;230;Saint-Pierre-Chérignat;165;5;170
75;Nouvelle-Aquitaine;23;2;05;232;Saint-Pierre-Bellevue;208;1;209
75;Nouvelle-Aquitaine;23;1;06;233;Saint-Pierre-le-Bost;124;1;125
75;Nouvelle-Aquitaine;23;1;08;234;Saint-Priest;150;2;152
75;Nouvelle-Aquitaine;23;2;15;235;Saint-Priest-la-Feuille;757;15;772
75;Nouvelle-Aquitaine;23;2;11;236;Saint-Priest-la-Plaine;255;8;263
75;Nouvelle-Aquitaine;23;2;05;237;Saint-Priest-Palus;55;0;55
75;Nouvelle-Aquitaine;23;1;09;238;Saint-Quentin-la-Chabanne;376;7;383
75;Nouvelle-Aquitaine;23;2;07;239;Saint-Sébastien;633;11;644
75;Nouvelle-Aquitaine;23;1;06;240;Saint-Silvain-Bas-le-Roc;409;5;414
75;Nouvelle-Aquitaine;23;1;02;241;Saint-Silvain-Bellegarde;217;3;220
75;Nouvelle-Aquitaine;23;2;13;242;Saint-Silvain-Montaigut;215;4;219
75;Nouvelle-Aquitaine;23;1;10;243;Saint-Silvain-sous-Toulx;148;2;150
75;Nouvelle-Aquitaine;23;2;07;244;Saint-Sulpice-le-Dunois;577;14;591
75;Nouvelle-Aquitaine;23;2;14;245;Saint-Sulpice-le-Guérétois;1926;57;1983
75;Nouvelle-Aquitaine;23;1;02;246;Saint-Sulpice-les-Champs;348;8;356
75;Nouvelle-Aquitaine;23;2;14;247;Saint-Vaury;1735;122;1857
75;Nouvelle-Aquitaine;23;2;13;248;Saint-Victor-en-Marche;355;8;363
75;Nouvelle-Aquitaine;23;1;09;249;Saint-Yrieix-la-Montagne;221;3;224
75;Nouvelle-Aquitaine;23;2;01;250;Saint-Yrieix-les-Bois;291;4;295
75;Nouvelle-Aquitaine;23;1;08;251;Tardes;120;2;122
75;Nouvelle-Aquitaine;23;2;06;252;Tercillat;153;3;156
75;Nouvelle-Aquitaine;23;2;01;253;Thauron;177;6;183
75;Nouvelle-Aquitaine;23;1;06;254;Toulx-Sainte-Croix;250;2;252
75;Nouvelle-Aquitaine;23;1;10;255;Trois-Fonds;123;0;123
75;Nouvelle-Aquitaine;23;1;09;257;Vallière;715;13;728
75;Nouvelle-Aquitaine;23;2;15;258;Vareilles;305;9;314
75;Nouvelle-Aquitaine;23;1;08;259;Verneiges;120;1;121
75;Nouvelle-Aquitaine;23;2;01;260;Vidaillat;191;1;192
75;Nouvelle-Aquitaine;23;1;08;261;Viersat;280;4;284
75;Nouvelle-Aquitaine;23;1;10;262;Vigeville;164;2;166
75;Nouvelle-Aquitaine;23;2;07;263;Villard;378;5;383
75;Nouvelle-Aquitaine;23;1;09;264;La Villedieu;48;1;49
75;Nouvelle-Aquitaine;23;1;03;265;La Villeneuve;49;0;49
75;Nouvelle-Aquitaine;23;1;03;266;La Villetelle;171;0;171
75;Nouvelle-Aquitaine;24;2;13;001;Abjat-sur-Bandiat;627;9;636
75;Nouvelle-Aquitaine;24;3;22;002;Agonac;1791;24;1815
75;Nouvelle-Aquitaine;24;4;05;004;Ajat;285;3;288
75;Nouvelle-Aquitaine;24;1;08;005;Alles-sur-Dordogne;392;9;401
75;Nouvelle-Aquitaine;24;4;23;006;Allas-les-Mines;194;8;202
75;Nouvelle-Aquitaine;24;3;16;007;Allemans;514;8;522
75;Nouvelle-Aquitaine;24;2;06;008;Angoisse;588;11;599
75;Nouvelle-Aquitaine;24;2;06;009;Anlhiac;265;9;274
75;Nouvelle-Aquitaine;24;3;17;010;Annesse-et-Beaulieu;1412;50;1462
75;Nouvelle-Aquitaine;24;3;22;011;Antonne-et-Trigonant;1293;19;1312
75;Nouvelle-Aquitaine;24;4;20;012;Archignac;390;10;400
75;Nouvelle-Aquitaine;24;4;25;014;Aubas;617;20;637
75;Nouvelle-Aquitaine;24;4;23;015;Audrix;263;4;267
75;Nouvelle-Aquitaine;24;2;13;016;Augignac;824;19;843
75;Nouvelle-Aquitaine;24;4;05;018;Auriac-du-Périgord;401;10;411
75;Nouvelle-Aquitaine;24;4;05;019;Azerat;440;7;447
75;Nouvelle-Aquitaine;24;4;05;020;La Bachellerie;894;21;915
75;Nouvelle-Aquitaine;24;4;05;021;Badefols-d'Ans;386;8;394
75;Nouvelle-Aquitaine;24;1;08;022;Badefols-sur-Dordogne;208;5;213
75;Nouvelle-Aquitaine;24;1;08;023;Baneuil;324;13;337
75;Nouvelle-Aquitaine;24;1;19;024;Bardou;46;0;46
75;Nouvelle-Aquitaine;24;4;05;025;Bars;237;7;244
75;Nouvelle-Aquitaine;24;3;89;026;Bassillac et Auberoche;4364;83;4447
75;Nouvelle-Aquitaine;24;1;08;027;Bayac;358;1;359
75;Nouvelle-Aquitaine;24;1;08;028;Beaumontois en Périgord;1803;35;1838
75;Nouvelle-Aquitaine;24;3;24;029;Beaupouyet;533;6;539
75;Nouvelle-Aquitaine;24;4;05;030;Beauregard-de-Terrasson;681;16;697
75;Nouvelle-Aquitaine;24;3;12;031;Beauregard-et-Bassac;273;5;278
75;Nouvelle-Aquitaine;24;3;24;032;Beauronne;371;10;381
75;Nouvelle-Aquitaine;24;3;12;034;Beleymas;272;8;280
75;Nouvelle-Aquitaine;24;4;23;035;Pays de Belvès;1337;36;1373
75;Nouvelle-Aquitaine;24;4;23;036;Berbiguières;177;3;180
75;Nouvelle-Aquitaine;24;1;98;037;Bergerac;26360;741;27101
75;Nouvelle-Aquitaine;24;3;16;038;Bertric-Burée;430;13;443
75;Nouvelle-Aquitaine;24;4;23;039;Besse;163;4;167
75;Nouvelle-Aquitaine;24;4;18;040;Beynac-et-Cazenac;546;9;555
75;Nouvelle-Aquitaine;24;2;03;042;Biras;681;7;688
75;Nouvelle-Aquitaine;24;1;08;043;Biron;142;10;152
75;Nouvelle-Aquitaine;24;1;19;045;Boisse;246;4;250
75;Nouvelle-Aquitaine;24;4;05;046;Boisseuilh;117;3;120
75;Nouvelle-Aquitaine;24;1;11;048;Bonneville-et-Saint-Avit-de-Fumadières;315;11;326
75;Nouvelle-Aquitaine;24;4;20;050;Borrèze;345;4;349
75;Nouvelle-Aquitaine;24;1;10;051;Bosset;219;1;220
75;Nouvelle-Aquitaine;24;1;08;052;Bouillac;128;0;128
75;Nouvelle-Aquitaine;24;3;07;053;Boulazac Isle Manoire;10738;352;11090
75;Nouvelle-Aquitaine;24;1;19;054;Bouniagues;609;20;629
75;Nouvelle-Aquitaine;24;2;03;055;Bourdeilles;771;16;787
75;Nouvelle-Aquitaine;24;2;13;056;Le Bourdeix;228;4;232
75;Nouvelle-Aquitaine;24;3;16;057;Bourg-des-Maisons;69;2;71
75;Nouvelle-Aquitaine;24;3;16;058;Bourg-du-Bost;216;5;221
75;Nouvelle-Aquitaine;24;3;24;059;Bourgnac;349;4;353
75;Nouvelle-Aquitaine;24;1;08;060;Bourniquel;71;1;72
75;Nouvelle-Aquitaine;24;3;12;061;Bourrou;124;6;130
75;Nouvelle-Aquitaine;24;3;16;062;Bouteilles-Saint-Sébastien;177;3;180
75;Nouvelle-Aquitaine;24;4;23;063;Bouzic;150;3;153
75;Nouvelle-Aquitaine;24;2;03;064;Brantôme en Périgord;3694;68;3762
75;Nouvelle-Aquitaine;24;2;06;066;Brouchaud;211;5;216
75;Nouvelle-Aquitaine;24;4;25;067;Le Bugue;2595;40;2635
75;Nouvelle-Aquitaine;24;1;08;068;Le Buisson-de-Cadouin;1936;49;1985
75;Nouvelle-Aquitaine;24;2;03;069;Bussac;398;2;400
75;Nouvelle-Aquitaine;24;2;13;070;Busserolles;505;8;513
75;Nouvelle-Aquitaine;24;2;13;071;Bussière-Badil;373;2;375
75;Nouvelle-Aquitaine;24;1;08;073;Calès;377;12;389
75;Nouvelle-Aquitaine;24;4;20;074;Calviac-en-Périgord;520;14;534
75;Nouvelle-Aquitaine;24;4;23;075;Campagnac-lès-Quercy;321;8;329
75;Nouvelle-Aquitaine;24;4;25;076;Campagne;416;14;430
75;Nouvelle-Aquitaine;24;3;12;077;Campsegret;390;7;397
75;Nouvelle-Aquitaine;24;1;08;080;Capdrot;463;12;475
75;Nouvelle-Aquitaine;24;4;20;081;Carlux;640;10;650
75;Nouvelle-Aquitaine;24;4;20;082;Carsac-Aillac;1530;28;1558
75;Nouvelle-Aquitaine;24;1;11;083;Carsac-de-Gurson;184;4;188
75;Nouvelle-Aquitaine;24;4;23;084;Carves;104;4;108
75;Nouvelle-Aquitaine;24;4;20;085;La Cassagne;155;1;156
75;Nouvelle-Aquitaine;24;4;23;086;Castelnaud-la-Chapelle;447;7;454
75;Nouvelle-Aquitaine;24;4;23;087;Castels et Bézenac;812;17;829
75;Nouvelle-Aquitaine;24;1;08;088;Cause-de-Clérans;346;7;353
75;Nouvelle-Aquitaine;24;3;16;090;Celles;594;11;605
75;Nouvelle-Aquitaine;24;4;23;091;Cénac-et-Saint-Julien;1199;31;1230
75;Nouvelle-Aquitaine;24;3;12;094;Chalagnac;441;9;450
75;Nouvelle-Aquitaine;24;2;21;095;Chalais;403;9;412
75;Nouvelle-Aquitaine;24;2;03;096;Champagnac-de-Belair;786;14;800
75;Nouvelle-Aquitaine;24;3;16;097;Champagne-et-Fontaine;350;14;364
75;Nouvelle-Aquitaine;24;3;22;098;Champcevinel;2980;91;3071
75;Nouvelle-Aquitaine;24;2;13;100;Champniers-et-Reilhac;452;4;456
75;Nouvelle-Aquitaine;24;2;13;101;Champs-Romain;279;7;286
75;Nouvelle-Aquitaine;24;3;04;102;Chancelade;4419;83;4502
75;Nouvelle-Aquitaine;24;3;24;104;Chantérac;619;7;626
75;Nouvelle-Aquitaine;24;3;03;105;Chapdeuil;137;1;138
75;Nouvelle-Aquitaine;24;4;25;106;La Chapelle-Aubareil;533;23;556
75;Nouvelle-Aquitaine;24;2;03;107;La Chapelle-Faucher;395;8;403
75;Nouvelle-Aquitaine;24;3;17;108;La Chapelle-Gonaguet;1076;15;1091
75;Nouvelle-Aquitaine;24;3;16;109;La Chapelle-Grésignac;102;3;105
75;Nouvelle-Aquitaine;24;3;16;110;La Chapelle-Montabourlet;60;4;64
75;Nouvelle-Aquitaine;24;2;03;111;La Chapelle-Montmoreau;74;1;75
75;Nouvelle-Aquitaine;24;4;05;113;La Chapelle-Saint-Jean;89;3;92
75;Nouvelle-Aquitaine;24;3;16;114;Chassaignes;68;2;70
75;Nouvelle-Aquitaine;24;3;22;115;Château-l'Évêque;2138;33;2171
75;Nouvelle-Aquitaine;24;4;05;116;Châtres;184;1;185
75;Nouvelle-Aquitaine;24;4;20;117;Les Coteaux Périgourdins;563;18;581
75;Nouvelle-Aquitaine;24;3;16;119;Cherval;237;4;241
75;Nouvelle-Aquitaine;24;2;06;120;Cherveix-Cubas;554;6;560
75;Nouvelle-Aquitaine;24;4;05;121;Chourgnac;62;1;63
75;Nouvelle-Aquitaine;24;4;23;122;Cladech;103;4;107
75;Nouvelle-Aquitaine;24;3;12;123;Clermont-de-Beauregard;120;1;121
75;Nouvelle-Aquitaine;24;2;06;124;Clermont-d'Excideuil;234;6;240
75;Nouvelle-Aquitaine;24;1;19;126;Colombier;268;12;280
75;Nouvelle-Aquitaine;24;3;16;128;Comberanche-et-Épeluche;164;3;167
75;Nouvelle-Aquitaine;24;2;03;129;Condat-sur-Trincou;476;8;484
75;Nouvelle-Aquitaine;24;4;20;130;Condat-sur-Vézère;882;16;898
75;Nouvelle-Aquitaine;24;2;13;131;Connezac;70;1;71
75;Nouvelle-Aquitaine;24;1;19;132;Conne-de-Labarde;268;4;272
75;Nouvelle-Aquitaine;24;2;21;133;La Coquille;1269;17;1286
75;Nouvelle-Aquitaine;24;2;21;134;Corgnac-sur-l'Isle;846;14;860
75;Nouvelle-Aquitaine;24;3;22;135;Cornille;687;12;699
75;Nouvelle-Aquitaine;24;4;05;136;Coubjours;113;6;119
75;Nouvelle-Aquitaine;24;2;06;137;Coulaures;725;77;802
75;Nouvelle-Aquitaine;24;3;04;138;Coulounieix-Chamiers;7316;297;7613
75;Nouvelle-Aquitaine;24;3;17;139;Coursac;2242;49;2291
75;Nouvelle-Aquitaine;24;1;02;140;Cours-de-Pile;1558;39;1597
75;Nouvelle-Aquitaine;24;3;16;141;Coutures;188;3;191
75;Nouvelle-Aquitaine;24;4;23;142;Coux et Bigaroque-Mouzens;1218;42;1260
75;Nouvelle-Aquitaine;24;1;08;143;Couze-et-Saint-Front;729;9;738
75;Nouvelle-Aquitaine;24;3;03;144;Creyssac;98;0;98
75;Nouvelle-Aquitaine;24;1;02;145;Creysse;1751;34;1785
75;Nouvelle-Aquitaine;24;3;12;146;Creyssensac-et-Pissot;252;9;261
75;Nouvelle-Aquitaine;24;2;06;147;Cubjac-Auvézère-Val d'Ans;1100;12;1112
75;Nouvelle-Aquitaine;24;1;19;148;Cunèges;295;3;298
75;Nouvelle-Aquitaine;24;4;23;150;Daglan;527;19;546
75;Nouvelle-Aquitaine;24;4;23;151;Doissat;102;2;104
75;Nouvelle-Aquitaine;24;4;23;152;Domme;907;23;930
75;Nouvelle-Aquitaine;24;4;20;153;La Dornac;398;12;410
75;Nouvelle-Aquitaine;24;3;03;154;Douchapt;350;10;360
75;Nouvelle-Aquitaine;24;3;12;155;Douville;462;6;468
75;Nouvelle-Aquitaine;24;3;07;156;La Douze;1162;17;1179
75;Nouvelle-Aquitaine;24;3;24;157;Douzillac;810;14;824
75;Nouvelle-Aquitaine;24;2;06;158;Dussac;408;4;412
75;Nouvelle-Aquitaine;24;3;09;159;Échourgnac;392;8;400
75;Nouvelle-Aquitaine;24;3;12;160;Église-Neuve-de-Vergt;571;2;573
75;Nouvelle-Aquitaine;24;3;12;161;Église-Neuve-d'Issac;123;1;124
75;Nouvelle-Aquitaine;24;3;22;162;Escoire;400;9;409
75;Nouvelle-Aquitaine;24;2;13;163;Étouars;161;2;163
75;Nouvelle-Aquitaine;24;2;06;164;Excideuil;1176;28;1204
75;Nouvelle-Aquitaine;24;3;09;165;Eygurande-et-Gardedeuil;413;6;419
75;Nouvelle-Aquitaine;24;1;19;167;Eymet;2547;41;2588
75;Nouvelle-Aquitaine;24;1;19;168;Plaisance;423;13;436
75;Nouvelle-Aquitaine;24;2;21;171;Eyzerac;556;8;564
75;Nouvelle-Aquitaine;24;4;25;172;Les Eyzies;1109;20;1129
75;Nouvelle-Aquitaine;24;4;25;174;Fanlac;143;1;144
75;Nouvelle-Aquitaine;24;4;25;175;Les Farges;310;17;327
75;Nouvelle-Aquitaine;24;1;19;176;Faurilles;36;0;36
75;Nouvelle-Aquitaine;24;1;19;177;Faux;652;8;660
75;Nouvelle-Aquitaine;24;4;20;179;La Feuillade;789;29;818
75;Nouvelle-Aquitaine;24;2;21;180;Firbeix;312;6;318
75;Nouvelle-Aquitaine;24;1;10;182;Le Fleix;1492;52;1544
75;Nouvelle-Aquitaine;24;4;25;183;Fleurac;300;3;303
75;Nouvelle-Aquitaine;24;4;23;184;Florimont-Gaumier;149;2;151
75;Nouvelle-Aquitaine;24;1;19;186;Fonroque;332;2;334
75;Nouvelle-Aquitaine;24;4;05;188;Fossemagne;542;10;552
75;Nouvelle-Aquitaine;24;1;11;189;Fougueyrolles;447;16;463
75;Nouvelle-Aquitaine;24;3;12;190;Fouleix;268;8;276
75;Nouvelle-Aquitaine;24;1;10;191;Fraisse;172;1;173
75;Nouvelle-Aquitaine;24;4;05;192;Gabillou;93;3;96
75;Nouvelle-Aquitaine;24;1;19;193;Gageac-et-Rouillac;478;8;486
75;Nouvelle-Aquitaine;24;1;10;194;Gardonne;1588;28;1616
75;Nouvelle-Aquitaine;24;1;08;195;Gaugeac;108;1;109
75;Nouvelle-Aquitaine;24;2;06;196;Génis;494;4;498
75;Nouvelle-Aquitaine;24;1;10;197;Ginestet;733;16;749
75;Nouvelle-Aquitaine;24;3;16;199;Gout-Rossignol;367;8;375
75;Nouvelle-Aquitaine;24;3;03;200;Grand-Brassac;545;11;556
75;Nouvelle-Aquitaine;24;4;05;202;Granges-d'Ans;143;4;147
75;Nouvelle-Aquitaine;24;3;17;205;Grignols;669;5;674
75;Nouvelle-Aquitaine;24;4;23;206;Grives;107;4;111
75;Nouvelle-Aquitaine;24;4;23;207;Groléjac;654;16;670
75;Nouvelle-Aquitaine;24;3;12;208;Grun-Bordas;243;4;247
75;Nouvelle-Aquitaine;24;2;13;209;Hautefaye;139;1;140
75;Nouvelle-Aquitaine;24;4;05;210;Hautefort;823;19;842
75;Nouvelle-Aquitaine;24;3;12;211;Issac;430;3;433
75;Nouvelle-Aquitaine;24;1;19;212;Issigeac;746;9;755
75;Nouvelle-Aquitaine;24;3;17;213;Jaure;174;2;176
75;Nouvelle-Aquitaine;24;2;13;214;Javerlhac-et-la-Chapelle-Saint-Robert;829;10;839
75;Nouvelle-Aquitaine;24;4;20;215;Jayac;181;6;187
75;Nouvelle-Aquitaine;24;3;16;216;La Jemaye-Ponteyraud;152;4;156
75;Nouvelle-Aquitaine;24;4;25;217;Journiac;455;8;463
75;Nouvelle-Aquitaine;24;2;21;218;Jumilhac-le-Grand;1144;43;1187
75;Nouvelle-Aquitaine;24;3;12;220;Lacropte;686;10;696
75;Nouvelle-Aquitaine;24;2;03;221;Rudeau-Ladosse;157;4;161
75;Nouvelle-Aquitaine;24;1;10;222;La Force;2641;89;2730
75;Nouvelle-Aquitaine;24;1;08;223;Lalinde;2827;46;2873
75;Nouvelle-Aquitaine;24;1;02;224;Lamonzie-Montastruc;690;12;702
75;Nouvelle-Aquitaine;24;1;10;225;Lamonzie-Saint-Martin;2738;43;2781
75;Nouvelle-Aquitaine;24;1;11;226;Lamothe-Montravel;1390;21;1411
75;Nouvelle-Aquitaine;24;2;06;227;Lanouaille;963;24;987
75;Nouvelle-Aquitaine;24;1;08;228;Lanquais;498;11;509
75;Nouvelle-Aquitaine;24;4;05;229;Le Lardin-Saint-Lazare;1672;38;1710
75;Nouvelle-Aquitaine;24;4;23;230;Larzac;148;1;149
75;Nouvelle-Aquitaine;24;1;08;231;Lavalade;100;1;101
75;Nouvelle-Aquitaine;24;4;23;232;Lavaur;72;2;74
75;Nouvelle-Aquitaine;24;3;24;234;Les Lèches;379;2;381
75;Nouvelle-Aquitaine;24;3;17;236;Léguillac-de-l'Auche;987;16;1003
75;Nouvelle-Aquitaine;24;1;02;237;Lembras;1241;25;1266
75;Nouvelle-Aquitaine;24;2;21;238;Lempzours;136;5;141
75;Nouvelle-Aquitaine;24;4;12;240;Limeuil;334;8;342
75;Nouvelle-Aquitaine;24;4;05;241;Limeyrat;438;7;445
75;Nouvelle-Aquitaine;24;1;08;242;Liorac-sur-Louyre;256;1;257
75;Nouvelle-Aquitaine;24;3;03;243;Lisle;825;12;837
75;Nouvelle-Aquitaine;24;1;08;244;Lolme;191;2;193
75;Nouvelle-Aquitaine;24;4;23;245;Loubejac;259;4;263
75;Nouvelle-Aquitaine;24;1;10;246;Lunas;426;4;430
75;Nouvelle-Aquitaine;24;3;16;247;Lusignac;161;4;165
75;Nouvelle-Aquitaine;24;2;13;248;Lussas-et-Nontronneau;286;6;292
75;Nouvelle-Aquitaine;24;3;17;251;Manzac-sur-Vern;554;9;563
75;Nouvelle-Aquitaine;24;4;18;252;Marcillac-Saint-Quentin;818;20;838
75;Nouvelle-Aquitaine;24;2;03;253;Mareuil en Périgord;2290;41;2331
75;Nouvelle-Aquitaine;24;4;23;254;Marnac;183;1;184
75;Nouvelle-Aquitaine;24;4;18;255;Marquay;582;9;591
75;Nouvelle-Aquitaine;24;3;04;256;Marsac-sur-l'Isle;3147;75;3222
75;Nouvelle-Aquitaine;24;1;08;257;Marsalès;229;5;234
75;Nouvelle-Aquitaine;24;3;12;259;Eyraud-Crempse-Maurens;1587;28;1615
75;Nouvelle-Aquitaine;24;1;08;260;Mauzac-et-Grand-Castang;870;10;880
75;Nouvelle-Aquitaine;24;4;25;261;Mauzens-et-Miremont;284;10;294
75;Nouvelle-Aquitaine;24;2;06;262;Mayac;338;9;347
75;Nouvelle-Aquitaine;24;4;23;263;Mazeyrolles;302;13;315
75;Nouvelle-Aquitaine;24;3;09;264;Ménesplet;1863;21;1884
75;Nouvelle-Aquitaine;24;3;17;266;Mensignac;1520;27;1547
75;Nouvelle-Aquitaine;24;1;19;267;Mescoules;179;1;180
75;Nouvelle-Aquitaine;24;4;23;268;Meyrals;677;15;692
75;Nouvelle-Aquitaine;24;2;21;269;Mialet;635;5;640
75;Nouvelle-Aquitaine;24;2;13;271;Milhac-de-Nontron;492;14;506
75;Nouvelle-Aquitaine;24;1;11;272;Minzac;477;5;482
75;Nouvelle-Aquitaine;24;1;08;273;Molières;337;10;347
75;Nouvelle-Aquitaine;24;1;19;274;Monbazillac;800;88;888
75;Nouvelle-Aquitaine;24;1;19;276;Monestier;406;4;410
75;Nouvelle-Aquitaine;24;1;10;277;Monfaucon;288;4;292
75;Nouvelle-Aquitaine;24;1;19;278;Monmadalès;82;1;83
75;Nouvelle-Aquitaine;24;1;19;279;Monmarvès;62;1;63
75;Nouvelle-Aquitaine;24;1;08;280;Monpazier;452;5;457
75;Nouvelle-Aquitaine;24;1;08;281;Monsac;188;2;190
75;Nouvelle-Aquitaine;24;1;19;282;Monsaguel;141;7;148
75;Nouvelle-Aquitaine;24;4;05;284;Montagnac-d'Auberoche;135;5;140
75;Nouvelle-Aquitaine;24;3;12;285;Montagnac-la-Crempse;418;15;433
75;Nouvelle-Aquitaine;24;3;03;286;Montagrier;503;11;514
75;Nouvelle-Aquitaine;24;1;19;287;Montaut;127;2;129
75;Nouvelle-Aquitaine;24;1;11;288;Montazeau;283;4;287
75;Nouvelle-Aquitaine;24;1;11;289;Montcaret;1453;19;1472
75;Nouvelle-Aquitaine;24;1;08;290;Montferrand-du-Périgord;155;4;159
75;Nouvelle-Aquitaine;24;4;25;291;Montignac-Lascaux;2757;54;2811
75;Nouvelle-Aquitaine;24;1;11;292;Montpeyroux;472;13;485
75;Nouvelle-Aquitaine;24;4;23;293;Monplaisant;289;9;298
75;Nouvelle-Aquitaine;24;3;09;294;Montpon-Ménestérol;5807;71;5878
75;Nouvelle-Aquitaine;24;3;17;295;Montrem;1197;21;1218
75;Nouvelle-Aquitaine;24;1;02;296;Mouleydier;1144;11;1155
75;Nouvelle-Aquitaine;24;3;09;297;Moulin-Neuf;947;12;959
75;Nouvelle-Aquitaine;24;3;24;299;Mussidan;2788;48;2836
75;Nouvelle-Aquitaine;24;4;23;300;Nabirat;368;9;377
75;Nouvelle-Aquitaine;24;4;20;301;Nadaillac;386;4;390
75;Nouvelle-Aquitaine;24;4;05;302;Nailhac;296;2;298
75;Nouvelle-Aquitaine;24;3;16;303;Nanteuil-Auriac-de-Bourzac;231;2;233
75;Nouvelle-Aquitaine;24;2;21;304;Nantheuil;974;23;997
75;Nouvelle-Aquitaine;24;2;21;305;Nanthiat;238;2;240
75;Nouvelle-Aquitaine;24;1;11;306;Nastringues;127;4;131
75;Nouvelle-Aquitaine;24;1;08;307;Naussannes;255;4;259
75;Nouvelle-Aquitaine;24;2;21;308;Négrondes;792;10;802
75;Nouvelle-Aquitaine;24;3;24;309;Neuvic;3618;63;3681
75;Nouvelle-Aquitaine;24;2;13;311;Nontron;3040;111;3151
75;Nouvelle-Aquitaine;24;3;88;312;Sanilhac;4665;104;4769
75;Nouvelle-Aquitaine;24;4;23;313;Orliac;49;0;49
75;Nouvelle-Aquitaine;24;3;09;316;Parcoul-Chenaud;796;16;812
75;Nouvelle-Aquitaine;24;4;20;317;Paulin;251;8;259
75;Nouvelle-Aquitaine;24;3;12;318;Paunat;314;8;322
75;Nouvelle-Aquitaine;24;3;03;319;Paussac-et-Saint-Vivien;478;10;488
75;Nouvelle-Aquitaine;24;2;06;320;Payzac;971;18;989
75;Nouvelle-Aquitaine;24;4;20;321;Pazayac;850;15;865
75;Nouvelle-Aquitaine;24;3;99;322;Périgueux;29255;1568;30823
75;Nouvelle-Aquitaine;24;3;16;323;Petit-Bersac;184;5;189
75;Nouvelle-Aquitaine;24;4;05;324;Peyrignac;574;9;583
75;Nouvelle-Aquitaine;24;4;20;325;Pechs-de-l'Espérance;760;26;786
75;Nouvelle-Aquitaine;24;4;25;326;Peyzac-le-Moustier;194;2;196
75;Nouvelle-Aquitaine;24;1;08;327;Pezuls;128;3;131
75;Nouvelle-Aquitaine;24;2;13;328;Piégut-Pluviers;1187;19;1206
75;Nouvelle-Aquitaine;24;3;09;329;Le Pizou;1351;21;1372
75;Nouvelle-Aquitaine;24;4;25;330;Plazac;696;12;708
75;Nouvelle-Aquitaine;24;1;19;331;Pomport;726;20;746
75;Nouvelle-Aquitaine;24;1;08;334;Pontours;195;5;200
75;Nouvelle-Aquitaine;24;1;11;335;Port-Sainte-Foy-et-Ponchapt;2487;43;2530
75;Nouvelle-Aquitaine;24;4;20;336;Prats-de-Carlux;529;19;548
75;Nouvelle-Aquitaine;24;4;23;337;Prats-du-Périgord;146;2;148
75;Nouvelle-Aquitaine;24;1;08;338;Pressignac-Vicq;435;7;442
75;Nouvelle-Aquitaine;24;2;06;339;Preyssac-d'Excideuil;145;0;145
75;Nouvelle-Aquitaine;24;1;10;340;Prigonrieux;4223;76;4299
75;Nouvelle-Aquitaine;24;4;18;341;Proissans;1055;21;1076
75;Nouvelle-Aquitaine;24;1;02;345;Queyssac;488;12;500
75;Nouvelle-Aquitaine;24;2;03;346;Quinsac;385;9;394
75;Nouvelle-Aquitaine;24;1;08;347;Rampieux;142;0;142
75;Nouvelle-Aquitaine;24;1;19;348;Razac-d'Eymet;313;1;314
75;Nouvelle-Aquitaine;24;1;19;349;Razac-de-Saussignac;342;9;351
75;Nouvelle-Aquitaine;24;3;04;350;Razac-sur-l'Isle;2371;48;2419
75;Nouvelle-Aquitaine;24;1;19;351;Ribagnac;313;6;319
75;Nouvelle-Aquitaine;24;3;16;352;Ribérac;3837;152;3989
75;Nouvelle-Aquitaine;24;2;03;353;La Rochebeaucourt-et-Argentine;332;9;341
75;Nouvelle-Aquitaine;24;3;09;354;La Roche-Chalais;3009;51;3060
75;Nouvelle-Aquitaine;24;4;18;355;La Roque-Gageac;429;3;432
75;Nouvelle-Aquitaine;24;4;25;356;Rouffignac-Saint-Cernin-de-Reilhac;1630;35;1665
75;Nouvelle-Aquitaine;24;1;19;357;Rouffignac-de-Sigoulès;298;7;305
75;Nouvelle-Aquitaine;24;1;19;359;Sadillac;116;2;118
75;Nouvelle-Aquitaine;24;4;23;360;Sagelat;317;5;322
75;Nouvelle-Aquitaine;24;1;08;361;Saint-Agne;450;7;457
75;Nouvelle-Aquitaine;24;3;12;362;Val de Louyre et Caudeau;1588;21;1609
75;Nouvelle-Aquitaine;24;4;25;364;Coly-Saint-Amand;588;16;604
75;Nouvelle-Aquitaine;24;3;12;365;Saint-Amand-de-Vergt;245;8;253
75;Nouvelle-Aquitaine;24;4;18;366;Saint-André-d'Allas;863;20;883
75;Nouvelle-Aquitaine;24;3;16;367;Saint-André-de-Double;181;1;182
75;Nouvelle-Aquitaine;24;1;11;370;Saint-Antoine-de-Breuilh;1849;41;1890
75;Nouvelle-Aquitaine;24;3;24;371;Saint-Aquilin;465;2;467
75;Nouvelle-Aquitaine;24;3;17;372;Saint-Astier;5340;89;5429
75;Nouvelle-Aquitaine;24;1;19;373;Saint-Aubin-de-Cadelech;343;8;351
75;Nouvelle-Aquitaine;24;1;19;374;Saint-Aubin-de-Lanquais;357;4;361
75;Nouvelle-Aquitaine;24;4;23;375;Saint-Aubin-de-Nabirat;150;3;153
75;Nouvelle-Aquitaine;24;3;09;376;Saint Aulaye-Puymangou;1422;19;1441
75;Nouvelle-Aquitaine;24;4;25;377;Saint-Avit-de-Vialard;155;3;158
75;Nouvelle-Aquitaine;24;1;08;378;Saint-Avit-Rivière;83;1;84
75;Nouvelle-Aquitaine;24;1;08;379;Saint-Avit-Sénieur;412;4;416
75;Nouvelle-Aquitaine;24;3;09;380;Saint-Barthélemy-de-Bellegarde;495;2;497
75;Nouvelle-Aquitaine;24;2;13;381;Saint-Barthélemy-de-Bussière;212;8;220
75;Nouvelle-Aquitaine;24;1;08;382;Saint-Capraise-de-Lalinde;526;9;535
75;Nouvelle-Aquitaine;24;1;19;383;Saint-Capraise-d'Eymet;165;2;167
75;Nouvelle-Aquitaine;24;1;08;384;Saint-Cassien;35;2;37
75;Nouvelle-Aquitaine;24;1;19;385;Saint-Cernin-de-Labarde;224;2;226
75;Nouvelle-Aquitaine;24;4;23;386;Saint-Cernin-de-l'Herm;205;10;215
75;Nouvelle-Aquitaine;24;4;25;388;Saint-Chamassy;489;15;504
75;Nouvelle-Aquitaine;24;3;07;390;Saint-Crépin-d'Auberoche;335;9;344
75;Nouvelle-Aquitaine;24;4;20;392;Saint-Crépin-et-Carlucet;523;8;531
75;Nouvelle-Aquitaine;24;1;08;393;Sainte-Croix;88;0;88
75;Nouvelle-Aquitaine;24;2;03;394;Sainte-Croix-de-Mareuil;151;7;158
75;Nouvelle-Aquitaine;24;4;23;395;Saint-Cybranet;366;6;372
75;Nouvelle-Aquitaine;24;4;23;396;Saint-Cyprien;1538;34;1572
75;Nouvelle-Aquitaine;24;2;06;397;Saint-Cyr-les-Champagnes;258;8;266
75;Nouvelle-Aquitaine;24;2;13;398;Saint-Estèphe;592;8;600
75;Nouvelle-Aquitaine;24;3;24;399;Saint-Étienne-de-Puycorbier;106;4;110
75;Nouvelle-Aquitaine;24;4;05;401;Sainte-Eulalie-d'Ans;297;4;301
75;Nouvelle-Aquitaine;24;2;03;403;Saint-Félix-de-Bourdeilles;66;0;66
75;Nouvelle-Aquitaine;24;4;25;404;Saint-Félix-de-Reillac-et-Mortemart;177;1;178
75;Nouvelle-Aquitaine;24;1;08;405;Saint-Félix-de-Villadeix;328;9;337
75;Nouvelle-Aquitaine;24;4;23;406;Sainte-Foy-de-Belvès;140;2;142
75;Nouvelle-Aquitaine;24;1;08;407;Sainte-Foy-de-Longas;241;7;248
75;Nouvelle-Aquitaine;24;2;21;408;Saint-Front-d'Alemps;256;3;259
75;Nouvelle-Aquitaine;24;3;24;409;Saint-Front-de-Pradoux;1178;27;1205
75;Nouvelle-Aquitaine;24;2;13;410;Saint-Front-la-Rivière;498;8;506
75;Nouvelle-Aquitaine;24;2;13;411;Saint-Front-sur-Nizonne;162;3;165
75;Nouvelle-Aquitaine;24;4;20;412;Saint-Geniès;906;26;932
75;Nouvelle-Aquitaine;24;1;10;413;Saint-Georges-Blancaneix;279;0;279
75;Nouvelle-Aquitaine;24;3;12;414;Saint-Georges-de-Montclard;280;5;285
75;Nouvelle-Aquitaine;24;1;11;415;Saint-Géraud-de-Corps;237;6;243
75;Nouvelle-Aquitaine;24;4;23;416;Saint-Germain-de-Belvès;169;9;178
75;Nouvelle-Aquitaine;24;2;06;417;Saint-Germain-des-Prés;466;8;474
75;Nouvelle-Aquitaine;24;3;24;418;Saint-Germain-du-Salembre;933;18;951
75;Nouvelle-Aquitaine;24;1;02;419;Saint-Germain-et-Mons;874;19;893
75;Nouvelle-Aquitaine;24;1;10;420;Saint-Géry;248;2;250
75;Nouvelle-Aquitaine;24;3;07;421;Saint-Geyrac;195;5;200
75;Nouvelle-Aquitaine;24;3;12;422;Saint-Hilaire-d'Estissac;118;2;120
75;Nouvelle-Aquitaine;24;1;19;423;Saint-Julien-Innocence-Eulalie;310;2;312
75;Nouvelle-Aquitaine;24;3;24;424;Saint-Jean-d'Ataux;133;3;136
75;Nouvelle-Aquitaine;24;2;21;425;Saint-Jean-de-Côle;369;6;375
75;Nouvelle-Aquitaine;24;3;12;426;Saint-Jean-d'Estissac;161;6;167
75;Nouvelle-Aquitaine;24;2;21;428;Saint-Jory-de-Chalais;581;38;619
75;Nouvelle-Aquitaine;24;2;06;429;Saint-Jory-las-Bloux;238;8;246
75;Nouvelle-Aquitaine;24;4;20;432;Saint-Julien-de-Lampon;643;15;658
75;Nouvelle-Aquitaine;24;3;03;434;Saint-Just;146;3;149
75;Nouvelle-Aquitaine;24;3;24;436;Saint-Laurent-des-Hommes;1027;19;1046
75;Nouvelle-Aquitaine;24;1;10;437;Saint-Laurent-des-Vignes;974;14;988
75;Nouvelle-Aquitaine;24;4;23;438;Saint-Laurent-la-Vallée;236;9;245
75;Nouvelle-Aquitaine;24;1;19;441;Saint-Léon-d'Issigeac;143;3;146
75;Nouvelle-Aquitaine;24;3;17;442;Saint-Léon-sur-l'Isle;2029;30;2059
75;Nouvelle-Aquitaine;24;4;25;443;Saint-Léon-sur-Vézère;421;13;434
75;Nouvelle-Aquitaine;24;3;24;444;Saint-Louis-en-l'Isle;304;7;311
75;Nouvelle-Aquitaine;24;1;08;445;Saint-Marcel-du-Périgord;144;5;149
75;Nouvelle-Aquitaine;24;1;08;446;Saint-Marcory;49;3;52
75;Nouvelle-Aquitaine;24;2;06;448;Saint-Martial-d'Albarède;479;10;489
75;Nouvelle-Aquitaine;24;3;09;449;Saint-Martial-d'Artenset;942;15;957
75;Nouvelle-Aquitaine;24;4;23;450;Saint-Martial-de-Nabirat;571;4;575
75;Nouvelle-Aquitaine;24;2;13;451;Saint-Martial-de-Valette;800;19;819
75;Nouvelle-Aquitaine;24;3;16;452;Saint-Martial-Viveyrol;186;2;188
75;Nouvelle-Aquitaine;24;2;21;453;Saint-Martin-de-Fressengeas;363;6;369
75;Nouvelle-Aquitaine;24;1;11;454;Saint-Martin-de-Gurson;652;7;659
75;Nouvelle-Aquitaine;24;3;16;455;Saint-Martin-de-Ribérac;739;10;749
75;Nouvelle-Aquitaine;24;3;12;456;Saint-Martin-des-Combes;196;3;199
75;Nouvelle-Aquitaine;24;3;24;457;Saint-Martin-l'Astier;138;2;140
75;Nouvelle-Aquitaine;24;2;13;458;Saint-Martin-le-Pin;262;7;269
75;Nouvelle-Aquitaine;24;3;12;459;Saint-Mayme-de-Péreyrol;285;10;295
75;Nouvelle-Aquitaine;24;3;16;460;Saint-Méard-de-Drône;498;6;504
75;Nouvelle-Aquitaine;24;1;11;461;Saint-Méard-de-Gurçon;815;11;826
75;Nouvelle-Aquitaine;24;3;24;462;Saint-Médard-de-Mussidan;1677;33;1710
75;Nouvelle-Aquitaine;24;2;06;463;Saint-Médard-d'Excideuil;542;15;557
75;Nouvelle-Aquitaine;24;2;06;464;Saint-Mesmin;326;6;332
75;Nouvelle-Aquitaine;24;3;24;465;Saint-Michel-de-Double;233;5;238
75;Nouvelle-Aquitaine;24;1;11;466;Saint-Michel-de-Montaigne;325;5;330
75;Nouvelle-Aquitaine;24;3;12;468;Saint-Michel-de-Villadeix;300;6;306
75;Nouvelle-Aquitaine;24;4;20;470;Sainte-Mondane;272;6;278
75;Nouvelle-Aquitaine;24;4;18;471;Sainte-Nathalène;629;12;641
75;Nouvelle-Aquitaine;24;1;02;472;Saint-Nexans;992;17;1009
75;Nouvelle-Aquitaine;24;4;05;473;Sainte-Orse;351;6;357
75;Nouvelle-Aquitaine;24;2;03;474;Saint-Pancrace;158;1;159
75;Nouvelle-Aquitaine;24;2;06;476;Saint-Pantaly-d'Excideuil;158;3;161
75;Nouvelle-Aquitaine;24;3;16;477;Saint-Pardoux-de-Drône;192;2;194
75;Nouvelle-Aquitaine;24;4;23;478;Saint-Pardoux-et-Vielvic;192;0;192
75;Nouvelle-Aquitaine;24;2;13;479;Saint-Pardoux-la-Rivière;1169;20;1189
75;Nouvelle-Aquitaine;24;3;12;480;Saint-Paul-de-Serre;313;3;316
75;Nouvelle-Aquitaine;24;2;21;481;Saint-Paul-la-Roche;514;0;514
75;Nouvelle-Aquitaine;24;3;16;482;Saint-Paul-Lizonne;277;2;279
75;Nouvelle-Aquitaine;24;1;19;483;Saint-Perdoux;142;7;149
75;Nouvelle-Aquitaine;24;3;07;484;Saint-Pierre-de-Chignac;889;16;905
75;Nouvelle-Aquitaine;24;2;21;485;Saint-Pierre-de-Côle;415;3;418
75;Nouvelle-Aquitaine;24;2;21;486;Saint-Pierre-de-Frugie;406;3;409
75;Nouvelle-Aquitaine;24;1;10;487;Saint-Pierre-d'Eyraud;1814;15;1829
75;Nouvelle-Aquitaine;24;4;23;488;Saint-Pompont;343;5;348
75;Nouvelle-Aquitaine;24;2;21;489;Saint-Priest-les-Fougères;375;7;382
75;Nouvelle-Aquitaine;24;3;09;490;Saint Privat en Périgord;1116;15;1131
75;Nouvelle-Aquitaine;24;4;05;491;Saint-Rabier;579;11;590
75;Nouvelle-Aquitaine;24;1;19;492;Sainte-Radegonde;66;2;68
75;Nouvelle-Aquitaine;24;2;06;493;Saint-Raphaël;93;2;95
75;Nouvelle-Aquitaine;24;1;11;494;Saint-Rémy;504;4;508
75;Nouvelle-Aquitaine;24;1;08;495;Saint-Romain-de-Monpazier;116;3;119
75;Nouvelle-Aquitaine;24;2;21;496;Saint-Romain-et-Saint-Clément;328;4;332
75;Nouvelle-Aquitaine;24;2;13;498;Saint-Saud-Lacoussière;825;20;845
75;Nouvelle-Aquitaine;24;1;02;499;Saint-Sauveur;862;21;883
75;Nouvelle-Aquitaine;24;3;09;500;Saint-Sauveur-Lalande;146;7;153
75;Nouvelle-Aquitaine;24;1;11;501;Saint-Seurin-de-Prats;483;5;488
75;Nouvelle-Aquitaine;24;3;24;502;Saint-Séverin-d'Estissac;89;0;89
75;Nouvelle-Aquitaine;24;3;16;504;Saint-Sulpice-de-Roumagnac;282;1;283
75;Nouvelle-Aquitaine;24;2;06;505;Saint-Sulpice-d'Excideuil;351;3;354
75;Nouvelle-Aquitaine;24;4;05;507;Sainte-Trie;110;2;112
75;Nouvelle-Aquitaine;24;3;03;508;Saint-Victor;213;5;218
75;Nouvelle-Aquitaine;24;3;16;509;Saint-Vincent-de-Connezac;667;12;679
75;Nouvelle-Aquitaine;24;4;18;510;Saint-Vincent-de-Cosse;369;10;379
75;Nouvelle-Aquitaine;24;3;09;511;Saint-Vincent-Jalmoutiers;256;3;259
75;Nouvelle-Aquitaine;24;4;18;512;Saint-Vincent-le-Paluel;293;11;304
75;Nouvelle-Aquitaine;24;2;06;513;Saint-Vincent-sur-l'Isle;313;3;316
75;Nouvelle-Aquitaine;24;1;11;514;Saint-Vivien;242;2;244
75;Nouvelle-Aquitaine;24;2;06;515;Salagnac;724;5;729
75;Nouvelle-Aquitaine;24;4;20;516;Salignac-Eyvigues;1189;54;1243
75;Nouvelle-Aquitaine;24;4;23;517;Salles-de-Belvès;73;2;75
75;Nouvelle-Aquitaine;24;3;12;518;Salon;286;4;290
75;Nouvelle-Aquitaine;24;2;06;519;Sarlande;431;5;436
75;Nouvelle-Aquitaine;24;4;18;520;Sarlat-la-Canéda;8788;404;9192
75;Nouvelle-Aquitaine;24;3;22;521;Sarliac-sur-l'Isle;1031;19;1050
75;Nouvelle-Aquitaine;24;2;06;522;Sarrazac;361;11;372
75;Nouvelle-Aquitaine;24;1;19;523;Saussignac;423;12;435
75;Nouvelle-Aquitaine;24;4;25;524;Savignac-de-Miremont;178;2;180
75;Nouvelle-Aquitaine;24;2;13;525;Savignac-de-Nontron;197;2;199
75;Nouvelle-Aquitaine;24;2;06;526;Savignac-Lédrier;714;9;723
75;Nouvelle-Aquitaine;24;3;06;527;Savignac-les-Églises;938;16;954
75;Nouvelle-Aquitaine;24;2;13;528;Sceau-Saint-Angel;127;2;129
75;Nouvelle-Aquitaine;24;3;03;529;Segonzac;200;2;202
75;Nouvelle-Aquitaine;24;4;25;531;Sergeac;212;3;215
75;Nouvelle-Aquitaine;24;1;19;532;Serres-et-Montguyard;250;3;253
75;Nouvelle-Aquitaine;24;3;09;533;Servanches;79;4;83
75;Nouvelle-Aquitaine;24;1;19;534;Sigoulès-et-Flaugeac;1192;238;1430
75;Nouvelle-Aquitaine;24;4;20;535;Simeyrols;252;3;255
75;Nouvelle-Aquitaine;24;1;19;536;Singleyrac;311;5;316
75;Nouvelle-Aquitaine;24;3;16;537;Siorac-de-Ribérac;250;4;254
75;Nouvelle-Aquitaine;24;4;23;538;Siorac-en-Périgord;1062;11;1073
75;Nouvelle-Aquitaine;24;3;21;540;Sorges et Ligueux en Périgord;1601;29;1630
75;Nouvelle-Aquitaine;24;2;13;541;Soudat;93;1;94
75;Nouvelle-Aquitaine;24;1;08;542;Soulaures;74;3;77
75;Nouvelle-Aquitaine;24;3;24;543;Sourzac;1111;17;1128
75;Nouvelle-Aquitaine;24;4;18;544;Tamniès;392;9;401
75;Nouvelle-Aquitaine;24;4;05;545;Teillots;98;1;99
75;Nouvelle-Aquitaine;24;4;05;546;Temple-Laguyon;36;0;36
75;Nouvelle-Aquitaine;24;4;20;547;Terrasson-Lavilledieu;6264;106;6370
75;Nouvelle-Aquitaine;24;2;13;548;Teyjat;275;4;279
75;Nouvelle-Aquitaine;24;1;19;549;Thénac;480;5;485
75;Nouvelle-Aquitaine;24;4;05;550;Thenon;1254;16;1270
75;Nouvelle-Aquitaine;24;2;21;551;Thiviers;2870;190;3060
75;Nouvelle-Aquitaine;24;4;25;552;Thonac;256;6;262
75;Nouvelle-Aquitaine;24;3;03;553;Tocane-Saint-Apre;1738;36;1774
75;Nouvelle-Aquitaine;24;3;16;554;La Tour-Blanche-Cercles;563;14;577
75;Nouvelle-Aquitaine;24;4;05;555;Tourtoirac;639;10;649
75;Nouvelle-Aquitaine;24;3;22;557;Trélissac;7191;199;7390
75;Nouvelle-Aquitaine;24;1;12;558;Trémolat;630;5;635
75;Nouvelle-Aquitaine;24;4;25;559;Tursac;332;10;342
75;Nouvelle-Aquitaine;24;1;08;560;Urval;114;7;121
75;Nouvelle-Aquitaine;24;3;24;562;Vallereuil;267;12;279
75;Nouvelle-Aquitaine;24;4;25;563;Valojoulx;281;7;288
75;Nouvelle-Aquitaine;24;3;16;564;Vanxains;690;106;796
75;Nouvelle-Aquitaine;24;2;13;565;Varaignes;368;8;376
75;Nouvelle-Aquitaine;24;1;08;566;Varennes;463;10;473
75;Nouvelle-Aquitaine;24;2;21;567;Vaunac;248;3;251
75;Nouvelle-Aquitaine;24;1;11;568;Vélines;1053;12;1065
75;Nouvelle-Aquitaine;24;3;16;569;Vendoire;129;1;130
75;Nouvelle-Aquitaine;24;1;08;570;Verdon;39;1;40
75;Nouvelle-Aquitaine;24;3;12;571;Vergt;1712;14;1726
75;Nouvelle-Aquitaine;24;1;08;572;Vergt-de-Biron;190;5;195
75;Nouvelle-Aquitaine;24;3;16;573;Verteillac;547;12;559
75;Nouvelle-Aquitaine;24;4;20;574;Veyrignac;337;11;348
75;Nouvelle-Aquitaine;24;4;23;575;Veyrines-de-Domme;232;22;254
75;Nouvelle-Aquitaine;24;3;12;576;Veyrines-de-Vergt;245;10;255
75;Nouvelle-Aquitaine;24;4;18;577;Vézac;516;10;526
75;Nouvelle-Aquitaine;24;4;05;580;Villac;264;1;265
75;Nouvelle-Aquitaine;24;3;12;581;Villamblard;908;19;927
75;Nouvelle-Aquitaine;24;2;03;582;Villars;456;10;466
75;Nouvelle-Aquitaine;24;1;11;584;Villefranche-de-Lonchat;963;19;982
75;Nouvelle-Aquitaine;24;4;23;585;Villefranche-du-Périgord;671;12;683
75;Nouvelle-Aquitaine;24;3;16;586;Villetoureix;912;19;931
75;Nouvelle-Aquitaine;24;4;18;587;Vitrac;826;20;846
27;Bourgogne-Franche-Comté;25;1;17;001;Abbans-Dessous;247;6;253
27;Bourgogne-Franche-Comté;25;1;17;002;Abbans-Dessus;298;5;303
27;Bourgogne-Franche-Comté;25;1;02;003;Abbenans;321;6;327
27;Bourgogne-Franche-Comté;25;2;12;004;Abbévillers;1068;20;1088
27;Bourgogne-Franche-Comté;25;2;03;005;Accolans;89;1;90
27;Bourgogne-Franche-Comté;25;1;02;006;Adam-lès-Passavant;88;5;93
27;Bourgogne-Franche-Comté;25;3;18;007;Adam-lès-Vercel;108;3;111
27;Bourgogne-Franche-Comté;25;2;03;008;Aibre;465;4;469
27;Bourgogne-Franche-Comté;25;1;02;009;Aïssey;163;3;166
27;Bourgogne-Franche-Comté;25;2;10;011;Allenjoie;741;16;757
27;Bourgogne-Franche-Comté;25;3;15;012;Les Alliés;170;5;175
27;Bourgogne-Franche-Comté;25;2;03;013;Allondans;253;7;260
27;Bourgogne-Franche-Comté;25;1;08;014;Amagney;936;11;947
27;Bourgogne-Franche-Comté;25;1;15;015;Amancey;706;20;726
27;Bourgogne-Franche-Comté;25;1;15;016;Amathay-Vésigneux;167;3;170
27;Bourgogne-Franche-Comté;25;1;15;017;Amondans;90;3;93
27;Bourgogne-Franche-Comté;25;2;03;018;Anteuil;613;21;634
27;Bourgogne-Franche-Comté;25;2;03;019;Appenans;384;11;395
27;Bourgogne-Franche-Comté;25;2;01;020;Arbouans;902;9;911
27;Bourgogne-Franche-Comté;25;1;17;021;Arc-et-Senans;1614;29;1643
27;Bourgogne-Franche-Comté;25;2;03;022;Arcey;1481;39;1520
27;Bourgogne-Franche-Comté;25;3;15;024;Arçon;930;31;961
27;Bourgogne-Franche-Comté;25;3;15;025;Arc-sous-Cicon;717;13;730
27;Bourgogne-Franche-Comté;25;3;11;026;Arc-sous-Montenot;224;5;229
27;Bourgogne-Franche-Comté;25;3;15;029;Aubonne;248;3;251
27;Bourgogne-Franche-Comté;25;1;05;030;Audeux;427;10;437
27;Bourgogne-Franche-Comté;25;2;01;031;Audincourt;13542;221;13763
27;Bourgogne-Franche-Comté;25;1;02;032;Autechaux;427;10;437
27;Bourgogne-Franche-Comté;25;2;12;033;Autechaux-Roide;516;10;526
27;Bourgogne-Franche-Comté;25;1;06;035;Les Auxons;2512;46;2558
27;Bourgogne-Franche-Comté;25;1;04;036;Avanne-Aveney;2232;29;2261
27;Bourgogne-Franche-Comté;25;1;02;038;Avilley;160;4;164
27;Bourgogne-Franche-Comté;25;3;18;039;Avoudrey;927;19;946
27;Bourgogne-Franche-Comté;25;2;01;040;Badevel;807;14;821
27;Bourgogne-Franche-Comté;25;3;11;041;Bannans;370;9;379
27;Bourgogne-Franche-Comté;25;3;14;042;Le Barboux;226;8;234
27;Bourgogne-Franche-Comté;25;2;13;043;Bart;2006;53;2059
27;Bourgogne-Franche-Comté;25;1;17;044;Bartherans;59;0;59
27;Bourgogne-Franche-Comté;25;1;02;045;Battenans-les-Mines;47;1;48
27;Bourgogne-Franche-Comté;25;2;18;046;Battenans-Varin;75;4;79
27;Bourgogne-Franche-Comté;25;1;02;047;Baume-les-Dames;4984;160;5144
27;Bourgogne-Franche-Comté;25;2;03;048;Bavans;3604;74;3678
27;Bourgogne-Franche-Comté;25;2;12;049;Belfays;136;5;141
27;Bourgogne-Franche-Comté;25;3;14;050;Le Bélieu;504;12;516
27;Bourgogne-Franche-Comté;25;2;18;051;Belleherbe;622;13;635
27;Bourgogne-Franche-Comté;25;3;18;052;Belmont;66;0;66
27;Bourgogne-Franche-Comté;25;2;03;053;Belvoir;93;7;100
27;Bourgogne-Franche-Comté;25;2;03;054;Berche;540;13;553
27;Bourgogne-Franche-Comté;25;1;17;055;Berthelange;356;7;363
27;Bourgogne-Franche-Comté;25;1;99;056;Besançon;118258;3261;121519
27;Bourgogne-Franche-Comté;25;2;10;057;Bethoncourt;5336;68;5404
27;Bourgogne-Franche-Comté;25;1;09;058;Beure;1361;13;1374
27;Bourgogne-Franche-Comté;25;2;03;059;Beutal;268;5;273
27;Bourgogne-Franche-Comté;25;3;15;060;Bians-les-Usiers;699;24;723
27;Bourgogne-Franche-Comté;25;2;12;061;Bief;116;1;117
27;Bourgogne-Franche-Comté;25;3;14;062;Le Bizot;297;11;308
27;Bourgogne-Franche-Comté;25;2;12;063;Blamont;1210;26;1236
27;Bourgogne-Franche-Comté;25;1;02;065;Blarians;54;4;58
27;Bourgogne-Franche-Comté;25;2;03;066;Blussangeaux;85;1;86
27;Bourgogne-Franche-Comté;25;2;03;067;Blussans;190;3;193
27;Bourgogne-Franche-Comté;25;1;15;070;Bolandoz;377;15;392
27;Bourgogne-Franche-Comté;25;2;12;071;Bondeval;477;4;481
27;Bourgogne-Franche-Comté;25;1;02;072;Bonnal;20;1;21
27;Bourgogne-Franche-Comté;25;1;02;073;Bonnay;830;6;836
27;Bourgogne-Franche-Comté;25;3;14;074;Bonnétage;984;21;1005
27;Bourgogne-Franche-Comté;25;3;11;075;Bonnevaux;405;10;415
27;Bourgogne-Franche-Comté;25;3;14;077;La Bosse;75;0;75
27;Bourgogne-Franche-Comté;25;1;02;078;Bouclans;1064;25;1089
27;Bourgogne-Franche-Comté;25;3;11;079;Boujailles;445;7;452
27;Bourgogne-Franche-Comté;25;2;19;082;Bourguignon;888;23;911
27;Bourgogne-Franche-Comté;25;2;03;083;Bournois;190;2;192
27;Bourgogne-Franche-Comté;25;1;09;084;Boussières;1169;19;1188
27;Bourgogne-Franche-Comté;25;3;11;085;Bouverans;400;8;408
27;Bourgogne-Franche-Comté;25;1;07;086;Braillans;208;2;210
27;Bourgogne-Franche-Comté;25;2;03;087;Branne;179;3;182
27;Bourgogne-Franche-Comté;25;1;02;088;Breconchaux;87;6;93
27;Bourgogne-Franche-Comté;25;3;18;089;Bremondans;98;2;100
27;Bourgogne-Franche-Comté;25;1;17;090;Brères;69;0;69
27;Bourgogne-Franche-Comté;25;2;12;091;Les Bréseux;476;8;484
27;Bourgogne-Franche-Comté;25;1;02;092;La Bretenière;70;2;72
27;Bourgogne-Franche-Comté;25;2;03;093;Bretigney;76;0;76
27;Bourgogne-Franche-Comté;25;1;02;094;Bretigney-Notre-Dame;119;0;119
27;Bourgogne-Franche-Comté;25;3;18;095;Bretonvillers;284;3;287
27;Bourgogne-Franche-Comté;25;3;11;096;Brey-et-Maison-du-Bois;163;2;165
27;Bourgogne-Franche-Comté;25;2;10;097;Brognard;478;12;490
27;Bourgogne-Franche-Comté;25;1;17;098;Buffard;188;3;191
27;Bourgogne-Franche-Comté;25;3;15;099;Bugny;241;7;248
27;Bourgogne-Franche-Comté;25;3;11;100;Bulle;477;9;486
27;Bourgogne-Franche-Comté;25;1;17;101;Burgille;574;13;587
27;Bourgogne-Franche-Comté;25;2;12;102;Burnevillers;49;2;51
27;Bourgogne-Franche-Comté;25;1;09;103;Busy;649;4;653
27;Bourgogne-Franche-Comté;25;1;17;104;By;84;1;85
27;Bourgogne-Franche-Comté;25;1;17;105;Byans-sur-Doubs;608;6;614
27;Bourgogne-Franche-Comté;25;1;15;106;Cademène;68;0;68
27;Bourgogne-Franche-Comté;25;1;02;107;Cendrey;195;1;196
27;Bourgogne-Franche-Comté;25;2;12;108;Cernay-l'Église;312;8;320
27;Bourgogne-Franche-Comté;25;1;17;109;Cessey;325;10;335
27;Bourgogne-Franche-Comté;25;3;16;110;Chaffois;1031;19;1050
27;Bourgogne-Franche-Comté;25;1;07;111;Chalèze;364;13;377
27;Bourgogne-Franche-Comté;25;1;07;112;Chalezeule;1323;26;1349
27;Bourgogne-Franche-Comté;25;3;18;113;Chamesey;141;5;146
27;Bourgogne-Franche-Comté;25;2;12;114;Chamesol;390;6;396
27;Bourgogne-Franche-Comté;25;1;05;115;Champagney;277;4;281
27;Bourgogne-Franche-Comté;25;1;02;116;Champlive;245;7;252
27;Bourgogne-Franche-Comté;25;1;07;117;Champoux;89;0;89
27;Bourgogne-Franche-Comté;25;1;05;119;Champvans-les-Moulins;321;10;331
27;Bourgogne-Franche-Comté;25;1;15;120;Chantrans;394;10;404
27;Bourgogne-Franche-Comté;25;3;11;121;Chapelle-des-Bois;256;15;271
27;Bourgogne-Franche-Comté;25;3;11;122;Chapelle-d'Huin;528;12;540
27;Bourgogne-Franche-Comté;25;2;12;124;Charmauvillers;278;7;285
27;Bourgogne-Franche-Comté;25;2;18;125;Charmoille;323;5;328
27;Bourgogne-Franche-Comté;25;1;17;126;Charnay;478;8;486
27;Bourgogne-Franche-Comté;25;2;12;127;Charquemont;2791;49;2840
27;Bourgogne-Franche-Comté;25;1;15;129;Chassagne-Saint-Denis;111;3;114
27;Bourgogne-Franche-Comté;25;1;15;130;Châteauvieux-les-Fossés;10;0;10
27;Bourgogne-Franche-Comté;25;3;11;131;Châtelblanc;110;5;115
27;Bourgogne-Franche-Comté;25;1;02;132;Châtillon-Guyotte;142;4;146
27;Bourgogne-Franche-Comté;25;1;06;133;Châtillon-le-Duc;2007;55;2062
27;Bourgogne-Franche-Comté;25;1;05;136;Chaucenne;499;13;512
27;Bourgogne-Franche-Comté;25;2;12;138;Les Terres-de-Chaux;125;5;130
27;Bourgogne-Franche-Comté;25;3;15;139;La Chaux;606;10;616
27;Bourgogne-Franche-Comté;25;3;18;141;Chaux-lès-Passavant;122;6;128
27;Bourgogne-Franche-Comté;25;3;11;142;Chaux-Neuve;329;3;332
27;Bourgogne-Franche-Comté;25;1;17;143;Chay;204;10;214
27;Bourgogne-Franche-Comté;25;2;03;145;Chazot;118;1;119
27;Bourgogne-Franche-Comté;25;1;04;147;Chemaudin et Vaux;2067;40;2107
27;Bourgogne-Franche-Comté;25;3;14;148;La Chenalotte;497;5;502
27;Bourgogne-Franche-Comté;25;1;17;149;Chenecey-Buillon;505;11;516
27;Bourgogne-Franche-Comté;25;1;17;150;Chevigney-sur-l'Ognon;290;3;293
27;Bourgogne-Franche-Comté;25;3;18;151;Chevigney-lès-Vercel;135;4;139
27;Bourgogne-Franche-Comté;25;1;08;152;La Chevillotte;160;0;160
27;Bourgogne-Franche-Comté;25;1;02;153;Chevroz;133;1;134
27;Bourgogne-Franche-Comté;25;1;17;154;Chouzelot;265;10;275
27;Bourgogne-Franche-Comté;25;1;15;155;Cléron;296;13;309
27;Bourgogne-Franche-Comté;25;2;03;156;Pays-de-Clerval;1139;21;1160
27;Bourgogne-Franche-Comté;25;3;16;157;La Cluse-et-Mijoux;1331;29;1360
27;Bourgogne-Franche-Comté;25;2;03;159;Colombier-Fontaine;1205;23;1228
27;Bourgogne-Franche-Comté;25;3;14;160;Les Combes;752;26;778
27;Bourgogne-Franche-Comté;25;3;18;161;Consolation-Maisonnettes;28;4;32
27;Bourgogne-Franche-Comté;25;1;17;162;Corcelles-Ferrières;212;6;218
27;Bourgogne-Franche-Comté;25;1;02;163;Corcelle-Mieslot;105;1;106
27;Bourgogne-Franche-Comté;25;1;17;164;Corcondray;145;0;145
27;Bourgogne-Franche-Comté;25;1;02;166;Côtebrune;84;6;90
27;Bourgogne-Franche-Comté;25;2;13;170;Courcelles-lès-Montbéliard;1388;42;1430
27;Bourgogne-Franche-Comté;25;1;17;171;Courcelles;105;2;107
27;Bourgogne-Franche-Comté;25;1;17;172;Courchapon;233;3;236
27;Bourgogne-Franche-Comté;25;2;18;173;Cour-Saint-Maurice;148;4;152
27;Bourgogne-Franche-Comté;25;2;12;174;Courtefontaine;243;3;246
27;Bourgogne-Franche-Comté;25;3;18;175;Courtetain-et-Salans;91;1;92
27;Bourgogne-Franche-Comté;25;3;11;176;Courvières;319;5;324
27;Bourgogne-Franche-Comté;25;2;03;177;Crosey-le-Grand;148;5;153
27;Bourgogne-Franche-Comté;25;2;03;178;Crosey-le-Petit;123;3;126
27;Bourgogne-Franche-Comté;25;3;11;179;Le Crouzet;61;2;63
27;Bourgogne-Franche-Comté;25;1;15;180;Crouzet-Migette;116;6;122
27;Bourgogne-Franche-Comté;25;1;02;181;Cubrial;151;6;157
27;Bourgogne-Franche-Comté;25;1;02;182;Cubry;96;1;97
27;Bourgogne-Franche-Comté;25;1;02;183;Cusance;76;2;78
27;Bourgogne-Franche-Comté;25;1;02;184;Cuse-et-Adrisans;287;12;299
27;Bourgogne-Franche-Comté;25;1;17;185;Cussey-sur-Lison;68;3;71
27;Bourgogne-Franche-Comté;25;1;02;186;Cussey-sur-l'Ognon;1044;24;1068
27;Bourgogne-Franche-Comté;25;2;19;187;Dambelin;502;6;508
27;Bourgogne-Franche-Comté;25;2;10;188;Dambenois;748;25;773
27;Bourgogne-Franche-Comté;25;1;02;189;Dammartin-les-Templiers;184;6;190
27;Bourgogne-Franche-Comté;25;2;01;190;Dampierre-les-Bois;1584;25;1609
27;Bourgogne-Franche-Comté;25;2;03;191;Dampierre-sur-le-Doubs;450;10;460
27;Bourgogne-Franche-Comté;25;2;12;192;Dampjoux;169;4;173
27;Bourgogne-Franche-Comté;25;2;12;193;Damprichard;1832;45;1877
27;Bourgogne-Franche-Comté;25;2;12;194;Dannemarie;114;0;114
27;Bourgogne-Franche-Comté;25;1;04;195;Dannemarie-sur-Crète;1543;290;1833
27;Bourgogne-Franche-Comté;25;2;01;196;Dasle;1380;26;1406
27;Bourgogne-Franche-Comté;25;1;08;197;Deluz;620;10;630
27;Bourgogne-Franche-Comté;25;2;03;198;Désandans;723;21;744
27;Bourgogne-Franche-Comté;25;1;15;199;Déservillers;342;7;349
27;Bourgogne-Franche-Comté;25;1;02;200;Devecey;1343;36;1379
27;Bourgogne-Franche-Comté;25;3;16;201;Dommartin;766;15;781
27;Bourgogne-Franche-Comté;25;3;11;202;Dompierre-les-Tilleuls;307;7;314
27;Bourgogne-Franche-Comté;25;3;18;203;Domprel;184;2;186
27;Bourgogne-Franche-Comté;25;3;16;204;Doubs;3235;74;3309
27;Bourgogne-Franche-Comté;25;2;03;207;Dung;620;17;637
27;Bourgogne-Franche-Comté;25;1;15;208;Durnes;184;9;193
27;Bourgogne-Franche-Comté;25;1;17;209;Échay;125;4;129
27;Bourgogne-Franche-Comté;25;2;03;210;Échenans;161;4;165
27;Bourgogne-Franche-Comté;25;1;15;211;Échevannes;87;1;88
27;Bourgogne-Franche-Comté;25;1;05;212;École-Valentin;2703;51;2754
27;Bourgogne-Franche-Comté;25;2;12;213;Les Écorces;745;23;768
27;Bourgogne-Franche-Comté;25;2;19;214;Écot;489;10;499
27;Bourgogne-Franche-Comté;25;1;02;215;L'Écouvotte;88;0;88
27;Bourgogne-Franche-Comté;25;2;12;216;Écurcey;263;10;273
27;Bourgogne-Franche-Comté;25;1;17;217;Émagny;603;10;613
27;Bourgogne-Franche-Comté;25;3;18;218;Épenouse;165;7;172
27;Bourgogne-Franche-Comté;25;3;18;219;Épenoy;637;14;651
27;Bourgogne-Franche-Comté;25;1;17;220;Épeugney;593;15;608
27;Bourgogne-Franche-Comté;25;1;02;221;Esnans;64;0;64
27;Bourgogne-Franche-Comté;25;3;18;222;Étalans;1607;37;1644
27;Bourgogne-Franche-Comté;25;1;15;223;Éternoz;322;9;331
27;Bourgogne-Franche-Comté;25;2;03;224;Étouvans;831;13;844
27;Bourgogne-Franche-Comté;25;1;17;225;Étrabonne;187;1;188
27;Bourgogne-Franche-Comté;25;2;03;226;Étrappe;213;5;218
27;Bourgogne-Franche-Comté;25;3;18;227;Étray;285;0;285
27;Bourgogne-Franche-Comté;25;2;10;228;Étupes;3721;63;3784
27;Bourgogne-Franche-Comté;25;3;15;229;Évillers;392;4;396
27;Bourgogne-Franche-Comté;25;2;10;230;Exincourt;3245;54;3299
27;Bourgogne-Franche-Comté;25;3;18;231;Eysson;120;2;122
27;Bourgogne-Franche-Comté;25;2;03;232;Faimbe;99;2;101
27;Bourgogne-Franche-Comté;25;3;18;233;Fallerans;286;10;296
27;Bourgogne-Franche-Comté;25;2;12;234;Ferrières-le-Lac;174;7;181
27;Bourgogne-Franche-Comté;25;1;17;235;Ferrières-les-Bois;320;7;327
27;Bourgogne-Franche-Comté;25;1;15;236;Fertans;304;3;307
27;Bourgogne-Franche-Comté;25;2;10;237;Fesches-le-Châtel;2163;34;2197
27;Bourgogne-Franche-Comté;25;2;12;238;Fessevillers;157;2;159
27;Bourgogne-Franche-Comté;25;2;19;239;Feule;181;2;183
27;Bourgogne-Franche-Comté;25;3;14;240;Les Fins;3157;125;3282
27;Bourgogne-Franche-Comté;25;1;15;241;Flagey;140;6;146
27;Bourgogne-Franche-Comté;25;1;02;242;Flagey-Rigney;122;0;122
27;Bourgogne-Franche-Comté;25;3;18;243;Flangebouche;807;19;826
27;Bourgogne-Franche-Comté;25;2;12;244;Fleurey;84;3;87
27;Bourgogne-Franche-Comté;25;1;08;245;Fontain;1226;22;1248
27;Bourgogne-Franche-Comté;25;2;03;246;Fontaine-lès-Clerval;270;10;280
27;Bourgogne-Franche-Comté;25;1;02;247;Fontenelle-Montby;84;3;87
27;Bourgogne-Franche-Comté;25;3;14;248;Les Fontenelles;527;112;639
27;Bourgogne-Franche-Comté;25;1;02;249;Fontenotte;62;2;64
27;Bourgogne-Franche-Comté;25;1;02;251;Fourbanne;174;8;182
27;Bourgogne-Franche-Comté;25;3;11;252;Fourcatier-et-Maison-Neuve;117;0;117
27;Bourgogne-Franche-Comté;25;1;17;253;Fourg;386;2;388
27;Bourgogne-Franche-Comté;25;3;11;254;Les Fourgs;1400;32;1432
27;Bourgogne-Franche-Comté;25;2;12;255;Fournet-Blancheroche;349;13;362
27;Bourgogne-Franche-Comté;25;2;12;256;Frambouhans;900;14;914
27;Bourgogne-Franche-Comté;25;1;17;257;Franey;268;5;273
27;Bourgogne-Franche-Comté;25;1;04;258;Franois;2272;39;2311
27;Bourgogne-Franche-Comté;25;3;11;259;Frasne;1933;37;1970
27;Bourgogne-Franche-Comté;25;2;12;261;Froidevaux;80;0;80
27;Bourgogne-Franche-Comté;25;3;18;262;Fuans;467;24;491
27;Bourgogne-Franche-Comté;25;3;11;263;Gellin;254;2;256
27;Bourgogne-Franche-Comté;25;2;03;264;Gémonval;83;2;85
27;Bourgogne-Franche-Comté;25;1;02;265;Geneuille;1299;29;1328
27;Bourgogne-Franche-Comté;25;2;03;266;Geney;119;4;123
27;Bourgogne-Franche-Comté;25;1;08;267;Gennes;682;19;701
27;Bourgogne-Franche-Comté;25;3;18;268;Germéfontaine;114;2;116
27;Bourgogne-Franche-Comté;25;1;02;269;Germondans;62;1;63
27;Bourgogne-Franche-Comté;25;1;15;270;Gevresin;131;0;131
27;Bourgogne-Franche-Comté;25;3;15;271;Gilley;1730;38;1768
27;Bourgogne-Franche-Comté;25;1;02;273;Glamondans;202;4;206
27;Bourgogne-Franche-Comté;25;2;12;274;Glay;340;2;342
27;Bourgogne-Franche-Comté;25;2;12;275;Glère;189;4;193
27;Bourgogne-Franche-Comté;25;1;02;276;Gondenans-Montby;168;2;170
27;Bourgogne-Franche-Comté;25;1;02;277;Gondenans-les-Moulins;76;2;78
27;Bourgogne-Franche-Comté;25;1;02;278;Gonsans;566;13;579
27;Bourgogne-Franche-Comté;25;1;02;279;Gouhelans;119;1;120
27;Bourgogne-Franche-Comté;25;2;12;280;Goumois;154;4;158
27;Bourgogne-Franche-Comté;25;2;19;281;Goux-lès-Dambelin;278;4;282
27;Bourgogne-Franche-Comté;25;3;15;282;Goux-les-Usiers;781;13;794
27;Bourgogne-Franche-Comté;25;1;17;283;Goux-sous-Landet;62;1;63
27;Bourgogne-Franche-Comté;25;2;10;284;Grand-Charmont;5849;73;5922
27;Bourgogne-Franche-Comté;25;3;14;285;Grand'Combe-Châteleu;1499;26;1525
27;Bourgogne-Franche-Comté;25;3;14;286;Grand'Combe-des-Bois;123;5;128
27;Bourgogne-Franche-Comté;25;1;04;287;Grandfontaine;1784;42;1826
27;Bourgogne-Franche-Comté;25;3;18;288;Fournets-Luisans;734;19;753
27;Bourgogne-Franche-Comté;25;3;18;289;Grandfontaine-sur-Creuse;74;3;77
27;Bourgogne-Franche-Comté;25;2;18;290;La Grange;96;2;98
27;Bourgogne-Franche-Comté;25;3;16;293;Granges-Narboz;1288;51;1339
27;Bourgogne-Franche-Comté;25;3;11;295;Les Grangettes;308;5;313
27;Bourgogne-Franche-Comté;25;3;14;296;Les Gras;789;28;817
27;Bourgogne-Franche-Comté;25;1;08;297;Le Gratteris;160;3;163
27;Bourgogne-Franche-Comté;25;1;02;298;Grosbois;244;8;252
27;Bourgogne-Franche-Comté;25;1;02;299;Guillon-les-Bains;111;1;112
27;Bourgogne-Franche-Comté;25;1;18;300;Guyans-Durnes;304;6;310
27;Bourgogne-Franche-Comté;25;3;18;301;Guyans-Vennes;867;26;893
27;Bourgogne-Franche-Comté;25;3;15;303;Hauterive-la-Fresse;223;6;229
27;Bourgogne-Franche-Comté;25;2;01;304;Hérimoncourt;3619;53;3672
27;Bourgogne-Franche-Comté;25;1;15;305;L'Hôpital-du-Grosbois;590;16;606
27;Bourgogne-Franche-Comté;25;2;03;306;L'Hôpital-Saint-Lieffroy;123;2;125
27;Bourgogne-Franche-Comté;25;3;11;307;Les Hôpitaux-Neufs;907;11;918
27;Bourgogne-Franche-Comté;25;3;11;308;Les Hôpitaux-Vieux;464;6;470
27;Bourgogne-Franche-Comté;25;3;16;309;Houtaud;1159;37;1196
27;Bourgogne-Franche-Comté;25;1;02;310;Huanne-Montmartin;100;1;101
27;Bourgogne-Franche-Comté;25;2;03;311;Hyémondans;210;4;214
27;Bourgogne-Franche-Comté;25;1;02;312;Hyèvre-Magny;66;1;67
27;Bourgogne-Franche-Comté;25;1;02;313;Hyèvre-Paroisse;197;3;200
27;Bourgogne-Franche-Comté;25;2;12;314;Indevillers;272;2;274
27;Bourgogne-Franche-Comté;25;2;03;315;L'Isle-sur-le-Doubs;2849;71;2920
27;Bourgogne-Franche-Comté;25;2;03;316;Issans;237;5;242
27;Bourgogne-Franche-Comté;25;1;17;317;Jallerange;267;4;271
27;Bourgogne-Franche-Comté;25;3;11;318;Jougne;1850;32;1882
27;Bourgogne-Franche-Comté;25;3;11;320;Labergement-Sainte-Marie;1218;35;1253
27;Bourgogne-Franche-Comté;25;3;14;321;Villers-le-Lac;5207;100;5307
27;Bourgogne-Franche-Comté;25;2;03;322;Laire;409;10;419
27;Bourgogne-Franche-Comté;25;1;02;323;Laissey;448;6;454
27;Bourgogne-Franche-Comté;25;1;03;324;Lanans;159;8;167
27;Bourgogne-Franche-Comté;25;3;18;325;Landresse;232;8;240
27;Bourgogne-Franche-Comté;25;1;17;326;Lantenne-Vertière;534;14;548
27;Bourgogne-Franche-Comté;25;2;03;327;Lanthenans;70;0;70
27;Bourgogne-Franche-Comté;25;1;09;328;Larnod;796;11;807
27;Bourgogne-Franche-Comté;25;3;14;329;Laval-le-Prieuré;35;1;36
27;Bourgogne-Franche-Comté;25;1;17;330;Lavans-Quingey;179;4;183
27;Bourgogne-Franche-Comté;25;1;15;331;Lavans-Vuillafans;251;5;256
27;Bourgogne-Franche-Comté;25;1;17;332;Lavernay;569;10;579
27;Bourgogne-Franche-Comté;25;3;18;333;Laviron;347;15;362
27;Bourgogne-Franche-Comté;25;3;11;334;Levier;2269;242;2511
27;Bourgogne-Franche-Comté;25;2;12;335;Liebvillers;150;5;155
27;Bourgogne-Franche-Comté;25;1;17;336;Liesle;548;5;553
27;Bourgogne-Franche-Comté;25;1;15;338;Lizine;99;1;100
27;Bourgogne-Franche-Comté;25;1;15;339;Lods;224;2;226
27;Bourgogne-Franche-Comté;25;1;17;340;Lombard;191;5;196
27;Bourgogne-Franche-Comté;25;1;02;341;Lomont-sur-Crête;173;6;179
27;Bourgogne-Franche-Comté;25;3;18;342;Longechaux;78;3;81
27;Bourgogne-Franche-Comté;25;3;18;343;Longemaison;164;6;170
27;Bourgogne-Franche-Comté;25;3;18;344;Longevelle-lès-Russey;45;0;45
27;Bourgogne-Franche-Comté;25;2;03;345;Longevelle-sur-Doubs;665;14;679
27;Bourgogne-Franche-Comté;25;1;15;346;Longeville;183;2;185
27;Bourgogne-Franche-Comté;25;3;15;347;La Longeville;829;15;844
27;Bourgogne-Franche-Comté;25;3;11;348;Longevilles-Mont-d'Or;611;9;620
27;Bourgogne-Franche-Comté;25;3;18;349;Loray;584;15;599
27;Bourgogne-Franche-Comté;25;2;03;350;Lougres;730;22;752
27;Bourgogne-Franche-Comté;25;3;14;351;Le Luhier;239;1;240
27;Bourgogne-Franche-Comté;25;1;02;354;Luxiol;158;2;160
27;Bourgogne-Franche-Comté;25;3;18;355;Magny-Châtelard;63;0;63
27;Bourgogne-Franche-Comté;25;2;12;356;Maîche;4259;103;4362
27;Bourgogne-Franche-Comté;25;3;15;357;Maisons-du-Bois-Lièvremont;853;8;861
27;Bourgogne-Franche-Comté;25;1;15;359;Malans;158;5;163
27;Bourgogne-Franche-Comté;25;1;15;360;Malbrans;174;4;178
27;Bourgogne-Franche-Comté;25;3;11;361;Malbuisson;851;26;877
27;Bourgogne-Franche-Comté;25;3;11;362;Malpas;286;12;298
27;Bourgogne-Franche-Comté;25;1;08;364;Mamirolle;1806;19;1825
27;Bourgogne-Franche-Comté;25;2;03;365;Mancenans;310;6;316
27;Bourgogne-Franche-Comté;25;2;12;366;Mancenans-Lizerne;191;6;197
27;Bourgogne-Franche-Comté;25;2;19;367;Mandeure;4795;150;4945
27;Bourgogne-Franche-Comté;25;1;07;368;Marchaux-Chaudefontaine;1462;20;1482
27;Bourgogne-Franche-Comté;25;2;03;369;Marvelise;158;2;160
27;Bourgogne-Franche-Comté;25;2;19;370;Mathay;2152;37;2189
27;Bourgogne-Franche-Comté;25;1;05;371;Mazerolles-le-Salin;216;7;223
27;Bourgogne-Franche-Comté;25;2;03;372;Médière;277;6;283
27;Bourgogne-Franche-Comté;25;3;14;373;Le Mémont;46;1;47
27;Bourgogne-Franche-Comté;25;1;17;374;Mercey-le-Grand;553;17;570
27;Bourgogne-Franche-Comté;25;1;15;375;Les Monts-Ronds;661;13;674
27;Bourgogne-Franche-Comté;25;1;02;376;Mérey-Vieilley;158;5;163
27;Bourgogne-Franche-Comté;25;1;02;377;Mésandans;232;6;238
27;Bourgogne-Franche-Comté;25;2;12;378;Meslières;342;8;350
27;Bourgogne-Franche-Comté;25;1;17;379;Mesmay;71;5;76
27;Bourgogne-Franche-Comté;25;3;11;380;Métabief;1411;38;1449
27;Bourgogne-Franche-Comté;25;1;06;381;Miserey-Salines;2658;37;2695
27;Bourgogne-Franche-Comté;25;1;02;382;Moncey;612;5;617
27;Bourgogne-Franche-Comté;25;1;17;383;Moncley;272;7;279
27;Bourgogne-Franche-Comté;25;1;02;384;Mondon;91;5;96
27;Bourgogne-Franche-Comté;25;1;02;385;Montagney-Servigney;126;3;129
27;Bourgogne-Franche-Comté;25;2;12;386;Montancy;122;4;126
27;Bourgogne-Franche-Comté;25;2;12;387;Montandon;375;9;384
27;Bourgogne-Franche-Comté;25;2;13;388;Montbéliard;25726;543;26269
27;Bourgogne-Franche-Comté;25;3;14;389;Montbéliardot;113;4;117
27;Bourgogne-Franche-Comté;25;3;15;390;Montbenoît;398;12;410
27;Bourgogne-Franche-Comté;25;3;14;391;Mont-de-Laval;185;6;191
27;Bourgogne-Franche-Comté;25;2;12;392;Mont-de-Vougney;198;5;203
27;Bourgogne-Franche-Comté;25;2;12;393;Montécheroux;546;7;553
27;Bourgogne-Franche-Comté;25;2;03;394;Montenois;1459;43;1502
27;Bourgogne-Franche-Comté;25;1;08;395;Montfaucon;1576;50;1626
27;Bourgogne-Franche-Comté;25;1;09;397;Montferrand-le-Château;2190;44;2234
27;Bourgogne-Franche-Comté;25;3;15;398;Montflovin;118;4;122
27;Bourgogne-Franche-Comté;25;1;15;400;Montgesoye;479;6;485
27;Bourgogne-Franche-Comté;25;1;02;401;Montivernage;27;0;27
27;Bourgogne-Franche-Comté;25;2;12;402;Montjoie-le-Château;24;1;25
27;Bourgogne-Franche-Comté;25;3;14;403;Montlebon;2190;73;2263
27;Bourgogne-Franche-Comté;25;1;15;404;Montmahoux;91;4;95
27;Bourgogne-Franche-Comté;25;3;11;405;Montperreux;929;41;970
27;Bourgogne-Franche-Comté;25;1;17;406;Montrond-le-Château;568;14;582
27;Bourgogne-Franche-Comté;25;1;02;408;Montussaint;55;1;56
27;Bourgogne-Franche-Comté;25;1;08;410;Morre;1327;62;1389
27;Bourgogne-Franche-Comté;25;3;14;411;Morteau;6851;336;7187
27;Bourgogne-Franche-Comté;25;3;11;413;Mouthe;1022;35;1057
27;Bourgogne-Franche-Comté;25;1;17;414;Le Moutherot;126;2;128
27;Bourgogne-Franche-Comté;25;1;15;415;Mouthier-Haute-Pierre;344;5;349
27;Bourgogne-Franche-Comté;25;1;17;416;Myon;182;4;186
27;Bourgogne-Franche-Comté;25;1;02;417;Naisey-les-Granges;806;21;827
27;Bourgogne-Franche-Comté;25;1;08;418;Nancray;1272;32;1304
27;Bourgogne-Franche-Comté;25;1;02;419;Nans;93;4;97
27;Bourgogne-Franche-Comté;25;1;15;420;Nans-sous-Sainte-Anne;167;4;171
27;Bourgogne-Franche-Comté;25;3;14;421;Narbief;81;0;81
27;Bourgogne-Franche-Comté;25;2;19;422;Neuchâtel-Urtière;170;4;174
27;Bourgogne-Franche-Comté;25;3;18;424;Les Premiers Sapins;1548;30;1578
27;Bourgogne-Franche-Comté;25;3;14;425;Noël-Cerneux;458;17;475
27;Bourgogne-Franche-Comté;25;2;19;426;Noirefontaine;331;6;337
27;Bourgogne-Franche-Comté;25;1;05;427;Noironte;397;5;402
27;Bourgogne-Franche-Comté;25;2;10;428;Nommay;1611;38;1649
27;Bourgogne-Franche-Comté;25;1;08;429;Novillars;1446;33;1479
27;Bourgogne-Franche-Comté;25;1;02;430;Ollans;38;0;38
27;Bourgogne-Franche-Comté;25;2;03;431;Onans;348;7;355
27;Bourgogne-Franche-Comté;25;3;18;432;Orchamps-Vennes;2161;57;2218
27;Bourgogne-Franche-Comté;25;2;12;433;Orgeans-Blanchefontaine;39;1;40
27;Bourgogne-Franche-Comté;25;1;15;434;Ornans;4422;106;4528
27;Bourgogne-Franche-Comté;25;3;18;435;Orsans;168;3;171
27;Bourgogne-Franche-Comté;25;2;03;436;Orve;57;2;59
27;Bourgogne-Franche-Comté;25;1;02;437;Osse;349;3;352
27;Bourgogne-Franche-Comté;25;1;09;438;Osselle-Routelle;959;15;974
27;Bourgogne-Franche-Comté;25;1;02;439;Ougney-Douvot;254;2;256
27;Bourgogne-Franche-Comté;25;3;15;440;Ouhans;383;8;391
27;Bourgogne-Franche-Comté;25;3;18;441;Ouvans;67;1;68
27;Bourgogne-Franche-Comté;25;3;11;442;Oye-et-Pallet;725;26;751
27;Bourgogne-Franche-Comté;25;1;17;443;Palantine;72;3;75
27;Bourgogne-Franche-Comté;25;1;02;444;Palise;142;4;146
27;Bourgogne-Franche-Comté;25;1;17;445;Paroy;123;2;125
27;Bourgogne-Franche-Comté;25;1;02;446;Passavant;188;11;199
27;Bourgogne-Franche-Comté;25;3;18;447;Passonfontaine;341;9;350
27;Bourgogne-Franche-Comté;25;1;05;448;Pelousey;1531;29;1560
27;Bourgogne-Franche-Comté;25;2;18;449;Péseux;141;1;142
27;Bourgogne-Franche-Comté;25;1;17;450;Pessans;85;3;88
27;Bourgogne-Franche-Comté;25;3;11;451;Petite-Chaux;152;3;155
27;Bourgogne-Franche-Comté;25;2;12;452;Pierrefontaine-lès-Blamont;473;9;482
27;Bourgogne-Franche-Comté;25;3;18;453;Pierrefontaine-les-Varans;1384;39;1423
27;Bourgogne-Franche-Comté;25;1;05;454;Pirey;2128;51;2179
27;Bourgogne-Franche-Comté;25;1;17;455;Placey;196;4;200
27;Bourgogne-Franche-Comté;25;3;14;456;Plaimbois-du-Miroir;271;9;280
27;Bourgogne-Franche-Comté;25;3;18;457;Plaimbois-Vennes;114;0;114
27;Bourgogne-Franche-Comté;25;2;12;458;Les Plains-et-Grands-Essarts;214;5;219
27;Bourgogne-Franche-Comté;25;3;11;459;La Planée;315;10;325
27;Bourgogne-Franche-Comté;25;1;17;460;Le Val;242;18;260
27;Bourgogne-Franche-Comté;25;2;03;461;Pompierre-sur-Doubs;302;5;307
27;Bourgogne-Franche-Comté;25;3;16;462;Pontarlier;17738;880;18618
27;Bourgogne-Franche-Comté;25;2;19;463;Pont-de-Roide-Vermondans;4088;74;4162
27;Bourgogne-Franche-Comté;25;3;11;464;Les Pontets;135;4;139
27;Bourgogne-Franche-Comté;25;1;02;465;Pont-les-Moulins;205;3;208
27;Bourgogne-Franche-Comté;25;1;17;466;Pouilley-Français;826;17;843
27;Bourgogne-Franche-Comté;25;1;05;467;Pouilley-les-Vignes;2042;36;2078
27;Bourgogne-Franche-Comté;25;1;02;468;Pouligney-Lusans;844;19;863
27;Bourgogne-Franche-Comté;25;2;03;469;Présentevillers;463;13;476
27;Bourgogne-Franche-Comté;25;2;03;470;La Prétière;158;5;163
27;Bourgogne-Franche-Comté;25;2;18;471;Provenchère;138;5;143
27;Bourgogne-Franche-Comté;25;1;02;472;Puessans;33;3;36
27;Bourgogne-Franche-Comté;25;1;09;473;Pugey;716;13;729
27;Bourgogne-Franche-Comté;25;1;02;474;Le Puy;111;3;114
27;Bourgogne-Franche-Comté;25;1;17;475;Quingey;1399;23;1422
27;Bourgogne-Franche-Comté;25;2;03;476;Rahon;128;3;131
27;Bourgogne-Franche-Comté;25;1;04;477;Rancenay;403;6;409
27;Bourgogne-Franche-Comté;25;2;03;478;Randevillers;122;2;124
27;Bourgogne-Franche-Comté;25;2;03;479;Rang;392;4;396
27;Bourgogne-Franche-Comté;25;2;03;481;Raynans;340;5;345
27;Bourgogne-Franche-Comté;25;1;17;482;Recologne;687;2;689
27;Bourgogne-Franche-Comté;25;3;11;483;Reculfoz;38;3;41
27;Bourgogne-Franche-Comté;25;2;19;485;Rémondans-Vaivre;224;5;229
27;Bourgogne-Franche-Comté;25;3;11;486;Remoray-Boujeons;435;11;446
27;Bourgogne-Franche-Comté;25;3;15;487;Renédale;47;4;51
27;Bourgogne-Franche-Comté;25;1;17;488;Rennes-sur-Loue;108;1;109
27;Bourgogne-Franche-Comté;25;1;15;489;Reugney;280;26;306
27;Bourgogne-Franche-Comté;25;1;02;490;Rigney;377;19;396
27;Bourgogne-Franche-Comté;25;1;02;491;Rignosot;114;3;117
27;Bourgogne-Franche-Comté;25;1;02;492;Rillans;93;3;96
27;Bourgogne-Franche-Comté;25;3;11;493;La Rivière-Drugeon;924;23;947
27;Bourgogne-Franche-Comté;25;3;11;494;Rochejean;729;25;754
27;Bourgogne-Franche-Comté;25;1;08;495;Roche-lez-Beaupré;2169;24;2193
27;Bourgogne-Franche-Comté;25;2;03;496;Roche-lès-Clerval;99;0;99
27;Bourgogne-Franche-Comté;25;2;12;497;Roches-lès-Blamont;616;14;630
27;Bourgogne-Franche-Comté;25;1;02;498;Rognon;49;0;49
27;Bourgogne-Franche-Comté;25;1;02;499;Romain;122;2;124
27;Bourgogne-Franche-Comté;25;1;17;500;Ronchaux;85;1;86
27;Bourgogne-Franche-Comté;25;3;11;501;Rondefontaine;37;1;38
27;Bourgogne-Franche-Comté;25;1;17;502;Roset-Fluans;555;4;559
27;Bourgogne-Franche-Comté;25;2;18;503;Rosières-sur-Barbèche;114;4;118
27;Bourgogne-Franche-Comté;25;3;18;504;Rosureux;81;2;83
27;Bourgogne-Franche-Comté;25;1;02;505;Rougemont;1028;27;1055
27;Bourgogne-Franche-Comté;25;1;02;506;Rougemontot;91;0;91
27;Bourgogne-Franche-Comté;25;1;17;507;Rouhe;72;2;74
27;Bourgogne-Franche-Comté;25;1;02;508;Roulans;1127;27;1154
27;Bourgogne-Franche-Comté;25;1;17;510;Ruffey-le-Château;360;9;369
27;Bourgogne-Franche-Comté;25;1;17;511;Rurey;356;6;362
27;Bourgogne-Franche-Comté;25;3;14;512;Le Russey;2446;53;2499
27;Bourgogne-Franche-Comté;25;1;15;513;Sainte-Anne;49;0;49
27;Bourgogne-Franche-Comté;25;3;11;514;Saint-Antoine;330;12;342
27;Bourgogne-Franche-Comté;25;3;16;515;Sainte-Colombe;446;6;452
27;Bourgogne-Franche-Comté;25;2;03;516;Saint-Georges-Armont;124;6;130
27;Bourgogne-Franche-Comté;25;3;15;517;Saint-Gorgon-Main;276;9;285
27;Bourgogne-Franche-Comté;25;1;02;518;Saint-Hilaire;157;9;166
27;Bourgogne-Franche-Comté;25;2;12;519;Saint-Hippolyte;913;13;926
27;Bourgogne-Franche-Comté;25;1;02;520;Saint-Juan;181;1;182
27;Bourgogne-Franche-Comté;25;2;03;521;Saint-Julien-lès-Montbéliard;159;5;164
27;Bourgogne-Franche-Comté;25;3;14;522;Saint-Julien-lès-Russey;184;3;187
27;Bourgogne-Franche-Comté;25;2;03;523;Sainte-Marie;672;15;687
27;Bourgogne-Franche-Comté;25;2;03;524;Saint-Maurice-Colombier;902;26;928
27;Bourgogne-Franche-Comté;25;3;11;525;Saint-Point-Lac;298;12;310
27;Bourgogne-Franche-Comté;25;2;13;526;Sainte-Suzanne;1447;41;1488
27;Bourgogne-Franche-Comté;25;1;17;527;Saint-Vit;4924;74;4998
27;Bourgogne-Franche-Comté;25;1;17;528;Samson;72;1;73
27;Bourgogne-Franche-Comté;25;2;03;529;Sancey;1327;18;1345
27;Bourgogne-Franche-Comté;25;1;08;532;Saône;3164;68;3232
27;Bourgogne-Franche-Comté;25;1;15;533;Saraz;17;0;17
27;Bourgogne-Franche-Comté;25;3;11;534;Sarrageois;194;4;198
27;Bourgogne-Franche-Comté;25;1;15;535;Saules;231;6;237
27;Bourgogne-Franche-Comté;25;1;17;536;Sauvagney;188;2;190
27;Bourgogne-Franche-Comté;25;1;15;537;Scey-Maisières;287;9;296
27;Bourgogne-Franche-Comté;25;1;02;538;Séchin;117;4;121
27;Bourgogne-Franche-Comté;25;2;01;539;Seloncourt;5756;138;5894
27;Bourgogne-Franche-Comté;25;2;03;540;Semondans;309;6;315
27;Bourgogne-Franche-Comté;25;3;15;541;Septfontaines;378;8;386
27;Bourgogne-Franche-Comté;25;1;05;542;Serre-les-Sapins;1794;29;1823
27;Bourgogne-Franche-Comté;25;1;03;544;Servin;209;8;217
27;Bourgogne-Franche-Comté;25;1;15;545;Silley-Amancey;145;2;147
27;Bourgogne-Franche-Comté;25;1;02;546;Silley-Bléfond;61;1;62
27;Bourgogne-Franche-Comté;25;2;10;547;Sochaux;3820;42;3862
27;Bourgogne-Franche-Comté;25;2;19;548;Solemont;137;7;144
27;Bourgogne-Franche-Comté;25;3;15;549;Sombacour;632;7;639
27;Bourgogne-Franche-Comté;25;3;18;550;La Sommette;245;8;253
27;Bourgogne-Franche-Comté;25;2;12;551;Soulce-Cernay;133;1;134
27;Bourgogne-Franche-Comté;25;2;03;552;Sourans;117;2;119
27;Bourgogne-Franche-Comté;25;2;03;553;Soye;387;8;395
27;Bourgogne-Franche-Comté;25;2;03;554;Surmont;115;3;118
27;Bourgogne-Franche-Comté;25;2;01;555;Taillecourt;1104;25;1129
27;Bourgogne-Franche-Comté;25;1;02;556;Tallans;47;3;50
27;Bourgogne-Franche-Comté;25;1;06;557;Tallenay;430;8;438
27;Bourgogne-Franche-Comté;25;1;15;558;Tarcenay-Foucherans;1518;35;1553
27;Bourgogne-Franche-Comté;25;2;12;559;Thiébouhans;258;6;264
27;Bourgogne-Franche-Comté;25;1;07;560;Thise;3010;38;3048
27;Bourgogne-Franche-Comté;25;1;09;561;Thoraise;341;9;350
27;Bourgogne-Franche-Comté;25;2;12;562;Thulay;212;6;218
27;Bourgogne-Franche-Comté;25;1;02;563;Thurey-le-Mont;119;2;121
27;Bourgogne-Franche-Comté;25;1;09;564;Torpes;1020;16;1036
27;Bourgogne-Franche-Comté;25;3;11;565;Touillon-et-Loutelet;273;8;281
27;Bourgogne-Franche-Comté;25;1;02;566;La Tour-de-Sçay;307;4;311
27;Bourgogne-Franche-Comté;25;1;02;567;Tournans;115;3;118
27;Bourgogne-Franche-Comté;25;1;15;569;Trépot;544;11;555
27;Bourgogne-Franche-Comté;25;1;02;570;Tressandans;28;1;29
27;Bourgogne-Franche-Comté;25;2;12;571;Trévillers;509;9;518
27;Bourgogne-Franche-Comté;25;1;02;572;Trouvans;104;5;109
27;Bourgogne-Franche-Comté;25;2;12;573;Urtière;14;0;14
27;Bourgogne-Franche-Comté;25;1;02;574;Uzelle;179;1;180
27;Bourgogne-Franche-Comté;25;1;08;575;Vaire;801;11;812
27;Bourgogne-Franche-Comté;25;3;18;578;Valdahon;5734;107;5841
27;Bourgogne-Franche-Comté;25;1;02;579;Val-de-Roulans;209;3;212
27;Bourgogne-Franche-Comté;25;2;19;580;Valentigney;10897;168;11065
27;Bourgogne-Franche-Comté;25;1;02;582;Valleroy;143;2;145
27;Bourgogne-Franche-Comté;25;2;03;583;Valonne;254;5;259
27;Bourgogne-Franche-Comté;25;2;12;584;Valoreille;124;4;128
27;Bourgogne-Franche-Comté;25;2;01;586;Vandoncourt;809;31;840
27;Bourgogne-Franche-Comté;25;2;18;588;Vaucluse;123;23;146
27;Bourgogne-Franche-Comté;25;2;18;589;Vauclusotte;82;1;83
27;Bourgogne-Franche-Comté;25;1;03;590;Vaudrivillers;80;2;82
27;Bourgogne-Franche-Comté;25;2;12;591;Vaufrey;153;0;153
27;Bourgogne-Franche-Comté;25;3;11;592;Vaux-et-Chantegrue;630;16;646
27;Bourgogne-Franche-Comté;25;1;17;594;Velesmes-Essarts;350;5;355
27;Bourgogne-Franche-Comté;25;2;03;595;Vellerot-lès-Belvoir;94;1;95
27;Bourgogne-Franche-Comté;25;3;18;596;Vellerot-lès-Vercel;69;1;70
27;Bourgogne-Franche-Comté;25;2;03;597;Vellevans;237;3;240
27;Bourgogne-Franche-Comté;25;1;02;598;Venise;521;7;528
27;Bourgogne-Franche-Comté;25;1;02;599;Vennans;255;8;263
27;Bourgogne-Franche-Comté;25;3;18;600;Vennes;224;5;229
27;Bourgogne-Franche-Comté;25;3;18;601;Vercel-Villedieu-le-Camp;1691;84;1775
27;Bourgogne-Franche-Comté;25;1;02;602;Vergranne;118;5;123
27;Bourgogne-Franche-Comté;25;1;02;604;Verne;125;1;126
27;Bourgogne-Franche-Comté;25;3;18;605;Vernierfontaine;481;12;493
27;Bourgogne-Franche-Comté;25;2;03;607;Vernois-lès-Belvoir;57;1;58
27;Bourgogne-Franche-Comté;25;2;03;608;Le Vernoy;178;2;180
27;Bourgogne-Franche-Comté;25;3;16;609;Verrières-de-Joux;489;12;501
27;Bourgogne-Franche-Comté;25;1;08;611;La Vèze;483;7;490
27;Bourgogne-Franche-Comté;25;1;02;612;Vieilley;684;18;702
27;Bourgogne-Franche-Comté;25;1;02;613;Viéthorey;93;2;95
27;Bourgogne-Franche-Comté;25;2;10;614;Vieux-Charmont;2850;54;2904
27;Bourgogne-Franche-Comté;25;2;12;615;Villars-lès-Blamont;450;8;458
27;Bourgogne-Franche-Comté;25;1;17;616;Villars-Saint-Georges;284;3;287
27;Bourgogne-Franche-Comté;25;2;19;617;Villars-sous-Dampjoux;351;6;357
27;Bourgogne-Franche-Comté;25;2;03;618;Villars-sous-Écot;345;8;353
27;Bourgogne-Franche-Comté;25;3;11;619;Les Villedieu;199;2;201
27;Bourgogne-Franche-Comté;25;3;15;620;Ville-du-Pont;333;7;340
27;Bourgogne-Franche-Comté;25;3;11;621;Villeneuve-d'Amont;223;36;259
27;Bourgogne-Franche-Comté;25;1;17;622;Villers-Buzon;260;1;261
27;Bourgogne-Franche-Comté;25;3;18;623;Villers-Chief;131;2;133
27;Bourgogne-Franche-Comté;25;1;02;624;Villers-Grélot;146;3;149
27;Bourgogne-Franche-Comté;25;3;18;625;Villers-la-Combe;51;1;52
27;Bourgogne-Franche-Comté;25;1;02;626;Villers-Saint-Martin;226;8;234
27;Bourgogne-Franche-Comté;25;3;11;627;Villers-sous-Chalamont;300;11;311
27;Bourgogne-Franche-Comté;25;1;02;629;Voillans;200;6;206
27;Bourgogne-Franche-Comté;25;1;18;630;Voires;78;0;78
27;Bourgogne-Franche-Comté;25;1;09;631;Vorges-les-Pins;591;8;599
27;Bourgogne-Franche-Comté;25;2;19;632;Voujeaucourt;3105;85;3190
27;Bourgogne-Franche-Comté;25;1;15;633;Vuillafans;717;14;731
27;Bourgogne-Franche-Comté;25;3;16;634;Vuillecin;648;11;659
27;Bourgogne-Franche-Comté;25;2;03;635;Vyt-lès-Belvoir;186;7;193
84;Auvergne-Rhône-Alpes;26;1;04;001;Solaure en Diois;428;8;436
84;Auvergne-Rhône-Alpes;26;3;12;002;Albon;1967;46;2013
84;Auvergne-Rhône-Alpes;26;2;03;003;Aleyrac;52;0;52
84;Auvergne-Rhône-Alpes;26;3;01;004;Alixan;2592;56;2648
84;Auvergne-Rhône-Alpes;26;2;09;005;Allan;1824;51;1875
84;Auvergne-Rhône-Alpes;26;1;07;006;Allex;2488;75;2563
84;Auvergne-Rhône-Alpes;26;1;07;007;Ambonil;101;7;108
84;Auvergne-Rhône-Alpes;26;2;08;008;Ancône;1366;26;1392
84;Auvergne-Rhône-Alpes;26;3;12;009;Andancette;1328;35;1363
84;Auvergne-Rhône-Alpes;26;3;12;010;Anneyron;4117;101;4218
84;Auvergne-Rhône-Alpes;26;1;02;011;Aouste-sur-Sye;2601;43;2644
84;Auvergne-Rhône-Alpes;26;1;04;012;Arnayon;20;3;23
84;Auvergne-Rhône-Alpes;26;2;10;013;Arpavon;76;2;78
84;Auvergne-Rhône-Alpes;26;3;05;014;Arthémonay;618;9;627
84;Auvergne-Rhône-Alpes;26;1;04;015;Aubenasson;78;4;82
84;Auvergne-Rhône-Alpes;26;2;10;016;Aubres;420;9;429
84;Auvergne-Rhône-Alpes;26;1;04;017;Aucelon;16;0;16
84;Auvergne-Rhône-Alpes;26;2;10;018;Aulan;10;0;10
84;Auvergne-Rhône-Alpes;26;1;04;019;Aurel;244;3;247
84;Auvergne-Rhône-Alpes;26;1;02;020;La Répara-Auriples;245;6;251
84;Auvergne-Rhône-Alpes;26;1;02;021;Autichamp;133;2;135
84;Auvergne-Rhône-Alpes;26;2;10;022;Ballons;91;2;93
84;Auvergne-Rhône-Alpes;26;3;19;023;Barbières;1128;19;1147
84;Auvergne-Rhône-Alpes;26;3;02;024;Barcelonne;354;10;364
84;Auvergne-Rhône-Alpes;26;1;04;025;Barnave;209;7;216
84;Auvergne-Rhône-Alpes;26;2;10;026;Barret-de-Lioure;64;0;64
84;Auvergne-Rhône-Alpes;26;1;04;027;Barsac;143;1;144
84;Auvergne-Rhône-Alpes;26;3;05;028;Bathernay;227;13;240
84;Auvergne-Rhône-Alpes;26;1;04;030;La Bâtie-des-Fonds;2;0;2
84;Auvergne-Rhône-Alpes;26;2;03;031;La Bâtie-Rolland;1031;26;1057
84;Auvergne-Rhône-Alpes;26;3;02;032;La Baume-Cornillane;451;9;460
84;Auvergne-Rhône-Alpes;26;2;06;033;La Baume-de-Transit;926;16;942
84;Auvergne-Rhône-Alpes;26;3;19;034;La Baume-d'Hostun;592;8;600
84;Auvergne-Rhône-Alpes;26;1;02;035;Beaufort-sur-Gervanne;477;8;485
84;Auvergne-Rhône-Alpes;26;1;04;036;Beaumont-en-Diois;104;4;108
84;Auvergne-Rhône-Alpes;26;3;17;037;Beaumont-lès-Valence;4154;86;4240
84;Auvergne-Rhône-Alpes;26;3;13;038;Beaumont-Monteux;1328;32;1360
84;Auvergne-Rhône-Alpes;26;3;19;039;Beauregard-Baret;896;14;910
84;Auvergne-Rhône-Alpes;26;1;04;040;Beaurières;69;2;71
84;Auvergne-Rhône-Alpes;26;3;12;041;Beausemblant;1430;25;1455
84;Auvergne-Rhône-Alpes;26;3;17;042;Beauvallon;1595;26;1621
84;Auvergne-Rhône-Alpes;26;2;10;043;Beauvoisin;146;6;152
84;Auvergne-Rhône-Alpes;26;2;03;045;La Bégude-de-Mazenc;1656;46;1702
84;Auvergne-Rhône-Alpes;26;2;10;046;Bellecombe-Tarendol;65;3;68
84;Auvergne-Rhône-Alpes;26;1;04;047;Bellegarde-en-Diois;95;0;95
84;Auvergne-Rhône-Alpes;26;2;10;048;Bénivay-Ollon;75;1;76
84;Auvergne-Rhône-Alpes;26;3;19;049;Bésayes;1248;38;1286
84;Auvergne-Rhône-Alpes;26;2;10;050;Bésignan;85;2;87
84;Auvergne-Rhône-Alpes;26;2;03;051;Bézaudun-sur-Bîne;68;2;70
84;Auvergne-Rhône-Alpes;26;2;03;052;Bonlieu-sur-Roubion;473;7;480
84;Auvergne-Rhône-Alpes;26;2;06;054;Bouchet;1501;36;1537
84;Auvergne-Rhône-Alpes;26;1;04;055;Boulc;156;2;158
84;Auvergne-Rhône-Alpes;26;2;03;056;Bourdeaux;686;17;703
84;Auvergne-Rhône-Alpes;26;3;01;057;Bourg-de-Péage;9818;159;9977
84;Auvergne-Rhône-Alpes;26;3;15;058;Bourg-lès-Valence;19814;517;20331
84;Auvergne-Rhône-Alpes;26;1;19;059;Bouvante;210;3;213
84;Auvergne-Rhône-Alpes;26;2;03;060;Bouvières;148;6;154
84;Auvergne-Rhône-Alpes;26;3;05;061;Bren;624;10;634
84;Auvergne-Rhône-Alpes;26;1;04;062;Brette;34;3;37
84;Auvergne-Rhône-Alpes;26;2;10;063;Buis-les-Baronnies;2291;79;2370
84;Auvergne-Rhône-Alpes;26;3;16;064;Chabeuil;6839;182;7021
84;Auvergne-Rhône-Alpes;26;1;02;065;Chabrillan;757;8;765
84;Auvergne-Rhône-Alpes;26;1;19;066;Le Chaffal;41;0;41
84;Auvergne-Rhône-Alpes;26;1;04;067;Chalancon;58;1;59
84;Auvergne-Rhône-Alpes;26;3;05;068;Le Chalon;203;6;209
84;Auvergne-Rhône-Alpes;26;1;04;069;Chamaloc;126;6;132
84;Auvergne-Rhône-Alpes;26;2;06;070;Chamaret;520;9;529
84;Auvergne-Rhône-Alpes;26;3;13;071;Chanos-Curson;1146;35;1181
84;Auvergne-Rhône-Alpes;26;3;13;072;Chantemerle-les-Blés;1327;22;1349
84;Auvergne-Rhône-Alpes;26;2;06;073;Chantemerle-lès-Grignan;244;3;247
84;Auvergne-Rhône-Alpes;26;1;19;074;La Chapelle-en-Vercors;724;133;857
84;Auvergne-Rhône-Alpes;26;2;10;075;La Charce;25;1;26
84;Auvergne-Rhône-Alpes;26;1;04;076;Charens;28;0;28
84;Auvergne-Rhône-Alpes;26;3;05;077;Charmes-sur-l'Herbasse;867;22;889
84;Auvergne-Rhône-Alpes;26;2;03;078;Charols;935;13;948
84;Auvergne-Rhône-Alpes;26;3;19;079;Charpey;1515;38;1553
84;Auvergne-Rhône-Alpes;26;1;04;080;Chastel-Arnaud;44;0;44
84;Auvergne-Rhône-Alpes;26;3;02;081;Châteaudouble;573;23;596
84;Auvergne-Rhône-Alpes;26;2;10;082;Châteauneuf-de-Bordette;104;1;105
84;Auvergne-Rhône-Alpes;26;3;05;083;Châteauneuf-de-Galaure;1827;585;2412
84;Auvergne-Rhône-Alpes;26;3;13;084;Châteauneuf-sur-Isère;3988;149;4137
84;Auvergne-Rhône-Alpes;26;2;09;085;Châteauneuf-du-Rhône;2784;52;2836
84;Auvergne-Rhône-Alpes;26;1;04;086;Châtillon-en-Diois;658;12;670
84;Auvergne-Rhône-Alpes;26;3;11;087;Châtillon-Saint-Jean;1294;44;1338
84;Auvergne-Rhône-Alpes;26;3;19;088;Chatuzange-le-Goubet;6122;143;6265
84;Auvergne-Rhône-Alpes;26;2;10;089;Chaudebonne;61;1;62
84;Auvergne-Rhône-Alpes;26;1;04;090;La Chaudière;35;0;35
84;Auvergne-Rhône-Alpes;26;2;10;091;Chauvac-Laux-Montaux;42;0;42
84;Auvergne-Rhône-Alpes;26;3;05;092;Chavannes;738;11;749
84;Auvergne-Rhône-Alpes;26;2;14;093;Clansayes;526;12;538
84;Auvergne-Rhône-Alpes;26;3;12;094;Claveyson;883;16;899
84;Auvergne-Rhône-Alpes;26;2;03;095;Cléon-d'Andran;965;33;998
84;Auvergne-Rhône-Alpes;26;3;11;096;Clérieux;2049;36;2085
84;Auvergne-Rhône-Alpes;26;1;07;097;Cliousclat;615;17;632
84;Auvergne-Rhône-Alpes;26;1;02;098;Cobonne;170;5;175
84;Auvergne-Rhône-Alpes;26;2;06;099;Colonzelle;547;14;561
84;Auvergne-Rhône-Alpes;26;3;02;100;Combovin;460;15;475
84;Auvergne-Rhône-Alpes;26;2;03;101;Comps;140;9;149
84;Auvergne-Rhône-Alpes;26;2;03;102;Condillac;135;3;138
84;Auvergne-Rhône-Alpes;26;2;10;103;Condorcet;500;4;504
84;Auvergne-Rhône-Alpes;26;2;10;104;Cornillac;91;0;91
84;Auvergne-Rhône-Alpes;26;2;10;105;Cornillon-sur-l'Oule;74;1;75
84;Auvergne-Rhône-Alpes;26;2;08;106;La Coucourde;1163;26;1189
84;Auvergne-Rhône-Alpes;26;3;05;107;Crépol;532;15;547
84;Auvergne-Rhône-Alpes;26;1;02;108;Crest;8707;267;8974
84;Auvergne-Rhône-Alpes;26;3;13;110;Crozes-Hermitage;657;18;675
84;Auvergne-Rhône-Alpes;26;2;03;111;Crupies;100;1;101
84;Auvergne-Rhône-Alpes;26;2;10;112;Curnier;201;8;209
84;Auvergne-Rhône-Alpes;26;1;04;113;Die;4770;244;5014
84;Auvergne-Rhône-Alpes;26;2;03;114;Dieulefit;3238;133;3371
84;Auvergne-Rhône-Alpes;26;1;02;115;Divajeu;671;73;744
84;Auvergne-Rhône-Alpes;26;2;06;116;Donzère;5963;99;6062
84;Auvergne-Rhône-Alpes;26;1;19;117;Échevis;56;4;60
84;Auvergne-Rhône-Alpes;26;3;05;118;Épinouze;1520;24;1544
84;Auvergne-Rhône-Alpes;26;3;13;119;Érôme;808;8;816
84;Auvergne-Rhône-Alpes;26;2;09;121;Espeluche;1114;29;1143
84;Auvergne-Rhône-Alpes;26;1;04;122;Espenel;179;2;181
84;Auvergne-Rhône-Alpes;26;1;04;123;Establet;23;0;23
84;Auvergne-Rhône-Alpes;26;3;07;124;Étoile-sur-Rhône;5545;128;5673
84;Auvergne-Rhône-Alpes;26;1;02;125;Eurre;1409;34;1443
84;Auvergne-Rhône-Alpes;26;2;10;126;Eygalayes;90;0;90
84;Auvergne-Rhône-Alpes;26;2;10;127;Eygaliers;120;2;122
84;Auvergne-Rhône-Alpes;26;1;04;128;Eygluy-Escoulin;69;1;70
84;Auvergne-Rhône-Alpes;26;3;19;129;Eymeux;1048;20;1068
84;Auvergne-Rhône-Alpes;26;2;10;130;Eyroles;23;0;23
84;Auvergne-Rhône-Alpes;26;2;03;131;Eyzahut;151;3;154
84;Auvergne-Rhône-Alpes;26;3;12;133;Fay-le-Clos;176;4;180
84;Auvergne-Rhône-Alpes;26;1;03;134;Félines-sur-Rimandoule;86;1;87
84;Auvergne-Rhône-Alpes;26;2;10;135;Ferrassières;122;2;124
84;Auvergne-Rhône-Alpes;26;1;04;136;Val-Maravel;51;0;51
84;Auvergne-Rhône-Alpes;26;1;03;137;Francillon-sur-Roubion;192;2;194
84;Auvergne-Rhône-Alpes;26;2;14;138;La Garde-Adhémar;1126;27;1153
84;Auvergne-Rhône-Alpes;26;3;11;139;Génissieux;2409;59;2468
84;Auvergne-Rhône-Alpes;26;3;05;140;Geyssans;706;27;733
84;Auvergne-Rhône-Alpes;26;1;02;141;Gigors-et-Lozeron;213;5;218
84;Auvergne-Rhône-Alpes;26;1;04;142;Glandage;118;1;119
84;Auvergne-Rhône-Alpes;26;3;05;143;Le Grand-Serre;900;53;953
84;Auvergne-Rhône-Alpes;26;1;02;144;Grane;2007;52;2059
84;Auvergne-Rhône-Alpes;26;2;06;145;Les Granges-Gontardes;680;21;701
84;Auvergne-Rhône-Alpes;26;2;06;146;Grignan;1590;43;1633
84;Auvergne-Rhône-Alpes;26;1;04;147;Gumiane;19;1;20
84;Auvergne-Rhône-Alpes;26;3;05;148;Hauterives;1876;55;1931
84;Auvergne-Rhône-Alpes;26;3;19;149;Hostun;1009;16;1025
84;Auvergne-Rhône-Alpes;26;2;10;150;Izon-la-Bruisse;11;0;11
84;Auvergne-Rhône-Alpes;26;1;04;152;Jonchères;26;0;26
84;Auvergne-Rhône-Alpes;26;2;10;153;Laborel;103;3;106
84;Auvergne-Rhône-Alpes;26;2;10;154;Lachau;233;1;234
84;Auvergne-Rhône-Alpes;26;3;05;155;Lapeyrouse-Mornay;1210;16;1226
84;Auvergne-Rhône-Alpes;26;3;13;156;Larnage;1046;42;1088
84;Auvergne-Rhône-Alpes;26;2;03;157;La Laupie;749;17;766
84;Auvergne-Rhône-Alpes;26;1;04;159;Laval-d'Aix;115;2;117
84;Auvergne-Rhône-Alpes;26;3;12;160;Laveyron;1239;21;1260
84;Auvergne-Rhône-Alpes;26;2;10;161;Lemps;49;0;49
84;Auvergne-Rhône-Alpes;26;3;05;162;Lens-Lestang;888;28;916
84;Auvergne-Rhône-Alpes;26;1;19;163;Léoncel;46;0;46
84;Auvergne-Rhône-Alpes;26;1;04;164;Lesches-en-Diois;57;1;58
84;Auvergne-Rhône-Alpes;26;1;07;165;Livron-sur-Drôme;9254;150;9404
84;Auvergne-Rhône-Alpes;26;1;07;166;Loriol-sur-Drôme;6629;93;6722
84;Auvergne-Rhône-Alpes;26;1;04;167;Luc-en-Diois;543;1;544
84;Auvergne-Rhône-Alpes;26;1;04;168;Lus-la-Croix-Haute;528;13;541
84;Auvergne-Rhône-Alpes;26;2;06;169;Malataverne;2198;43;2241
84;Auvergne-Rhône-Alpes;26;3;16;170;Malissard;3239;94;3333
84;Auvergne-Rhône-Alpes;26;2;03;171;Manas;184;10;194
84;Auvergne-Rhône-Alpes;26;3;05;172;Manthes;665;10;675
84;Auvergne-Rhône-Alpes;26;3;19;173;Marches;872;22;894
84;Auvergne-Rhône-Alpes;26;3;05;174;Margès;1094;33;1127
84;Auvergne-Rhône-Alpes;26;1;04;175;Marignac-en-Diois;225;2;227
84;Auvergne-Rhône-Alpes;26;2;03;176;Marsanne;1280;41;1321
84;Auvergne-Rhône-Alpes;26;3;05;177;Marsaz;702;22;724
84;Auvergne-Rhône-Alpes;26;1;04;178;Menglon;535;7;542
84;Auvergne-Rhône-Alpes;26;3;13;179;Mercurol-Veaunes;2807;57;2864
84;Auvergne-Rhône-Alpes;26;2;10;180;Mérindol-les-Oliviers;213;6;219
84;Auvergne-Rhône-Alpes;26;2;10;181;Mévouillon;233;7;240
84;Auvergne-Rhône-Alpes;26;2;10;182;Mirabel-aux-Baronnies;1515;35;1550
84;Auvergne-Rhône-Alpes;26;1;02;183;Mirabel-et-Blacons;1185;30;1215
84;Auvergne-Rhône-Alpes;26;1;07;185;Mirmande;592;15;607
84;Auvergne-Rhône-Alpes;26;1;04;186;Miscon;60;0;60
84;Auvergne-Rhône-Alpes;26;2;10;188;Mollans-sur-Ouvèze;1065;24;1089
84;Auvergne-Rhône-Alpes;26;2;10;189;Montauban-sur-l'Ouvèze;120;2;122
84;Auvergne-Rhône-Alpes;26;2;10;190;Montaulieu;85;2;87
84;Auvergne-Rhône-Alpes;26;2;09;191;Montboucher-sur-Jabron;2456;70;2526
84;Auvergne-Rhône-Alpes;26;2;06;192;Montbrison-sur-Lez;274;10;284
84;Auvergne-Rhône-Alpes;26;2;10;193;Montbrun-les-Bains;443;2;445
84;Auvergne-Rhône-Alpes;26;3;05;194;Montchenu;591;17;608
84;Auvergne-Rhône-Alpes;26;1;02;195;Montclar-sur-Gervanne;192;2;194
84;Auvergne-Rhône-Alpes;26;3;17;196;Montéléger;1743;141;1884
84;Auvergne-Rhône-Alpes;26;3;16;197;Montélier;4278;117;4395
84;Auvergne-Rhône-Alpes;26;2;97;198;Montélimar;39790;1179;40969
84;Auvergne-Rhône-Alpes;26;2;10;199;Montferrand-la-Fare;28;1;29
84;Auvergne-Rhône-Alpes;26;2;10;200;Montfroc;84;1;85
84;Auvergne-Rhône-Alpes;26;2;10;201;Montguers;48;6;54
84;Auvergne-Rhône-Alpes;26;2;03;202;Montjoux;333;11;344
84;Auvergne-Rhône-Alpes;26;2;06;203;Montjoyer;278;6;284
84;Auvergne-Rhône-Alpes;26;1;04;204;Montlaur-en-Diois;144;5;149
84;Auvergne-Rhône-Alpes;26;1;04;205;Montmaur-en-Diois;85;0;85
84;Auvergne-Rhône-Alpes;26;3;02;206;Montmeyran;2955;102;3057
84;Auvergne-Rhône-Alpes;26;3;05;207;Montmiral;685;10;695
84;Auvergne-Rhône-Alpes;26;1;07;208;Montoison;1942;34;1976
84;Auvergne-Rhône-Alpes;26;2;10;209;Montréal-les-Sources;23;0;23
84;Auvergne-Rhône-Alpes;26;3;05;210;Valherbasse;1021;17;1038
84;Auvergne-Rhône-Alpes;26;2;06;211;Montségur-sur-Lauzon;1352;29;1381
84;Auvergne-Rhône-Alpes;26;3;02;212;Montvendre;1227;29;1256
84;Auvergne-Rhône-Alpes;26;3;05;213;Moras-en-Valloire;679;15;694
84;Auvergne-Rhône-Alpes;26;1;03;214;Mornans;77;0;77
84;Auvergne-Rhône-Alpes;26;1;04;215;La Motte-Chalancon;410;22;432
84;Auvergne-Rhône-Alpes;26;3;12;216;Saint-Jean-de-Galaure;1275;24;1299
84;Auvergne-Rhône-Alpes;26;1;19;217;La Motte-Fanjas;193;4;197
84;Auvergne-Rhône-Alpes;26;3;11;218;Mours-Saint-Eusèbe;3255;59;3314
84;Auvergne-Rhône-Alpes;26;2;10;220;Nyons;6737;184;6921
84;Auvergne-Rhône-Alpes;26;1;02;221;Omblèze;70;2;72
84;Auvergne-Rhône-Alpes;26;2;03;222;Orcinas;37;0;37
84;Auvergne-Rhône-Alpes;26;1;19;223;Oriol-en-Royans;523;6;529
84;Auvergne-Rhône-Alpes;26;3;02;224;Ourches;273;8;281
84;Auvergne-Rhône-Alpes;26;3;05;225;Parnans;707;22;729
84;Auvergne-Rhône-Alpes;26;2;06;226;Le Pègue;365;6;371
84;Auvergne-Rhône-Alpes;26;2;10;227;Pelonne;26;0;26
84;Auvergne-Rhône-Alpes;26;1;04;228;Pennes-le-Sec;34;0;34
84;Auvergne-Rhône-Alpes;26;2;10;229;La Penne-sur-l'Ouvèze;94;5;99
84;Auvergne-Rhône-Alpes;26;3;11;231;Peyrins;2644;71;2715
84;Auvergne-Rhône-Alpes;26;3;02;232;Peyrus;580;8;588
84;Auvergne-Rhône-Alpes;26;2;10;233;Piégon;241;9;250
84;Auvergne-Rhône-Alpes;26;1;02;234;Piégros-la-Clastre;887;16;903
84;Auvergne-Rhône-Alpes;26;2;14;235;Pierrelatte;13708;271;13979
84;Auvergne-Rhône-Alpes;26;2;10;236;Pierrelongue;220;2;222
84;Auvergne-Rhône-Alpes;26;2;10;238;Les Pilles;240;2;242
84;Auvergne-Rhône-Alpes;26;2;10;239;Plaisians;208;5;213
84;Auvergne-Rhône-Alpes;26;1;02;240;Plan-de-Baix;154;2;156
84;Auvergne-Rhône-Alpes;26;1;03;241;Le Poët-Célard;137;2;139
84;Auvergne-Rhône-Alpes;26;2;10;242;Le Poët-en-Percip;16;0;16
84;Auvergne-Rhône-Alpes;26;2;03;243;Le Poët-Laval;966;39;1005
84;Auvergne-Rhône-Alpes;26;2;10;244;Le Poët-Sigillat;128;5;133
84;Auvergne-Rhône-Alpes;26;2;10;245;Pommerol;5;0;5
84;Auvergne-Rhône-Alpes;26;1;04;246;Ponet-et-Saint-Auban;132;3;135
84;Auvergne-Rhône-Alpes;26;3;12;247;Ponsas;530;6;536
84;Auvergne-Rhône-Alpes;26;1;04;248;Pontaix;178;5;183
84;Auvergne-Rhône-Alpes;26;2;03;249;Pont-de-Barret;668;17;685
84;Auvergne-Rhône-Alpes;26;3;13;250;Pont-de-l'Isère;3608;53;3661
84;Auvergne-Rhône-Alpes;26;2;03;251;Portes-en-Valdaine;427;7;434
84;Auvergne-Rhône-Alpes;26;3;17;252;Portes-lès-Valence;10526;159;10685
84;Auvergne-Rhône-Alpes;26;1;04;253;Poyols;72;1;73
84;Auvergne-Rhône-Alpes;26;1;04;254;Pradelle;21;0;21
84;Auvergne-Rhône-Alpes;26;1;04;255;Les Prés;22;0;22
84;Auvergne-Rhône-Alpes;26;2;10;256;Propiac;138;5;143
84;Auvergne-Rhône-Alpes;26;2;03;257;Puygiron;459;20;479
84;Auvergne-Rhône-Alpes;26;2;03;258;Puy-Saint-Martin;869;19;888
84;Auvergne-Rhône-Alpes;26;3;05;259;Ratières;269;4;273
84;Auvergne-Rhône-Alpes;26;2;06;261;Réauville;396;10;406
84;Auvergne-Rhône-Alpes;26;1;04;262;Recoubeau-Jansac;288;2;290
84;Auvergne-Rhône-Alpes;26;2;10;263;Reilhanette;146;2;148
84;Auvergne-Rhône-Alpes;26;2;10;264;Rémuzat;325;7;332
84;Auvergne-Rhône-Alpes;26;1;04;266;Rimon-et-Savel;23;0;23
84;Auvergne-Rhône-Alpes;26;2;10;267;Rioms;24;1;25
84;Auvergne-Rhône-Alpes;26;2;03;268;Rochebaudin;125;0;125
84;Auvergne-Rhône-Alpes;26;2;10;269;Rochebrune;54;0;54
84;Auvergne-Rhône-Alpes;26;1;19;270;Rochechinard;129;2;131
84;Auvergne-Rhône-Alpes;26;3;13;271;La Roche-de-Glun;3456;65;3521
84;Auvergne-Rhône-Alpes;26;2;03;272;Rochefort-en-Valdaine;370;9;379
84;Auvergne-Rhône-Alpes;26;3;19;273;Rochefort-Samson;1022;19;1041
84;Auvergne-Rhône-Alpes;26;1;04;274;Rochefourchat;1;0;1
84;Auvergne-Rhône-Alpes;26;2;14;275;Rochegude;1671;48;1719
84;Auvergne-Rhône-Alpes;26;2;03;276;Roche-Saint-Secret-Béconne;469;14;483
84;Auvergne-Rhône-Alpes;26;1;02;277;La Roche-sur-Grane;173;4;177
84;Auvergne-Rhône-Alpes;26;2;10;278;La Roche-sur-le-Buis;285;9;294
84;Auvergne-Rhône-Alpes;26;2;10;279;La Rochette-du-Buis;57;1;58
84;Auvergne-Rhône-Alpes;26;3;98;281;Romans-sur-Isère;32818;668;33486
84;Auvergne-Rhône-Alpes;26;1;04;282;Romeyer;202;4;206
84;Auvergne-Rhône-Alpes;26;1;04;283;Rottier;24;0;24
84;Auvergne-Rhône-Alpes;26;2;06;284;Roussas;383;8;391
84;Auvergne-Rhône-Alpes;26;2;06;285;Rousset-les-Vignes;279;9;288
84;Auvergne-Rhône-Alpes;26;2;10;286;Roussieux;24;1;25
84;Auvergne-Rhône-Alpes;26;2;03;287;Roynac;483;15;498
84;Auvergne-Rhône-Alpes;26;2;10;288;Sahune;306;6;312
84;Auvergne-Rhône-Alpes;26;1;04;289;Saillans;1388;21;1409
84;Auvergne-Rhône-Alpes;26;1;19;290;Saint-Agnan-en-Vercors;354;9;363
84;Auvergne-Rhône-Alpes;26;1;04;291;Saint-Andéol;85;2;87
84;Auvergne-Rhône-Alpes;26;2;10;292;Saint-Auban-sur-l'Ouvèze;212;4;216
84;Auvergne-Rhône-Alpes;26;3;05;293;Saint-Avit;326;9;335
84;Auvergne-Rhône-Alpes;26;3;11;294;Saint-Bardoux;594;18;612
84;Auvergne-Rhône-Alpes;26;3;12;295;Saint-Barthélemy-de-Vals;1859;31;1890
84;Auvergne-Rhône-Alpes;26;1;04;296;Saint-Benoit-en-Diois;32;1;33
84;Auvergne-Rhône-Alpes;26;3;05;298;Saint-Christophe-et-le-Laris;421;5;426
84;Auvergne-Rhône-Alpes;26;1;04;299;Sainte-Croix;105;3;108
84;Auvergne-Rhône-Alpes;26;1;04;300;Saint-Dizier-en-Diois;49;1;50
84;Auvergne-Rhône-Alpes;26;3;05;301;Saint-Donat-sur-l'Herbasse;4294;94;4388
84;Auvergne-Rhône-Alpes;26;1;19;302;Sainte-Eulalie-en-Royans;549;10;559
84;Auvergne-Rhône-Alpes;26;2;10;303;Sainte-Euphémie-sur-Ouvèze;74;4;78
84;Auvergne-Rhône-Alpes;26;2;10;304;Saint-Ferréol-Trente-Pas;257;8;265
84;Auvergne-Rhône-Alpes;26;2;03;305;Saint-Gervais-sur-Roubion;1083;23;1106
84;Auvergne-Rhône-Alpes;26;2;10;306;Sainte-Jalle;318;5;323
84;Auvergne-Rhône-Alpes;26;1;19;307;Saint-Jean-en-Royans;2796;66;2862
84;Auvergne-Rhône-Alpes;26;1;04;308;Saint-Julien-en-Quint;148;0;148
84;Auvergne-Rhône-Alpes;26;1;19;309;Saint-Julien-en-Vercors;228;5;233
84;Auvergne-Rhône-Alpes;26;3;05;310;Saint-Laurent-d'Onay;158;4;162
84;Auvergne-Rhône-Alpes;26;1;19;311;Saint-Laurent-en-Royans;1409;51;1460
84;Auvergne-Rhône-Alpes;26;2;03;312;Saint-Marcel-lès-Sauzet;1269;29;1298
84;Auvergne-Rhône-Alpes;26;3;15;313;Saint-Marcel-lès-Valence;6320;124;6444
84;Auvergne-Rhône-Alpes;26;3;05;314;Saint-Martin-d'Août;390;16;406
84;Auvergne-Rhône-Alpes;26;1;19;315;Saint-Martin-en-Vercors;382;7;389
84;Auvergne-Rhône-Alpes;26;1;19;316;Saint-Martin-le-Colonel;210;7;217
84;Auvergne-Rhône-Alpes;26;2;10;317;Saint-Maurice-sur-Eygues;796;12;808
84;Auvergne-Rhône-Alpes;26;2;10;318;Saint-May;33;1;34
84;Auvergne-Rhône-Alpes;26;3;05;319;Saint-Michel-sur-Savasse;558;12;570
84;Auvergne-Rhône-Alpes;26;1;19;320;Saint-Nazaire-en-Royans;811;10;821
84;Auvergne-Rhône-Alpes;26;1;04;321;Saint-Nazaire-le-Désert;208;1;209
84;Auvergne-Rhône-Alpes;26;2;06;322;Saint-Pantaléon-les-Vignes;410;22;432
84;Auvergne-Rhône-Alpes;26;3;11;323;Saint-Paul-lès-Romans;1858;34;1892
84;Auvergne-Rhône-Alpes;26;2;14;324;Saint-Paul-Trois-Châteaux;8731;431;9162
84;Auvergne-Rhône-Alpes;26;3;12;325;Saint-Rambert-d'Albon;6833;67;6900
84;Auvergne-Rhône-Alpes;26;2;14;326;Saint-Restitut;1462;48;1510
84;Auvergne-Rhône-Alpes;26;1;04;327;Saint-Roman;218;3;221
84;Auvergne-Rhône-Alpes;26;1;04;328;Saint-Sauveur-en-Diois;53;1;54
84;Auvergne-Rhône-Alpes;26;2;10;329;Saint-Sauveur-Gouvernet;178;6;184
84;Auvergne-Rhône-Alpes;26;3;05;330;Saint-Sorlin-en-Valloire;2247;44;2291
84;Auvergne-Rhône-Alpes;26;1;19;331;Saint-Thomas-en-Royans;608;14;622
84;Auvergne-Rhône-Alpes;26;3;12;332;Saint-Uze;2083;23;2106
84;Auvergne-Rhône-Alpes;26;3;12;333;Saint-Vallier;4017;155;4172
84;Auvergne-Rhône-Alpes;26;2;03;334;Salettes;141;2;143
84;Auvergne-Rhône-Alpes;26;2;06;335;Salles-sous-Bois;202;3;205
84;Auvergne-Rhône-Alpes;26;1;03;336;Saou;565;23;588
84;Auvergne-Rhône-Alpes;26;2;08;337;Saulce-sur-Rhône;1838;30;1868
84;Auvergne-Rhône-Alpes;26;2;03;338;Sauzet;1830;58;1888
84;Auvergne-Rhône-Alpes;26;2;08;339;Savasse;1536;43;1579
84;Auvergne-Rhône-Alpes;26;2;10;340;Séderon;251;5;256
84;Auvergne-Rhône-Alpes;26;3;13;341;Serves-sur-Rhône;726;13;739
84;Auvergne-Rhône-Alpes;26;2;14;342;Solérieux;315;7;322
84;Auvergne-Rhône-Alpes;26;2;03;343;Souspierre;107;2;109
84;Auvergne-Rhône-Alpes;26;1;03;344;Soyans;395;7;402
84;Auvergne-Rhône-Alpes;26;2;14;345;Suze-la-Rousse;2126;71;2197
84;Auvergne-Rhône-Alpes;26;1;02;346;Suze;236;8;244
84;Auvergne-Rhône-Alpes;26;3;13;347;Tain-l'Hermitage;6025;244;6269
84;Auvergne-Rhône-Alpes;26;2;06;348;Taulignan;1645;28;1673
84;Auvergne-Rhône-Alpes;26;3;05;349;Tersanne;363;8;371
84;Auvergne-Rhône-Alpes;26;2;03;350;Teyssières;68;1;69
84;Auvergne-Rhône-Alpes;26;2;03;351;Les Tonils;34;0;34
84;Auvergne-Rhône-Alpes;26;2;03;352;La Touche;261;8;269
84;Auvergne-Rhône-Alpes;26;2;08;353;Les Tourrettes;1034;19;1053
84;Auvergne-Rhône-Alpes;26;3;11;355;Triors;617;8;625
84;Auvergne-Rhône-Alpes;26;2;03;356;Truinas;127;6;133
84;Auvergne-Rhône-Alpes;26;2;06;357;Tulette;2004;39;2043
84;Auvergne-Rhône-Alpes;26;3;02;358;Upie;1523;41;1564
84;Auvergne-Rhône-Alpes;26;1;04;359;Vachères-en-Quint;36;0;36
84;Auvergne-Rhône-Alpes;26;2;06;360;Valaurie;692;26;718
84;Auvergne-Rhône-Alpes;26;1;04;361;Valdrôme;134;3;137
84;Auvergne-Rhône-Alpes;26;3;99;362;Valence;64431;1278;65709
84;Auvergne-Rhône-Alpes;26;2;10;363;Valouse;40;0;40
84;Auvergne-Rhône-Alpes;26;1;19;364;Vassieux-en-Vercors;333;8;341
84;Auvergne-Rhône-Alpes;26;1;02;365;Vaunaveys-la-Rochette;583;11;594
84;Auvergne-Rhône-Alpes;26;2;10;367;Venterol;672;11;683
84;Auvergne-Rhône-Alpes;26;1;04;368;Vercheny;461;8;469
84;Auvergne-Rhône-Alpes;26;2;10;369;Verclause;61;0;61
84;Auvergne-Rhône-Alpes;26;2;10;370;Vercoiran;138;4;142
84;Auvergne-Rhône-Alpes;26;1;04;371;Véronne;44;1;45
84;Auvergne-Rhône-Alpes;26;2;10;372;Vers-sur-Méouge;39;1;40
84;Auvergne-Rhône-Alpes;26;2;03;373;Vesc;242;8;250
84;Auvergne-Rhône-Alpes;26;2;10;374;Villebois-les-Pins;14;0;14
84;Auvergne-Rhône-Alpes;26;2;10;375;Villefranche-le-Château;17;1;18
84;Auvergne-Rhône-Alpes;26;2;10;376;Villeperdrix;101;1;102
84;Auvergne-Rhône-Alpes;26;2;10;377;Vinsobres;1025;23;1048
84;Auvergne-Rhône-Alpes;26;1;04;378;Volvent;33;0;33
84;Auvergne-Rhône-Alpes;26;3;13;379;Granges-les-Beaumont;890;12;902
84;Auvergne-Rhône-Alpes;26;3;13;380;Gervans;546;10;556
84;Auvergne-Rhône-Alpes;26;3;19;381;Jaillans;910;12;922
84;Auvergne-Rhône-Alpes;26;3;19;382;Saint-Vincent-la-Commanderie;571;7;578
28;Normandie;27;2;07;001;Aclou;330;9;339
28;Normandie;27;3;22;002;Acon;460;9;469
28;Normandie;27;1;18;003;Acquigny;1674;34;1708
28;Normandie;27;1;16;004;Aigleville;420;13;433
28;Normandie;27;1;12;005;Ailly;1191;21;1212
28;Normandie;27;2;04;006;Aizier;154;3;157
28;Normandie;27;1;18;008;Alizay;1597;17;1614
28;Normandie;27;2;06;009;Ambenay;565;11;576
28;Normandie;27;1;13;010;Amécourt;174;7;181
28;Normandie;27;2;05;011;Amfreville-Saint-Amand;1197;13;1210
28;Normandie;27;1;19;012;Amfreville-les-Champs;443;16;459
28;Normandie;27;1;21;013;Amfreville-sous-les-Monts;488;11;499
28;Normandie;27;1;18;014;Amfreville-sur-Iton;859;21;880
28;Normandie;27;1;14;015;Andé;1304;32;1336
28;Normandie;27;1;01;016;Les Andelys;8055;138;8193
28;Normandie;27;3;11;017;Angerville-la-Campagne;1350;38;1388
28;Normandie;27;2;17;018;Appeville-Annebault;989;12;1001
28;Normandie;27;2;22;019;Armentières-sur-Avre;161;7;168
28;Normandie;27;3;09;020;Arnières-sur-Iton;1667;43;1710
28;Normandie;27;2;03;021;Asnières;338;9;347
28;Normandie;27;1;12;022;Le Val d'Hazey;5248;106;5354
28;Normandie;27;3;08;023;Aulnay-sur-Iton;706;19;725
28;Normandie;27;1;12;025;Autheuil-Authouillet;949;20;969
28;Normandie;27;1;13;026;Authevernes;448;9;457
28;Normandie;27;3;20;027;Les Authieux;291;7;298
28;Normandie;27;2;17;028;Authou;336;4;340
28;Normandie;27;3;10;031;Aviron;1102;37;1139
28;Normandie;27;2;22;032;Chambois;1398;31;1429
28;Normandie;27;2;15;033;Bacquepuis;306;4;310
28;Normandie;27;1;19;034;Bacqueville;628;7;635
28;Normandie;27;2;03;035;Bailleul-la-Vallée;100;1;101
28;Normandie;27;2;22;036;Bâlines;541;21;562
28;Normandie;27;2;07;037;Barc;1155;21;1176
28;Normandie;27;2;22;038;Les Barils;276;6;282
28;Normandie;27;2;04;039;Barneville-sur-Seine;517;35;552
28;Normandie;27;2;07;040;Barquet;448;5;453
28;Normandie;27;2;03;042;Barville;82;0;82
28;Normandie;27;2;06;043;Les Baux-de-Breteuil;677;21;698
28;Normandie;27;3;11;044;Les Baux-Sainte-Croix;836;19;855
28;Normandie;27;1;13;045;Bazincourt-sur-Epte;783;12;795
28;Normandie;27;2;03;046;Bazoques;143;1;144
28;Normandie;27;3;08;047;Beaubray;336;8;344
28;Normandie;27;1;19;048;Beauficel-en-Lyons;186;3;189
28;Normandie;27;2;02;049;Mesnil-en-Ouche;4484;119;4603
28;Normandie;27;2;07;050;Beaumontel;636;17;653
28;Normandie;27;2;07;051;Beaumont-le-Roger;2791;40;2831
28;Normandie;27;2;07;052;Le Bec-Hellouin;402;3;405
28;Normandie;27;2;05;053;Le Bec-Thomas;213;2;215
28;Normandie;27;2;06;054;Bémécourt;582;8;590
28;Normandie;27;2;15;055;Bérengeville-la-Campagne;330;6;336
28;Normandie;27;2;02;056;Bernay;9654;281;9935
28;Normandie;27;2;15;057;Bernienville;288;6;294
28;Normandie;27;1;12;058;Les Trois Lacs;1759;45;1804
28;Normandie;27;1;13;059;Bernouville;313;4;317
28;Normandie;27;2;07;061;Berthouville;327;5;332
28;Normandie;27;2;05;062;Les Monts du Roumois;1571;45;1616
28;Normandie;27;2;07;063;Berville-la-Campagne;258;1;259
28;Normandie;27;2;03;064;Berville-sur-Mer;680;9;689
28;Normandie;27;2;03;065;Beuzeville;4682;53;4735
28;Normandie;27;1;19;066;Bézu-la-Forêt;315;3;318
28;Normandie;27;1;13;067;Bézu-Saint-Éloi;1572;28;1600
28;Normandie;27;2;06;068;Bois-Anzeray;171;2;173
28;Normandie;27;2;06;069;Bois-Arnault;689;15;704
28;Normandie;27;1;01;070;Frenelles-en-Vexin;1714;27;1741
28;Normandie;27;2;03;071;Le Bois-Hellain;213;2;215
28;Normandie;27;1;01;072;Bois-Jérôme-Saint-Ouen;748;23;771
28;Normandie;27;3;20;073;Bois-le-Roi;1238;19;1257
28;Normandie;27;2;07;074;Boisney;276;8;284
28;Normandie;27;2;06;075;Bois-Normand-près-Lyre;350;6;356
28;Normandie;27;1;16;076;Boisset-les-Prévanches;498;8;506
28;Normandie;27;2;05;077;Boissey-le-Châtel;854;10;864
28;Normandie;27;1;16;078;La Boissière;262;11;273
28;Normandie;27;2;03;079;Boissy-Lamberville;367;5;372
28;Normandie;27;3;11;081;Boncourt;181;7;188
28;Normandie;27;3;08;082;La Bonneville-sur-Iton;2047;47;2094
28;Normandie;27;2;17;083;Bonneville-Aptot;264;4;268
28;Normandie;27;2;05;085;Flancourt-Crescy-en-Roumois;1554;22;1576
28;Normandie;27;2;05;089;Thénouville;1008;17;1025
28;Normandie;27;2;05;090;Bosroumois;3718;68;3786
28;Normandie;27;2;04;091;Bosgouet;755;4;759
28;Normandie;27;1;19;094;Bosquentin;125;1;126
28;Normandie;27;2;07;095;Bosrobert;668;11;679
28;Normandie;27;2;06;096;Les Bottereaux;344;11;355
28;Normandie;27;1;01;097;Bouafles;663;12;675
28;Normandie;27;1;19;098;Bouchevilliers;79;5;84
28;Normandie;27;3;10;099;Le Boulay-Morin;810;10;820
28;Normandie;27;2;03;100;Boulleville;1204;24;1228
28;Normandie;27;2;04;101;Bouquelon;526;10;536
28;Normandie;27;2;04;102;Bouquetot;1035;22;1057
28;Normandie;27;2;04;103;Bourg-Achard;3939;73;4012
28;Normandie;27;1;19;104;Bourg-Beaudouin;707;10;717
28;Normandie;27;2;05;105;Grand Bourgtheroulde;4038;79;4117
28;Normandie;27;2;03;106;Bournainville-Faverolles;482;5;487
28;Normandie;27;2;04;107;Bourneville-Sainte-Croix;1336;24;1360
28;Normandie;27;2;22;108;Bourth;1188;31;1219
28;Normandie;27;2;07;109;Bray;398;8;406
28;Normandie;27;2;17;110;Brestot;652;8;660
28;Normandie;27;3;20;111;Bretagnolles;203;5;208
28;Normandie;27;2;06;112;Breteuil;4321;124;4445
28;Normandie;27;2;07;113;Brétigny;141;2;143
28;Normandie;27;1;16;114;Breuilpont;1210;23;1233
28;Normandie;27;2;22;115;Breux-sur-Avre;339;7;346
28;Normandie;27;2;07;116;Brionne;4184;152;4336
28;Normandie;27;2;06;117;Broglie;1013;20;1033
28;Normandie;27;2;15;118;Brosville;644;10;654
28;Normandie;27;1;16;119;Bueil;1625;28;1653
28;Normandie;27;3;08;120;Burey;405;5;410
28;Normandie;27;1;16;123;Caillouet-Orgeville;487;12;499
28;Normandie;27;1;12;124;Cailly-sur-Eure;213;2;215
28;Normandie;27;2;07;125;Calleville;654;10;664
28;Normandie;27;2;17;126;Campigny;1101;21;1122
28;Normandie;27;2;15;127;Canappeville;699;22;721
28;Normandie;27;2;02;129;Caorches-Saint-Nicolas;597;19;616
28;Normandie;27;2;06;130;Capelle-les-Grands;417;11;428
28;Normandie;27;3;08;132;Caugé;846;21;867
28;Normandie;27;2;04;133;Caumont;1086;12;1098
28;Normandie;27;2;04;134;Cauverville-en-Roumois;213;0;213
28;Normandie;27;2;15;135;Cesseville;444;11;455
28;Normandie;27;1;16;136;Chaignes;276;4;280
28;Normandie;27;2;06;137;Chaise-Dieu-du-Theil;199;5;204
28;Normandie;27;2;06;138;Chamblac;385;11;396
28;Normandie;27;2;06;139;Chambord;175;6;181
28;Normandie;27;1;16;140;Chambray;407;9;416
28;Normandie;27;3;08;141;Champ-Dolent;63;0;63
28;Normandie;27;1;12;142;Champenard;288;7;295
28;Normandie;27;3;20;144;Champigny-la-Futelaye;273;5;278
28;Normandie;27;2;03;146;La Chapelle-Bayvel;382;5;387
28;Normandie;27;3;10;147;La Chapelle-du-Bois-des-Faulx;693;11;704
28;Normandie;27;2;06;148;La Chapelle-Gauthier;410;9;419
28;Normandie;27;2;03;149;La Chapelle-Hareng;117;3;120
28;Normandie;27;1;19;151;Charleval;1706;22;1728
28;Normandie;27;1;01;152;Château-sur-Epte;559;9;568
28;Normandie;27;1;13;153;Chauvincourt-Provemont;377;7;384
28;Normandie;27;3;20;154;Chavigny-Bailleul;597;16;613
28;Normandie;27;2;22;155;Chennebrun;105;2;107
28;Normandie;27;2;06;156;Chéronvilliers;467;17;484
28;Normandie;27;2;06;157;Marbois;1321;20;1341
28;Normandie;27;3;11;158;Cierrey;774;27;801
28;Normandie;27;3;08;161;Claville;1080;21;1101
28;Normandie;27;3;08;162;Collandres-Quincarnon;242;4;246
28;Normandie;27;2;17;163;Colletot;198;3;201
28;Normandie;27;2;07;164;Combon;819;7;826
28;Normandie;27;3;08;165;Conches-en-Ouche;4950;72;5022
28;Normandie;27;2;17;167;Condé-sur-Risle;661;6;667
28;Normandie;27;1;21;168;Connelles;177;7;184
28;Normandie;27;2;03;169;Conteville;1015;12;1027
28;Normandie;27;2;03;170;Cormeilles;1195;20;1215
28;Normandie;27;1;16;171;Le Cormier;373;10;383
28;Normandie;27;2;02;173;Corneville-la-Fouquetière;123;3;126
28;Normandie;27;2;17;174;Corneville-sur-Risle;1371;26;1397
28;Normandie;27;1;13;176;Coudray;217;5;222
28;Normandie;27;3;20;177;Coudres;551;13;564
28;Normandie;27;2;02;179;Courbépine;717;16;733
28;Normandie;27;1;12;180;Courcelles-sur-Seine;2129;38;2167
28;Normandie;27;3;22;181;Courdemanche;600;11;611
28;Normandie;27;2;22;182;Courteilles;162;2;164
28;Normandie;27;3;20;183;La Couture-Boussey;2315;41;2356
28;Normandie;27;1;18;184;Crasville;123;3;126
28;Normandie;27;2;15;185;Crestot;575;8;583
28;Normandie;27;2;15;187;Criquebeuf-la-Campagne;338;6;344
28;Normandie;27;1;18;188;Criquebeuf-sur-Seine;1512;16;1528
28;Normandie;27;3;08;189;La Croisille;425;7;432
28;Normandie;27;1;16;190;Croisy-sur-Eure;216;4;220
28;Normandie;27;1;12;191;Clef Vallée d'Eure;2482;65;2547
28;Normandie;27;2;15;192;Crosville-la-Vieille;604;11;615
28;Normandie;27;3;20;193;Croth;1374;16;1390
28;Normandie;27;1;01;194;Cuverville;250;2;252
28;Normandie;27;1;18;196;Les Damps;1360;10;1370
28;Normandie;27;2;88;198;Mesnils-sur-Iton;6149;216;6365
28;Normandie;27;1;13;199;Dangu;570;12;582
28;Normandie;27;3;10;200;Dardez;143;7;150
28;Normandie;27;2;15;201;Daubeuf-la-Campagne;238;3;241
28;Normandie;27;1;01;202;Daubeuf-près-Vatteville;461;8;469
28;Normandie;27;1;16;203;Douains;461;17;478
28;Normandie;27;1;13;204;Doudeauville-en-Vexin;275;7;282
28;Normandie;27;1;19;205;Douville-sur-Andelle;439;8;447
28;Normandie;27;3;22;206;Droisy;458;3;461
28;Normandie;27;2;03;207;Drucourt;584;7;591
28;Normandie;27;2;03;208;Duranville;150;2;152
28;Normandie;27;2;17;209;Écaquelon;601;11;612
28;Normandie;27;2;07;210;Écardenville-la-Campagne;465;12;477
28;Normandie;27;2;15;212;Écauville;110;2;112
28;Normandie;27;1;01;213;Vexin-sur-Epte;5964;135;6099
28;Normandie;27;1;01;214;Écouis;818;14;832
28;Normandie;27;2;15;215;Ecquetot;389;10;399
28;Normandie;27;3;10;216;Émalleville;483;25;508
28;Normandie;27;2;15;217;Émanville;554;9;563
28;Normandie;27;2;03;218;Épaignes;1561;25;1586
28;Normandie;27;2;15;219;Épégard;536;7;543
28;Normandie;27;3;20;220;Épieds;347;8;355
28;Normandie;27;2;03;222;Épreville-en-Lieuvin;200;4;204
28;Normandie;27;2;15;224;Épreville-près-le-Neubourg;454;9;463
28;Normandie;27;1;13;226;Étrépagny;3703;81;3784
28;Normandie;27;2;04;227;Étréville;667;11;678
28;Normandie;27;2;04;228;Éturqueraye;304;3;307
28;Normandie;27;3;99;229;Évreux;46869;1227;48096
28;Normandie;27;3;20;230;Ézy-sur-Eure;3686;49;3735
28;Normandie;27;1;16;231;Fains;451;7;458
28;Normandie;27;1;13;232;Farceaux;345;7;352
28;Normandie;27;2;03;233;Fatouville-Grestain;725;11;736
28;Normandie;27;3;11;234;Fauville;351;6;357
28;Normandie;27;3;08;235;Faverolles-la-Campagne;166;2;168
28;Normandie;27;2;03;237;Le Favril;171;4;175
28;Normandie;27;3;08;238;Ferrières-Haut-Clocher;1162;30;1192
28;Normandie;27;2;06;239;Ferrières-Saint-Hilaire;416;7;423
28;Normandie;27;3;08;240;La Ferrière-sur-Risle;222;4;226
28;Normandie;27;2;15;241;Feuguerolles;173;5;178
28;Normandie;27;3;08;242;Le Fidelaire;1013;10;1023
28;Normandie;27;2;03;243;Fiquefleur-Équainville;748;10;758
28;Normandie;27;1;19;245;Fleury-la-Forêt;269;5;274
28;Normandie;27;1;19;246;Fleury-sur-Andelle;1826;20;1846
28;Normandie;27;1;19;247;Flipou;323;3;326
28;Normandie;27;2;03;248;Folleville;195;3;198
28;Normandie;27;1;12;249;Fontaine-Bellenger;1161;21;1182
28;Normandie;27;2;02;251;Fontaine-l'Abbé;553;6;559
28;Normandie;27;2;03;252;Fontaine-la-Louvet;328;7;335
28;Normandie;27;1;16;254;Fontaine-sous-Jouy;847;23;870
28;Normandie;27;3;20;256;La Forêt-du-Parc;628;9;637
28;Normandie;27;2;03;258;Fort-Moville;526;6;532
28;Normandie;27;3;20;259;Foucrainville;91;4;95
28;Normandie;27;2;03;260;Foulbec;664;8;672
28;Normandie;27;2;05;261;Fouqueville;442;11;453
28;Normandie;27;2;17;263;Le Perrey;1236;20;1256
28;Normandie;27;2;07;266;Franqueville;310;2;312
28;Normandie;27;2;17;267;Freneuse-sur-Risle;345;4;349
28;Normandie;27;2;03;269;Fresne-Cauverville;193;3;196
28;Normandie;27;3;20;271;Fresney;320;13;333
28;Normandie;27;1;16;273;Gadencourt;375;11;386
28;Normandie;27;1;12;275;Gaillon;6833;102;6935
28;Normandie;27;1;13;276;Gamaches-en-Vexin;281;8;289
28;Normandie;27;3;20;277;La Baronnie;748;15;763
28;Normandie;27;3;20;278;Garennes-sur-Eure;1967;38;2005
28;Normandie;27;1;23;279;Gasny;3065;64;3129
28;Normandie;27;3;11;280;Gauciel;835;7;842
28;Normandie;27;3;08;281;Gaudreville-la-Rivière;222;8;230
28;Normandie;27;3;08;282;Gauville-la-Campagne;620;16;636
28;Normandie;27;1;13;284;Gisors;11863;183;12046
28;Normandie;27;1;23;285;Giverny;486;13;499
28;Normandie;27;2;03;286;Giverville;400;10;410
28;Normandie;27;3;08;287;Glisolles;864;16;880
28;Normandie;27;2;17;288;Glos-sur-Risle;604;14;618
28;Normandie;27;2;06;289;La Goulafrière;170;2;172
28;Normandie;27;2;07;290;Goupil-Othon;1256;17;1273
28;Normandie;27;2;22;291;Gournay-le-Guérin;124;5;129
28;Normandie;27;1;19;294;Val d'Orger;993;15;1008
28;Normandie;27;2;06;295;Grand-Camp;470;15;485
28;Normandie;27;2;15;298;Graveron-Sémerville;319;6;325
28;Normandie;27;3;10;299;Gravigny;4016;81;4097
28;Normandie;27;2;07;300;Grosley-sur-Risle;530;6;536
28;Normandie;27;3;20;301;Grossœuvre;1366;35;1401
28;Normandie;27;2;15;302;Le Bosc du Theil;1300;13;1313
28;Normandie;27;1;13;304;Guerny;163;4;167
28;Normandie;27;3;11;306;Guichainville;3017;61;3078
28;Normandie;27;1;01;307;Guiseniers;473;11;484
28;Normandie;27;3;20;309;L'Habit;502;7;509
28;Normandie;27;1;13;310;Hacqueville;420;8;428
28;Normandie;27;2;07;311;Harcourt;1096;4;1100
28;Normandie;27;1;16;312;Hardencourt-Cocherel;275;12;287
28;Normandie;27;2;05;313;La Harengère;618;5;623
28;Normandie;27;1;01;315;Harquency;272;8;280
28;Normandie;27;2;04;316;Hauville;1294;28;1322
28;Normandie;27;2;04;317;La Haye-Aubrée;453;9;462
28;Normandie;27;2;07;318;La Haye-de-Calleville;256;3;259
28;Normandie;27;2;04;319;La Haye-de-Routot;300;2;302
28;Normandie;27;2;05;320;La Haye-du-Theil;309;0;309
28;Normandie;27;1;18;321;La Haye-le-Comte;136;5;141
28;Normandie;27;1;18;322;La Haye-Malherbe;1388;18;1406
28;Normandie;27;2;06;323;La Haye-Saint-Sylvestre;286;3;289
28;Normandie;27;1;13;324;Hébécourt;623;13;636
28;Normandie;27;2;07;325;Hecmanville;194;3;197
28;Normandie;27;1;16;326;Hécourt;314;13;327
28;Normandie;27;2;15;327;Hectomare;211;8;219
28;Normandie;27;1;01;329;Hennezis;762;22;784
28;Normandie;27;1;21;330;Herqueville;132;4;136
28;Normandie;27;1;01;331;Heubécourt-Haricourt;456;10;466
28;Normandie;27;1;14;332;Heudebouville;787;13;800
28;Normandie;27;1;13;333;Heudicourt;736;7;743
28;Normandie;27;2;03;334;Heudreville-en-Lieuvin;110;1;111
28;Normandie;27;1;12;335;Heudreville-sur-Eure;1073;26;1099
28;Normandie;27;1;16;336;La Heunière;450;4;454
28;Normandie;27;1;01;337;Heuqueville;352;6;358
28;Normandie;27;1;19;338;Les Hogues;679;9;688
28;Normandie;27;2;15;339;Hondouville;785;16;801
28;Normandie;27;2;04;340;Honguemare-Guenouville;707;11;718
28;Normandie;27;2;22;341;L'Hosmes;67;1;68
28;Normandie;27;2;15;342;Houetteville;198;6;204
28;Normandie;27;1;16;343;Houlbec-Cocherel;1271;55;1326
28;Normandie;27;2;07;345;La Houssaye;207;2;209
28;Normandie;27;1;19;346;Houville-en-Vexin;235;4;239
28;Normandie;27;3;11;347;Huest;778;26;804
28;Normandie;27;1;18;348;Igoville;1747;26;1773
28;Normandie;27;2;17;349;Illeville-sur-Montfort;861;13;874
28;Normandie;27;3;22;350;Illiers-l'Évêque;1026;17;1043
28;Normandie;27;1;14;351;Incarville;1397;21;1418
28;Normandie;27;3;10;353;Irreville;467;8;475
28;Normandie;27;2;15;354;Iville;417;4;421
28;Normandie;27;3;20;355;Ivry-la-Bataille;2658;30;2688
28;Normandie;27;1;16;358;Jouy-sur-Eure;592;13;605
28;Normandie;27;2;06;359;Juignettes;224;1;225
28;Normandie;27;3;20;360;Jumelles;328;7;335
28;Normandie;27;2;03;361;La Lande-Saint-Léger;395;4;399
28;Normandie;27;2;04;363;Le Landin;223;7;230
28;Normandie;27;2;07;364;Launay;193;5;198
28;Normandie;27;1;21;365;Léry;2013;26;2039
28;Normandie;27;1;19;366;Letteguives;207;3;210
28;Normandie;27;2;03;367;Lieurey;1502;15;1517
28;Normandie;27;3;20;368;Lignerolles;342;9;351
28;Normandie;27;1;19;369;Lilly;77;2;79
28;Normandie;27;1;19;370;Lisors;319;9;328
28;Normandie;27;2;07;371;Livet-sur-Authou;161;1;162
28;Normandie;27;1;13;372;Longchamps;684;5;689
28;Normandie;27;1;19;373;Lorleau;105;1;106
28;Normandie;27;3;08;374;Louversey;522;15;537
28;Normandie;27;1;14;375;Louviers;18636;386;19022
28;Normandie;27;3;20;376;Louye;224;5;229
28;Normandie;27;1;19;377;Lyons-la-Forêt;709;6;715
28;Normandie;27;3;22;378;La Madeleine-de-Nonancourt;1139;24;1163
28;Normandie;27;1;19;379;Mainneville;445;8;453
28;Normandie;27;2;07;380;Malleville-sur-le-Bec;266;5;271
28;Normandie;27;2;02;381;Malouy;164;0;164
28;Normandie;27;2;15;382;Mandeville;317;9;326
28;Normandie;27;2;22;383;Mandres;367;12;379
28;Normandie;27;2;03;384;Manneville-la-Raoult;497;10;507
28;Normandie;27;2;17;385;Manneville-sur-Risle;1479;43;1522
28;Normandie;27;1;18;386;Le Manoir;1311;13;1324
28;Normandie;27;2;04;388;Marais-Vernier;475;10;485
28;Normandie;27;2;15;389;Marbeuf;471;6;477
28;Normandie;27;3;22;390;Marcilly-la-Campagne;1119;16;1135
28;Normandie;27;3;20;391;Marcilly-sur-Eure;1594;20;1614
28;Normandie;27;1;19;392;Martagny;146;3;149
28;Normandie;27;2;03;393;Martainville;501;6;507
28;Normandie;27;1;18;394;Martot;454;11;465
28;Normandie;27;2;06;395;Mélicourt;89;1;90
28;Normandie;27;1;19;396;Ménesqueville;465;9;474
28;Normandie;27;1;16;397;Ménilles;1738;41;1779
28;Normandie;27;2;02;398;Menneval;1525;106;1631
28;Normandie;27;1;16;399;Mercey;53;1;54
28;Normandie;27;1;16;400;Merey;339;5;344
28;Normandie;27;3;15;401;Le Mesnil-Fuguet;180;3;183
28;Normandie;27;1;18;403;Le Mesnil-Jourdain;236;12;248
28;Normandie;27;2;06;404;Mesnil-Rousset;88;4;92
28;Normandie;27;1;19;405;Mesnil-sous-Vienne;99;4;103
28;Normandie;27;3;20;406;Mesnil-sur-l'Estrée;912;23;935
28;Normandie;27;1;01;407;Mesnil-Verclives;332;9;341
28;Normandie;27;1;01;408;Mézières-en-Vexin;595;19;614
28;Normandie;27;3;11;410;Miserey;634;12;646
28;Normandie;27;3;22;411;Moisville;229;2;231
28;Normandie;27;1;18;412;Terres de Bord;1520;32;1552
28;Normandie;27;2;17;413;Montfort-sur-Risle;783;12;795
28;Normandie;27;2;06;414;Montreuil-l'Argillé;829;7;836
28;Normandie;27;2;03;415;Morainville-Jouveaux;368;7;375
28;Normandie;27;1;13;417;Morgny;673;12;685
28;Normandie;27;2;07;418;Morsan;111;3;114
28;Normandie;27;3;20;419;Mouettes;747;17;764
28;Normandie;27;1;13;420;Mouflaines;164;6;170
28;Normandie;27;3;20;421;Mousseaux-Neuville;634;13;647
28;Normandie;27;1;01;422;Muids;876;21;897
28;Normandie;27;3;20;423;Muzy;766;17;783
28;Normandie;27;3;08;424;Nagel-Séez-Mesnil;329;4;333
28;Normandie;27;2;07;425;Nassandres sur Risle;2366;40;2406
28;Normandie;27;1;13;426;Neaufles-Saint-Martin;1341;6;1347
28;Normandie;27;2;06;427;Neaufles-Auvergny;419;9;428
28;Normandie;27;2;15;428;Le Neubourg;4254;224;4478
28;Normandie;27;1;16;429;Neuilly;186;0;186
28;Normandie;27;1;13;430;La Neuve-Grange;358;4;362
28;Normandie;27;2;06;431;La Neuve-Lyre;580;5;585
28;Normandie;27;2;07;432;La Neuville-du-Bosc;719;7;726
28;Normandie;27;2;07;433;Neuville-sur-Authou;194;2;196
28;Normandie;27;2;03;434;Noards;54;0;54
28;Normandie;27;2;03;435;La Noë-Poulain;274;5;279
28;Normandie;27;3;08;436;Nogent-le-Sec;441;6;447
28;Normandie;27;1;13;437;Nojeon-en-Vexin;341;6;347
28;Normandie;27;3;22;438;Nonancourt;2260;41;2301
28;Normandie;27;3;10;439;Normanville;1105;25;1130
28;Normandie;27;1;01;440;Notre-Dame-de-l'Isle;653;22;675
28;Normandie;27;2;07;441;Notre-Dame-d'Épine;71;1;72
28;Normandie;27;2;06;442;Notre-Dame-du-Hamel;194;7;201
28;Normandie;27;2;02;444;Le Noyer-en-Ouche;231;1;232
28;Normandie;27;1;13;445;Noyers;248;4;252
28;Normandie;27;3;08;446;Ormes;479;3;482
28;Normandie;27;3;08;447;Le Val-Doré;888;55;943
28;Normandie;27;1;16;448;Pacy-sur-Eure;5042;126;5168
28;Normandie;27;3;08;451;Parville;291;6;297
28;Normandie;27;1;19;453;Perriers-sur-Andelle;1801;21;1822
28;Normandie;27;1;19;454;Perruel;463;7;470
28;Normandie;27;2;03;455;Piencourt;166;3;169
28;Normandie;27;1;18;456;Pinterville;767;18;785
28;Normandie;27;2;22;457;Piseux;694;12;706
28;Normandie;27;1;18;458;Pîtres;2620;25;2645
28;Normandie;27;2;03;459;Les Places;71;2;73
28;Normandie;27;2;02;460;Plainville;205;5;210
28;Normandie;27;2;03;462;Le Planquay;166;1;167
28;Normandie;27;2;02;463;Plasnes;724;18;742
28;Normandie;27;3;11;464;Le Plessis-Grohan;919;19;938
28;Normandie;27;1;16;465;Le Plessis-Hébert;399;13;412
28;Normandie;27;2;07;466;Le Plessis-Sainte-Opportune;341;5;346
28;Normandie;27;2;17;467;Pont-Audemer;9891;261;10152
28;Normandie;27;2;17;468;Pont-Authou;589;9;598
28;Normandie;27;1;18;469;Pont-de-l'Arche;4139;51;4190
28;Normandie;27;1;19;470;Pont-Saint-Pierre;1137;22;1159
28;Normandie;27;1;21;471;Porte-de-Seine;207;5;212
28;Normandie;27;3;08;472;Portes;271;6;277
28;Normandie;27;1;01;473;Port-Mort;903;21;924
28;Normandie;27;1;21;474;Poses;1143;19;1162
28;Normandie;27;2;03;475;La Poterie-Mathieu;164;1;165
28;Normandie;27;2;17;476;Les Préaux;393;8;401
28;Normandie;27;1;01;477;Pressagny-l'Orgueilleux;696;16;712
28;Normandie;27;3;20;478;Prey;968;25;993
28;Normandie;27;1;13;480;Puchay;640;19;659
28;Normandie;27;2;22;481;Pullay;401;54;455
28;Normandie;27;2;15;482;La Pyle;168;4;172
28;Normandie;27;1;18;483;Quatremare;437;3;440
28;Normandie;27;2;04;485;Quillebeuf-sur-Seine;826;9;835
28;Normandie;27;2;15;486;Quittebeuf;650;19;669
28;Normandie;27;1;19;487;Radepont;655;3;658
28;Normandie;27;1;19;488;Renneville;191;6;197
28;Normandie;27;3;10;489;Reuilly;519;13;532
28;Normandie;27;1;13;490;Richeville;267;4;271
28;Normandie;27;2;07;492;Romilly-la-Puthenaye;321;11;332
28;Normandie;27;1;19;493;Romilly-sur-Andelle;3268;43;3311
28;Normandie;27;1;01;495;La Roquette;239;2;241
28;Normandie;27;1;19;496;Rosay-sur-Lieure;510;6;516
28;Normandie;27;2;04;497;Rougemontiers;1038;17;1055
28;Normandie;27;2;07;498;Rouge-Perriers;365;4;369
28;Normandie;27;2;04;500;Routot;1699;56;1755
28;Normandie;27;1;16;501;Rouvray;260;6;266
28;Normandie;27;2;06;502;Rugles;2204;27;2231
28;Normandie;27;3;15;504;Sacquenville;1261;37;1298
28;Normandie;27;2;06;505;Saint-Agnan-de-Cernières;166;1;167
28;Normandie;27;3;20;507;Saint-André-de-l'Eure;4055;66;4121
28;Normandie;27;2;06;508;Saint-Antonin-de-Sommaire;206;2;208
28;Normandie;27;2;15;511;Saint-Aubin-d'Écrosville;735;11;746
28;Normandie;27;2;03;512;Saint-Aubin-de-Scellon;335;7;342
28;Normandie;27;2;06;514;Saint-Aubin-du-Thenney;370;6;376
28;Normandie;27;2;02;516;Treis-Sants-en-Ouche;1386;34;1420
28;Normandie;27;1;12;517;Saint-Aubin-sur-Gaillon;2171;49;2220
28;Normandie;27;2;04;518;Saint-Aubin-sur-Quillebeuf;758;14;772
28;Normandie;27;2;03;520;Saint-Benoît-des-Ombres;141;1;142
28;Normandie;27;2;22;521;Saint-Christophe-sur-Avre;136;6;142
28;Normandie;27;2;03;522;Saint-Christophe-sur-Condé;439;4;443
28;Normandie;27;2;15;524;Sainte-Colombe-la-Commanderie;879;7;886
28;Normandie;27;1;16;525;Sainte-Colombe-près-Vernon;299;18;317
28;Normandie;27;2;07;527;Saint-Cyr-de-Salerne;205;1;206
28;Normandie;27;1;21;528;Le Vaudreuil;3660;88;3748
28;Normandie;27;2;05;529;Saint-Cyr-la-Campagne;433;6;439
28;Normandie;27;2;06;530;Saint-Denis-d'Augerons;80;3;83
28;Normandie;27;2;05;531;Saint-Denis-des-Monts;204;4;208
28;Normandie;27;1;13;533;Saint-Denis-le-Ferment;491;19;510
28;Normandie;27;2;05;534;Saint-Didier-des-Bois;890;10;900
28;Normandie;27;3;08;535;Saint-Élier;427;11;438
28;Normandie;27;2;07;536;Saint-Éloi-de-Fourques;543;15;558
28;Normandie;27;1;14;537;Saint-Étienne-du-Vauvray;872;15;887
28;Normandie;27;2;03;538;Saint-Étienne-l'Allier;541;9;550
28;Normandie;27;1;12;539;Saint-Étienne-sous-Bailleul;386;6;392
28;Normandie;27;1;23;540;Sainte-Geneviève-lès-Gasny;660;12;672
28;Normandie;27;2;03;541;Le Mesnil-Saint-Jean;202;5;207
28;Normandie;27;2;03;542;Saint-Georges-du-Vièvre;889;12;901
28;Normandie;27;3;20;543;Saint-Georges-Motel;879;11;890
28;Normandie;27;3;20;544;Saint-Germain-de-Fresney;202;5;207
28;Normandie;27;2;05;545;Saint-Germain-de-Pasquier;122;0;122
28;Normandie;27;3;10;546;Saint-Germain-des-Angles;168;2;170
28;Normandie;27;2;03;547;Saint-Germain-la-Campagne;864;21;885
28;Normandie;27;3;22;548;Saint-Germain-sur-Avre;1179;25;1204
28;Normandie;27;2;03;550;Saint-Grégoire-du-Vièvre;307;7;314
28;Normandie;27;2;06;552;Saint-Jean-du-Thenney;237;6;243
28;Normandie;27;1;12;553;Saint-Julien-de-la-Liègue;418;2;420
28;Normandie;27;1;16;554;La Chapelle-Longueville;3319;105;3424
28;Normandie;27;3;20;555;Saint-Laurent-des-Bois;246;5;251
28;Normandie;27;2;06;556;Saint-Laurent-du-Tencement;65;0;65
28;Normandie;27;2;02;557;Saint-Léger-de-Rôtes;466;6;472
28;Normandie;27;2;05;558;Saint-Léger-du-Gennetey;177;6;183
28;Normandie;27;3;11;560;Saint-Luc;249;12;261
28;Normandie;27;2;03;561;Saint-Maclou;658;11;669
28;Normandie;27;1;16;562;Saint-Marcel;4412;135;4547
28;Normandie;27;2;17;563;Saint-Mards-de-Blacarville;831;23;854
28;Normandie;27;2;03;564;Saint-Mards-de-Fresne;334;5;339
28;Normandie;27;2;06;565;Le Lesme;684;9;693
28;Normandie;27;1;13;567;Sainte-Marie-de-Vatimesnil;280;6;286
28;Normandie;27;3;08;568;Sainte-Marthe;496;8;504
28;Normandie;27;2;02;569;Saint-Martin-du-Tilleul;247;10;257
28;Normandie;27;3;15;570;Saint-Martin-la-Campagne;102;2;104
28;Normandie;27;2;03;571;Saint-Martin-Saint-Firmin;336;11;347
28;Normandie;27;2;15;572;Saint-Meslin-du-Bosc;299;4;303
28;Normandie;27;2;07;576;Sainte-Opportune-du-Bosc;647;15;662
28;Normandie;27;2;04;577;Sainte-Opportune-la-Mare;435;11;446
28;Normandie;27;2;06;578;Sainte-Marie-d'Attez;591;12;603
28;Normandie;27;2;05;579;Saint-Ouen-de-Pontcheuil;101;2;103
28;Normandie;27;2;04;580;Saint-Ouen-de-Thouberville;2452;29;2481
28;Normandie;27;2;05;582;Saint-Ouen-du-Tilleul;1747;16;1763
28;Normandie;27;2;07;584;Saint-Paul-de-Fourques;277;9;286
28;Normandie;27;2;05;586;Saint-Philbert-sur-Boissey;173;1;174
28;Normandie;27;2;17;587;Saint-Philbert-sur-Risle;789;6;795
28;Normandie;27;1;12;589;Saint-Pierre-de-Bailleul;977;32;1009
28;Normandie;27;2;06;590;Saint-Pierre-de-Cernières;239;4;243
28;Normandie;27;2;03;591;Saint-Pierre-de-Cormeilles;589;11;600
28;Normandie;27;2;07;592;Saint-Pierre-de-Salerne;244;3;247
28;Normandie;27;2;05;593;Saint-Pierre-des-Fleurs;1634;22;1656
28;Normandie;27;2;03;594;Saint-Pierre-des-Ifs;272;3;275
28;Normandie;27;2;05;595;Saint-Pierre-du-Bosguérard;995;19;1014
28;Normandie;27;2;03;597;Saint-Pierre-du-Val;589;1;590
28;Normandie;27;1;14;598;Saint-Pierre-du-Vauvray;1240;22;1262
28;Normandie;27;1;12;599;Saint-Pierre-la-Garenne;918;10;928
28;Normandie;27;2;04;601;Saint-Samson-de-la-Roque;431;12;443
28;Normandie;27;3;09;602;Saint-Sébastien-de-Morsent;5561;167;5728
28;Normandie;27;2;03;603;Saint-Siméon;310;6;316
28;Normandie;27;2;03;604;Saint-Sulpice-de-Grimbouville;154;2;156
28;Normandie;27;2;03;605;Saint-Sylvestre-de-Cormeilles;229;4;233
28;Normandie;27;2;17;606;Saint-Symphorien;482;4;486
28;Normandie;27;2;02;608;Saint-Victor-de-Chrétienville;444;9;453
28;Normandie;27;2;07;609;Saint-Victor-d'Épine;339;6;345
28;Normandie;27;2;22;610;Saint-Victor-sur-Avre;55;1;56
28;Normandie;27;3;10;611;Saint-Vigor;316;10;326
28;Normandie;27;1;16;612;Saint-Vincent-des-Bois;335;9;344
28;Normandie;27;2;03;613;Saint-Vincent-du-Boulay;376;5;381
28;Normandie;27;1;13;614;Sancourt;173;2;175
28;Normandie;27;3;11;615;Sassey;194;5;199
28;Normandie;27;2;05;616;La Saussaye;1889;53;1942
28;Normandie;27;1;13;617;Saussay-la-Campagne;530;9;539
28;Normandie;27;3;08;618;Sébécourt;465;11;476
28;Normandie;27;2;17;620;Selles;468;2;470
28;Normandie;27;3;20;621;Serez;172;5;177
28;Normandie;27;2;02;622;Serquigny;1793;45;1838
28;Normandie;27;1;18;623;Surtauville;491;14;505
28;Normandie;27;1;18;624;Surville;877;23;900
28;Normandie;27;1;01;625;Suzay;354;6;360
28;Normandie;27;2;03;627;Le Theil-Nolent;243;12;255
28;Normandie;27;2;03;629;Thiberville;1781;22;1803
28;Normandie;27;2;07;630;Thibouville;321;32;353
28;Normandie;27;2;17;631;Thierville;371;4;375
28;Normandie;27;1;13;632;Le Thil;596;8;604
28;Normandie;27;1;13;633;Les Thilliers-en-Vexin;497;4;501
28;Normandie;27;1;01;635;Le Thuit;141;1;142
28;Normandie;27;2;05;638;Le Thuit de l'Oison;3734;55;3789
28;Normandie;27;3;08;640;Tilleul-Dame-Agnès;190;4;194
28;Normandie;27;2;15;641;Le Tilleul-Lambert;262;5;267
28;Normandie;27;2;22;643;Tillières-sur-Avre;1059;16;1075
28;Normandie;27;1;01;644;Tilly;566;41;607
28;Normandie;27;2;04;645;Tocqueville;155;4;159
28;Normandie;27;2;03;646;Le Torpt;443;5;448
28;Normandie;27;1;19;649;Touffreville;353;7;360
28;Normandie;27;2;15;650;Tournedos-Bois-Hubert;464;8;472
28;Normandie;27;3;15;652;Tourneville;305;8;313
28;Normandie;27;2;05;654;Tourville-la-Campagne;1127;12;1139
28;Normandie;27;2;17;655;Tourville-sur-Pont-Audemer;731;160;891
28;Normandie;27;2;17;656;Toutainville;1294;32;1326
28;Normandie;27;2;15;658;Le Tremblay-Omonville;369;9;378
28;Normandie;27;3;11;659;La Trinité;127;6;133
28;Normandie;27;2;06;660;La Trinité-de-Réville;236;2;238
28;Normandie;27;2;04;661;La Trinité-de-Thouberville;424;9;433
28;Normandie;27;2;17;662;Triqueville;336;5;341
28;Normandie;27;2;15;663;Le Troncq;169;4;173
28;Normandie;27;1;19;664;Le Tronquay;516;8;524
28;Normandie;27;2;04;665;Trouville-la-Haule;756;13;769
28;Normandie;27;1;18;666;La Vacherie;570;19;589
28;Normandie;27;2;02;667;Valailles;392;11;403
28;Normandie;27;3;11;668;Le Val-David;690;11;701
28;Normandie;27;2;04;669;Valletot;431;8;439
28;Normandie;27;1;19;670;Vandrimare;966;18;984
28;Normandie;27;2;03;671;Vannecrocq;163;0;163
28;Normandie;27;1;19;672;Vascœuil;355;1;356
28;Normandie;27;1;01;673;Vatteville;176;4;180
28;Normandie;27;1;16;674;Vaux-sur-Eure;268;10;278
28;Normandie;27;2;15;677;Venon;405;6;411
28;Normandie;27;3;08;678;Les Ventes;1043;23;1066
28;Normandie;27;2;86;679;Verneuil d'Avre et d'Iton;7374;343;7717
28;Normandie;27;2;06;680;Verneusses;189;6;195
28;Normandie;27;1;23;681;Vernon;24056;622;24678
28;Normandie;27;1;13;682;Vesly;639;16;655
28;Normandie;27;1;01;683;Vézillon;231;3;234
28;Normandie;27;3;11;684;Le Vieil-Évreux;838;11;849
28;Normandie;27;2;06;685;La Vieille-Lyre;663;19;682
28;Normandie;27;2;04;686;Vieux-Port;48;0;48
28;Normandie;27;1;16;689;Villegats;350;17;367
28;Normandie;27;1;13;690;Villers-en-Vexin;312;7;319
28;Normandie;27;1;12;691;Villers-sur-le-Roule;865;19;884
28;Normandie;27;2;15;692;Villettes;164;7;171
28;Normandie;27;2;22;693;Sylvains-Lès-Moulins;1299;32;1331
28;Normandie;27;1;16;694;Villez-sous-Bailleul;319;15;334
28;Normandie;27;2;15;695;Villez-sur-le-Neubourg;265;11;276
28;Normandie;27;1;16;696;Villiers-en-Désœuvre;908;22;930
28;Normandie;27;1;14;697;Vironvay;329;17;346
28;Normandie;27;2;15;698;Vitot;564;13;577
28;Normandie;27;2;05;699;Voiscreville;118;3;121
28;Normandie;27;2;15;700;Vraiville;727;14;741
28;Normandie;27;1;21;701;Val-de-Reuil;12702;286;12988
24;Centre-Val de Loire;28;3;01;001;Abondant;2409;46;2455
24;Centre-Val de Loire;28;3;08;003;Allainville;141;4;145
24;Centre-Val de Loire;28;1;15;004;Allonnes;316;3;319
24;Centre-Val de Loire;28;2;07;005;Alluyes;751;87;838
24;Centre-Val de Loire;28;1;12;006;Amilly;1809;47;1856
24;Centre-Val de Loire;28;3;01;007;Anet;2689;104;2793
24;Centre-Val de Loire;28;3;14;008;Ardelles;208;2;210
24;Centre-Val de Loire;28;1;02;009;Ardelu;71;1;72
24;Centre-Val de Loire;28;4;13;010;Argenvilliers;323;8;331
24;Centre-Val de Loire;28;2;03;012;Commune nouvelle d'Arrou;3580;59;3639
24;Centre-Val de Loire;28;1;02;013;Aunay-sous-Auneau;1565;24;1589
24;Centre-Val de Loire;28;3;08;014;Aunay-sous-Crécy;686;7;693
24;Centre-Val de Loire;28;1;02;015;Auneau-Bleury-Saint-Symphorien;6230;94;6324
24;Centre-Val de Loire;28;4;03;016;Les Autels-Villevillon;118;6;124
24;Centre-Val de Loire;28;4;03;018;Authon-du-Perche;1492;16;1508
24;Centre-Val de Loire;28;2;15;019;Baigneaux;204;3;207
24;Centre-Val de Loire;28;1;11;021;Bailleau-le-Pin;1597;30;1627
24;Centre-Val de Loire;28;1;06;022;Bailleau-l'Évêque;1146;31;1177
24;Centre-Val de Loire;28;1;02;023;Bailleau-Armenonville;1367;26;1393
24;Centre-Val de Loire;28;1;12;024;Barjouville;1780;61;1841
24;Centre-Val de Loire;28;1;15;025;Barmainville;100;2;102
24;Centre-Val de Loire;28;1;15;026;Baudreville;243;0;243
24;Centre-Val de Loire;28;4;03;027;La Bazoche-Gouet;1223;20;1243
24;Centre-Val de Loire;28;2;15;028;Bazoches-en-Dunois;260;4;264
24;Centre-Val de Loire;28;2;15;029;Bazoches-les-Hautes;322;6;328
24;Centre-Val de Loire;28;3;14;030;Beauche;278;5;283
24;Centre-Val de Loire;28;4;03;031;Beaumont-les-Autels;386;111;497
24;Centre-Val de Loire;28;1;15;032;Beauvilliers;343;4;347
24;Centre-Val de Loire;28;4;13;033;Belhomert-Guéhouville;797;32;829
24;Centre-Val de Loire;28;1;04;034;Berchères-Saint-Germain;890;13;903
24;Centre-Val de Loire;28;1;05;035;Berchères-les-Pierres;969;23;992
24;Centre-Val de Loire;28;3;01;036;Berchères-sur-Vesgre;842;21;863
24;Centre-Val de Loire;28;3;14;037;Bérou-la-Mulotière;337;4;341
24;Centre-Val de Loire;28;4;03;038;Béthonvilliers;118;4;122
24;Centre-Val de Loire;28;1;02;039;Béville-le-Comte;1670;32;1702
24;Centre-Val de Loire;28;1;11;040;Billancelles;320;9;329
24;Centre-Val de Loire;28;1;11;041;Blandainville;278;4;282
24;Centre-Val de Loire;28;3;08;045;Boissy-en-Drouais;228;6;234
24;Centre-Val de Loire;28;3;14;046;Boissy-lès-Perche;480;8;488
24;Centre-Val de Loire;28;1;15;047;Boisville-la-Saint-Père;718;15;733
24;Centre-Val de Loire;28;1;05;048;La Bourdinière-Saint-Loup;744;14;758
24;Centre-Val de Loire;28;1;15;049;Boncé;244;5;249
24;Centre-Val de Loire;28;3;01;050;Boncourt;268;6;274
24;Centre-Val de Loire;28;2;07;051;Bonneval;4841;101;4942
24;Centre-Val de Loire;28;1;10;052;Bouglainval;746;15;761
24;Centre-Val de Loire;28;3;14;053;Le Boullay-les-Deux-Églises;246;3;249
24;Centre-Val de Loire;28;3;09;054;Le Boullay-Mivoye;506;10;516
24;Centre-Val de Loire;28;3;09;055;Le Boullay-Thierry;563;9;572
24;Centre-Val de Loire;28;3;01;056;Boutigny-Prouais;1676;45;1721
24;Centre-Val de Loire;28;2;15;057;Bouville;598;9;607
24;Centre-Val de Loire;28;3;09;058;Bréchamps;363;4;367
24;Centre-Val de Loire;28;3;14;059;Brezolles;1814;26;1840
24;Centre-Val de Loire;28;1;04;060;Briconville;264;4;268
24;Centre-Val de Loire;28;2;03;061;Brou;3265;37;3302
24;Centre-Val de Loire;28;3;01;062;Broué;904;15;919
24;Centre-Val de Loire;28;3;01;064;Bû;2026;51;2077
24;Centre-Val de Loire;28;2;15;065;Bullainville;107;5;112
24;Centre-Val de Loire;28;1;11;067;Cernay;89;2;91
24;Centre-Val de Loire;28;1;04;068;Challet;431;12;443
24;Centre-Val de Loire;28;1;04;070;Champhol;3737;111;3848
24;Centre-Val de Loire;28;4;13;071;Champrond-en-Gâtine;702;3;705
24;Centre-Val de Loire;28;4;13;072;Champrond-en-Perchet;405;12;417
24;Centre-Val de Loire;28;1;02;073;Champseru;344;5;349
24;Centre-Val de Loire;28;1;02;074;La Chapelle-d'Aunainville;247;4;251
24;Centre-Val de Loire;28;2;07;075;La Chapelle-du-Noyer;1014;180;1194
24;Centre-Val de Loire;28;3;01;076;La Chapelle-Forainvilliers;196;3;199
24;Centre-Val de Loire;28;3;14;077;La Chapelle-Fortin;169;4;173
24;Centre-Val de Loire;28;4;03;078;Chapelle-Guillaume;184;4;188
24;Centre-Val de Loire;28;4;03;079;Chapelle-Royale;296;4;300
24;Centre-Val de Loire;28;4;03;080;Charbonnières;255;3;258
24;Centre-Val de Loire;28;1;11;081;Charonville;302;5;307
24;Centre-Val de Loire;28;3;09;082;Charpont;646;14;660
24;Centre-Val de Loire;28;1;10;084;Chartainvilliers;690;22;712
24;Centre-Val de Loire;28;1;98;085;Chartres;38443;1068;39511
24;Centre-Val de Loire;28;4;13;086;Chassant;320;8;328
24;Centre-Val de Loire;28;3;14;087;Châtaincourt;240;4;244
24;Centre-Val de Loire;28;2;07;088;Châteaudun;12949;310;13259
24;Centre-Val de Loire;28;3;14;089;Châteauneuf-en-Thymerais;2614;33;2647
24;Centre-Val de Loire;28;3;14;090;Les Châtelets;107;3;110
24;Centre-Val de Loire;28;1;11;091;Les Châtelliers-Notre-Dame;146;3;149
24;Centre-Val de Loire;28;1;02;092;Châtenay;230;6;236
24;Centre-Val de Loire;28;3;09;094;Chaudon;1662;27;1689
24;Centre-Val de Loire;28;1;11;095;Chauffours;281;6;287
24;Centre-Val de Loire;28;3;01;096;La Chaussée-d'Ivry;1264;19;1283
24;Centre-Val de Loire;28;3;01;098;Cherisy;1829;48;1877
24;Centre-Val de Loire;28;1;11;099;Chuisnes;1096;21;1117
24;Centre-Val de Loire;28;1;12;100;Cintray;452;6;458
24;Centre-Val de Loire;28;1;04;102;Clévilliers;716;9;725
24;Centre-Val de Loire;28;2;03;103;Cloyes-les-Trois-Rivières;5618;106;5724
24;Centre-Val de Loire;28;1;04;104;Coltainville;911;28;939
24;Centre-Val de Loire;28;4;13;105;Combres;552;6;558
24;Centre-Val de Loire;28;2;07;106;Conie-Molitard;400;11;411
24;Centre-Val de Loire;28;1;05;107;Corancez;356;9;365
24;Centre-Val de Loire;28;2;15;108;Cormainville;231;8;239
24;Centre-Val de Loire;28;4;13;109;Les Corvées-les-Yys;319;5;324
24;Centre-Val de Loire;28;1;05;110;Le Coudray;4042;118;4160
24;Centre-Val de Loire;28;4;03;111;Coudray-au-Perche;366;13;379
24;Centre-Val de Loire;28;3;10;113;Coulombs;1337;32;1369
24;Centre-Val de Loire;28;2;15;114;Courbehaye;135;0;135
24;Centre-Val de Loire;28;1;11;116;Courville-sur-Eure;2812;62;2874
24;Centre-Val de Loire;28;3;08;117;Crécy-Couvé;266;9;275
24;Centre-Val de Loire;28;3;09;118;Croisilles;426;15;441
24;Centre-Val de Loire;28;4;13;119;La Croix-du-Perche;148;2;150
24;Centre-Val de Loire;28;3;14;120;Crucey-Villages;449;2;451
24;Centre-Val de Loire;28;2;15;121;Dambron;110;0;110
24;Centre-Val de Loire;28;1;05;122;Dammarie;1499;23;1522
24;Centre-Val de Loire;28;2;03;123;Dampierre-sous-Brou;449;5;454
24;Centre-Val de Loire;28;3;14;124;Dampierre-sur-Avre;746;18;764
24;Centre-Val de Loire;28;2;07;126;Dancy;199;4;203
24;Centre-Val de Loire;28;2;07;127;Dangeau;1250;26;1276
24;Centre-Val de Loire;28;1;11;128;Dangers;434;6;440
24;Centre-Val de Loire;28;1;02;129;Denonville;775;21;796
24;Centre-Val de Loire;28;3;14;130;Digny;996;13;1009
24;Centre-Val de Loire;28;2;07;132;Donnemain-Saint-Mamès;662;16;678
24;Centre-Val de Loire;28;3;99;134;Dreux;30744;495;31239
24;Centre-Val de Loire;28;1;10;135;Droue-sur-Drouette;1208;57;1265
24;Centre-Val de Loire;28;3;09;136;Écluzelles;164;1;165
24;Centre-Val de Loire;28;1;02;137;Écrosnes;829;17;846
24;Centre-Val de Loire;28;1;11;139;Épeautrolles;184;1;185
24;Centre-Val de Loire;28;1;10;140;Épernon;5601;68;5669
24;Centre-Val de Loire;28;1;11;141;Ermenonville-la-Grande;319;11;330
24;Centre-Val de Loire;28;1;11;142;Ermenonville-la-Petite;182;2;184
24;Centre-Val de Loire;28;3;14;143;Escorpain;245;3;248
24;Centre-Val de Loire;28;4;03;144;Les Étilleux;206;7;213
24;Centre-Val de Loire;28;3;10;146;Faverolles;852;9;861
24;Centre-Val de Loire;28;3;14;147;Favières;609;10;619
24;Centre-Val de Loire;28;1;11;148;Le Favril;371;11;382
24;Centre-Val de Loire;28;3;14;149;La Ferté-Vidame;581;16;597
24;Centre-Val de Loire;28;3;14;151;Fessanvilliers-Mattanvilliers;176;5;181
24;Centre-Val de Loire;28;2;07;153;Flacey;207;6;213
24;Centre-Val de Loire;28;1;11;154;Fontaine-la-Guyon;1699;33;1732
24;Centre-Val de Loire;28;3;14;155;Fontaine-les-Ribouts;199;5;204
24;Centre-Val de Loire;28;4;13;156;Fontaine-Simon;894;16;910
24;Centre-Val de Loire;28;2;15;157;Fontenay-sur-Conie;130;3;133
24;Centre-Val de Loire;28;1;12;158;Fontenay-sur-Eure;1127;28;1155
24;Centre-Val de Loire;28;3;14;159;La Framboisière;346;4;350
24;Centre-Val de Loire;28;1;02;160;Francourville;864;8;872
24;Centre-Val de Loire;28;4;03;161;Frazé;499;7;506
24;Centre-Val de Loire;28;1;05;162;Fresnay-le-Comte;294;5;299
24;Centre-Val de Loire;28;1;04;163;Fresnay-le-Gilmert;215;3;218
24;Centre-Val de Loire;28;1;15;164;Fresnay-l'Évêque;737;10;747
24;Centre-Val de Loire;28;4;11;166;Friaize;255;2;257
24;Centre-Val de Loire;28;1;11;167;Fruncé;382;7;389
24;Centre-Val de Loire;28;1;02;168;Gallardon;3641;66;3707
24;Centre-Val de Loire;28;1;02;169;Garancières-en-Beauce;225;7;232
24;Centre-Val de Loire;28;3;08;170;Garancières-en-Drouais;283;6;289
24;Centre-Val de Loire;28;3;08;171;Garnay;943;22;965
24;Centre-Val de Loire;28;1;10;172;Gas;774;16;790
24;Centre-Val de Loire;28;1;04;173;Gasville-Oisème;1489;33;1522
24;Centre-Val de Loire;28;4;13;175;La Gaudaine;177;3;180
24;Centre-Val de Loire;28;2;15;176;Le Gault-Saint-Denis;680;13;693
24;Centre-Val de Loire;28;1;05;177;Gellainville;751;14;765
24;Centre-Val de Loire;28;3;01;178;Germainville;325;6;331
24;Centre-Val de Loire;28;3;01;180;Gilles;491;13;504
24;Centre-Val de Loire;28;2;03;182;Gohory;316;2;318
24;Centre-Val de Loire;28;1;15;183;Gommerville;682;13;695
24;Centre-Val de Loire;28;1;15;184;Gouillons;341;4;345
24;Centre-Val de Loire;28;3;01;185;Goussainville;1307;21;1328
24;Centre-Val de Loire;28;3;01;187;Guainville;661;14;675
24;Centre-Val de Loire;28;1;02;188;Le Gué-de-Longroi;948;16;964
24;Centre-Val de Loire;28;1;15;189;Guilleville;178;4;182
24;Centre-Val de Loire;28;2;15;190;Guillonville;459;13;472
24;Centre-Val de Loire;28;1;10;191;Hanches;2675;57;2732
24;Centre-Val de Loire;28;4;13;192;Happonvilliers;319;3;322
24;Centre-Val de Loire;28;3;01;193;Havelu;131;3;134
24;Centre-Val de Loire;28;1;02;194;Houville-la-Branche;403;16;419
24;Centre-Val de Loire;28;1;10;195;Houx;749;12;761
24;Centre-Val de Loire;28;1;11;196;Illiers-Combray;3237;50;3287
24;Centre-Val de Loire;28;1;15;197;Intréville;139;1;140
24;Centre-Val de Loire;28;2;07;198;Jallans;796;11;807
24;Centre-Val de Loire;28;1;15;199;Janville-en-Beauce;2541;44;2585
24;Centre-Val de Loire;28;3;14;200;Jaudrais;421;5;426
24;Centre-Val de Loire;28;1;04;201;Jouy;1970;44;2014
24;Centre-Val de Loire;28;3;14;202;Lamblore;325;6;331
24;Centre-Val de Loire;28;1;11;203;Landelles;641;6;647
24;Centre-Val de Loire;28;3;14;206;Laons;671;13;684
24;Centre-Val de Loire;28;1;02;207;Léthuin;233;3;236
24;Centre-Val de Loire;28;1;02;208;Levainville;378;14;392
24;Centre-Val de Loire;28;1;06;209;Lèves;5629;159;5788
24;Centre-Val de Loire;28;1;15;210;Levesville-la-Chenard;224;2;226
24;Centre-Val de Loire;28;2;07;211;Logron;577;7;584
24;Centre-Val de Loire;28;2;15;212;Loigny-la-Bataille;202;9;211
24;Centre-Val de Loire;28;3;10;213;Lormaye;676;11;687
24;Centre-Val de Loire;28;4;13;214;La Loupe;3327;81;3408
24;Centre-Val de Loire;28;1;15;215;Louville-la-Chenard;252;6;258
24;Centre-Val de Loire;28;3;08;216;Louvilliers-en-Drouais;204;1;205
24;Centre-Val de Loire;28;3;14;217;Louvilliers-lès-Perche;179;2;181
24;Centre-Val de Loire;28;1;12;218;Lucé;15525;209;15734
24;Centre-Val de Loire;28;4;03;219;Luigny;413;10;423
24;Centre-Val de Loire;28;1;12;220;Luisant;6686;313;6999
24;Centre-Val de Loire;28;2;15;221;Lumeau;135;7;142
24;Centre-Val de Loire;28;1;11;222;Luplanté;385;10;395
24;Centre-Val de Loire;28;3;09;223;Luray;1563;23;1586
24;Centre-Val de Loire;28;1;11;225;Magny;645;11;656
24;Centre-Val de Loire;28;3;14;226;Maillebois;896;15;911
24;Centre-Val de Loire;28;1;10;227;Maintenon;4494;78;4572
24;Centre-Val de Loire;28;1;06;229;Mainvilliers;11186;259;11445
24;Centre-Val de Loire;28;1;02;230;Maisons;384;7;391
24;Centre-Val de Loire;28;3;14;231;La Mancelière;169;4;173
24;Centre-Val de Loire;28;4;13;232;Manou;592;30;622
24;Centre-Val de Loire;28;2;07;233;Marboué;1156;26;1182
24;Centre-Val de Loire;28;1;11;234;Marchéville;476;8;484
24;Centre-Val de Loire;28;3;01;235;Marchezais;383;3;386
24;Centre-Val de Loire;28;4;13;236;Arcisses;2190;42;2232
24;Centre-Val de Loire;28;4;13;237;Marolles-les-Buis;207;4;211
24;Centre-Val de Loire;28;3;08;239;Marville-Moutiers-Brûlé;983;25;1008
24;Centre-Val de Loire;28;4;13;240;Meaucé;507;8;515
24;Centre-Val de Loire;28;1;11;242;Méréglise;101;1;102
24;Centre-Val de Loire;28;1;15;243;Mérouville;212;7;219
24;Centre-Val de Loire;28;1;11;245;Meslay-le-Grenet;367;9;376
24;Centre-Val de Loire;28;2;15;246;Meslay-le-Vidame;533;9;542
24;Centre-Val de Loire;28;3;01;247;Le Mesnil-Simon;570;15;585
24;Centre-Val de Loire;28;3;14;248;Le Mesnil-Thomas;332;5;337
24;Centre-Val de Loire;28;1;10;249;Mévoisins;617;14;631
24;Centre-Val de Loire;28;3;09;251;Mézières-en-Drouais;1063;27;1090
24;Centre-Val de Loire;28;4;03;252;Miermaigne;186;3;189
24;Centre-Val de Loire;28;1;05;253;Mignières;1091;82;1173
24;Centre-Val de Loire;28;1;11;254;Mittainvilliers-Vérigny;797;13;810
24;Centre-Val de Loire;28;1;02;255;Moinville-la-Jeulin;166;2;168
24;Centre-Val de Loire;28;2;07;256;Moléans;444;14;458
24;Centre-Val de Loire;28;1;02;257;Mondonville-Saint-Jean;87;2;89
24;Centre-Val de Loire;28;2;07;259;Montboissier;332;5;337
24;Centre-Val de Loire;28;2;07;260;Montharville;100;5;105
24;Centre-Val de Loire;28;4;03;261;Montigny-le-Chartif;597;12;609
24;Centre-Val de Loire;28;3;14;263;Montigny-sur-Avre;252;6;258
24;Centre-Val de Loire;28;4;13;264;Montireau;138;3;141
24;Centre-Val de Loire;28;4;13;265;Montlandon;258;2;260
24;Centre-Val de Loire;28;3;01;267;Montreuil;514;5;519
24;Centre-Val de Loire;28;1;02;268;Morainville;16;2;18
24;Centre-Val de Loire;28;1;05;269;Morancez;1908;58;1966
24;Centre-Val de Loire;28;2;07;270;Moriers;222;4;226
24;Centre-Val de Loire;28;3;14;271;Morvilliers;136;4;140
24;Centre-Val de Loire;28;2;03;272;Mottereau;154;3;157
24;Centre-Val de Loire;28;4;03;273;Moulhard;139;2;141
24;Centre-Val de Loire;28;1;15;274;Moutiers;238;6;244
24;Centre-Val de Loire;28;3;10;275;Néron;667;15;682
24;Centre-Val de Loire;28;1;15;276;Neuvy-en-Beauce;206;8;214
24;Centre-Val de Loire;28;2;15;277;Neuvy-en-Dunois;304;13;317
24;Centre-Val de Loire;28;1;05;278;Nogent-le-Phaye;1484;34;1518
24;Centre-Val de Loire;28;3;10;279;Nogent-le-Roi;3990;67;4057
24;Centre-Val de Loire;28;4;13;280;Nogent-le-Rotrou;9433;433;9866
24;Centre-Val de Loire;28;1;11;281;Nogent-sur-Eure;513;15;528
24;Centre-Val de Loire;28;4;13;282;Nonvilliers-Grandhoux;434;10;444
24;Centre-Val de Loire;28;2;15;283;Nottonville;283;5;288
24;Centre-Val de Loire;28;1;15;284;Oinville-Saint-Liphard;277;6;283
24;Centre-Val de Loire;28;1;02;285;Oinville-sous-Auneau;352;9;361
24;Centre-Val de Loire;28;1;11;286;Ollé;623;12;635
24;Centre-Val de Loire;28;2;15;287;Orgères-en-Beauce;1003;15;1018
24;Centre-Val de Loire;28;3;09;289;Ormoy;219;6;225
24;Centre-Val de Loire;28;1;11;290;Orrouer;284;9;293
24;Centre-Val de Loire;28;1;15;291;Ouarville;519;16;535
24;Centre-Val de Loire;28;3;09;292;Ouerre;751;14;765
24;Centre-Val de Loire;28;3;01;293;Oulins;1190;27;1217
24;Centre-Val de Loire;28;1;02;294;Oysonville;523;13;536
24;Centre-Val de Loire;28;2;15;296;Péronville;269;4;273
24;Centre-Val de Loire;28;1;10;298;Pierres;2768;47;2815
24;Centre-Val de Loire;28;3;10;299;Les Pinthières;166;6;172
24;Centre-Val de Loire;28;1;15;300;Poinville;160;6;166
24;Centre-Val de Loire;28;1;04;301;Poisvilliers;445;6;451
24;Centre-Val de Loire;28;1;11;302;Pontgouin;1095;319;1414
24;Centre-Val de Loire;28;2;15;303;Poupry;96;3;99
24;Centre-Val de Loire;28;1;15;304;Prasville;438;7;445
24;Centre-Val de Loire;28;2;15;305;Pré-Saint-Évroult;295;7;302
24;Centre-Val de Loire;28;2;15;306;Pré-Saint-Martin;191;3;194
24;Centre-Val de Loire;28;3;14;308;Prudemanche;261;11;272
24;Centre-Val de Loire;28;1;05;309;Prunay-le-Gillon;1077;16;1093
24;Centre-Val de Loire;28;3;14;310;La Puisaye;257;6;263
24;Centre-Val de Loire;28;3;14;312;Puiseux;128;2;130
24;Centre-Val de Loire;28;1;15;313;Réclainville;196;1;197
24;Centre-Val de Loire;28;3;14;314;Les Ressuintes;128;4;132
24;Centre-Val de Loire;28;3;14;315;Revercourt;22;1;23
24;Centre-Val de Loire;28;3;14;316;Rohaire;126;3;129
24;Centre-Val de Loire;28;1;02;317;Roinville;570;5;575
24;Centre-Val de Loire;28;1;15;319;Rouvray-Saint-Denis;343;11;354
24;Centre-Val de Loire;28;3;01;321;Rouvres;837;14;851
24;Centre-Val de Loire;28;3;14;322;Rueil-la-Gadelière;489;9;498
24;Centre-Val de Loire;28;3;14;323;Saint-Ange-et-Torçay;285;1;286
24;Centre-Val de Loire;28;1;11;324;Saint-Arnoult-des-Bois;886;22;908
24;Centre-Val de Loire;28;1;06;325;Saint-Aubin-des-Bois;1055;26;1081
24;Centre-Val de Loire;28;2;11;326;Saint-Avit-les-Guespières;358;2;360
24;Centre-Val de Loire;28;4;03;327;Saint-Bomer;191;2;193
24;Centre-Val de Loire;28;2;07;329;Saint-Christophe;158;2;160
24;Centre-Val de Loire;28;2;07;330;Villemaury;1350;32;1382
24;Centre-Val de Loire;28;4;13;331;Saintigny;949;19;968
24;Centre-Val de Loire;28;3;09;332;Sainte-Gemme-Moronval;1092;21;1113
24;Centre-Val de Loire;28;1;11;333;Saint-Denis-des-Puits;143;7;150
24;Centre-Val de Loire;28;2;07;334;Saint-Denis-Lanneray;2164;53;2217
24;Centre-Val de Loire;28;4;13;335;Saint-Éliph;843;24;867
24;Centre-Val de Loire;28;1;11;336;Saint-Éman;103;0;103
24;Centre-Val de Loire;28;1;11;337;Saint-Georges-sur-Eure;2789;59;2848
24;Centre-Val de Loire;28;1;11;339;Saint-Germain-le-Gaillard;369;11;380
24;Centre-Val de Loire;28;3;14;341;Saint-Jean-de-Rebervilliers;250;5;255
24;Centre-Val de Loire;28;4;13;342;Saint-Jean-Pierre-Fixte;265;5;270
24;Centre-Val de Loire;28;3;10;343;Saint-Laurent-la-Gâtine;448;11;459
24;Centre-Val de Loire;28;1;02;344;Saint-Léger-des-Aubées;266;11;277
24;Centre-Val de Loire;28;3;14;346;Saint-Lubin-de-Cravant;56;3;59
24;Centre-Val de Loire;28;3;01;347;Saint-Lubin-de-la-Haye;922;29;951
24;Centre-Val de Loire;28;3;14;348;Saint-Lubin-des-Joncherets;4041;69;4110
24;Centre-Val de Loire;28;3;10;349;Saint-Lucien;259;8;267
24;Centre-Val de Loire;28;1;11;350;Saint-Luperce;954;23;977
24;Centre-Val de Loire;28;3;14;351;Saint-Maixme-Hauterive;403;8;411
24;Centre-Val de Loire;28;1;10;352;Saint-Martin-de-Nigelles;1561;41;1602
24;Centre-Val de Loire;28;2;07;353;Saint-Maur-sur-le-Loir;401;5;406
24;Centre-Val de Loire;28;4;13;354;Saint-Maurice-Saint-Germain;423;69;492
24;Centre-Val de Loire;28;3;01;355;Saint-Ouen-Marchefroy;296;8;304
24;Centre-Val de Loire;28;1;10;357;Saint-Piat;1063;29;1092
24;Centre-Val de Loire;28;1;04;358;Saint-Prest;2093;64;2157
24;Centre-Val de Loire;28;3;14;359;Saint-Rémy-sur-Avre;4048;49;4097
24;Centre-Val de Loire;28;3;14;360;Saint-Sauveur-Marville;923;19;942
24;Centre-Val de Loire;28;4;13;362;Saint-Victor-de-Buthon;505;3;508
24;Centre-Val de Loire;28;1;02;363;Sainville;1021;13;1034
24;Centre-Val de Loire;28;2;15;364;Sancheville;758;11;769
24;Centre-Val de Loire;28;1;11;365;Sandarville;410;9;419
24;Centre-Val de Loire;28;1;02;366;Santeuil;320;3;323
24;Centre-Val de Loire;28;1;15;367;Santilly;322;0;322
24;Centre-Val de Loire;28;3;14;368;La Saucelle;202;3;205
24;Centre-Val de Loire;28;3;08;369;Saulnières;814;10;824
24;Centre-Val de Loire;28;2;07;370;Saumeray;492;14;506
24;Centre-Val de Loire;28;3;01;371;Saussay;1100;21;1121
24;Centre-Val de Loire;28;3;10;372;Senantes;558;11;569
24;Centre-Val de Loire;28;3;14;373;Senonches;3005;44;3049
24;Centre-Val de Loire;28;3;14;374;Serazereux;541;4;545
24;Centre-Val de Loire;28;3;01;375;Serville;367;8;375
24;Centre-Val de Loire;28;3;01;377;Sorel-Moussel;1740;43;1783
24;Centre-Val de Loire;28;4;13;378;Souancé-au-Perche;514;15;529
24;Centre-Val de Loire;28;1;10;379;Soulaires;474;10;484
24;Centre-Val de Loire;28;1;05;380;Sours;1973;155;2128
24;Centre-Val de Loire;28;2;15;382;Terminiers;882;12;894
24;Centre-Val de Loire;28;1;15;383;Theuville;706;6;712
24;Centre-Val de Loire;28;4;11;385;Le Thieulin;450;17;467
24;Centre-Val de Loire;28;3;14;386;Thimert-Gâtelles;1240;21;1261
24;Centre-Val de Loire;28;4;13;387;Thiron-Gardais;983;11;994
24;Centre-Val de Loire;28;1;05;388;Thivars;1048;32;1080
24;Centre-Val de Loire;28;2;07;389;Thiville;341;8;349
24;Centre-Val de Loire;28;2;15;390;Tillay-le-Péneux;307;6;313
24;Centre-Val de Loire;28;1;15;391;Toury;2580;32;2612
24;Centre-Val de Loire;28;1;15;392;Trancrainville;166;2;168
24;Centre-Val de Loire;28;3;14;393;Tremblay-les-Villages;2228;66;2294
24;Centre-Val de Loire;28;3;08;394;Tréon;1420;27;1447
24;Centre-Val de Loire;28;4;13;395;Trizay-Coutretot-Saint-Serge;432;14;446
24;Centre-Val de Loire;28;2;07;396;Trizay-lès-Bonneval;308;4;312
24;Centre-Val de Loire;28;1;02;397;Umpeau;409;13;422
24;Centre-Val de Loire;28;2;03;398;Unverre;1181;21;1202
24;Centre-Val de Loire;28;2;15;400;Varize;194;8;202
24;Centre-Val de Loire;28;4;13;401;Vaupillon;453;8;461
24;Centre-Val de Loire;28;1;05;403;Ver-lès-Chartres;763;21;784
24;Centre-Val de Loire;28;3;08;404;Vernouillet;12411;172;12583
24;Centre-Val de Loire;28;3;08;405;Vert-en-Drouais;1097;23;1120
24;Centre-Val de Loire;28;1;15;406;Éole-en-Beauce;1244;19;1263
24;Centre-Val de Loire;28;4;13;407;Vichères;290;8;298
24;Centre-Val de Loire;28;1;02;408;Vierville;116;3;119
24;Centre-Val de Loire;28;2;11;409;Vieuvicq;444;16;460
24;Centre-Val de Loire;28;2;07;410;Villampuy;302;4;306
24;Centre-Val de Loire;28;1;15;411;Villars;171;2;173
24;Centre-Val de Loire;28;1;11;414;Villebon;59;5;64
24;Centre-Val de Loire;28;3;09;415;Villemeux-sur-Eure;1692;32;1724
24;Centre-Val de Loire;28;3;10;417;Villiers-le-Morhier;1366;34;1400
24;Centre-Val de Loire;28;2;07;418;Villiers-Saint-Orien;163;5;168
24;Centre-Val de Loire;28;2;15;419;Vitray-en-Beauce;337;8;345
24;Centre-Val de Loire;28;1;02;421;Voise;267;3;270
24;Centre-Val de Loire;28;1;15;422;Les Villages Vovéens;3932;61;3993
24;Centre-Val de Loire;28;1;02;423;Yermenonville;599;15;614
24;Centre-Val de Loire;28;2;03;424;Yèvres;1635;32;1667
24;Centre-Val de Loire;28;1;02;425;Ymeray;564;11;575
24;Centre-Val de Loire;28;1;15;426;Ymonville;491;9;500
53;Bretagne;29;2;09;001;Argol;998;19;1017
53;Bretagne;29;4;25;002;Arzano;1397;29;1426
53;Bretagne;29;4;10;003;Audierne;3690;66;3756
53;Bretagne;29;4;16;004;Bannalec;5656;155;5811
53;Bretagne;29;4;25;005;Baye;1281;31;1312
53;Bretagne;29;4;11;006;Bénodet;3702;73;3775
53;Bretagne;29;2;07;007;Berrien;879;28;907
53;Bretagne;29;4;10;008;Beuzec-Cap-Sizun;1006;27;1033
53;Bretagne;29;3;14;010;Bodilis;1653;36;1689
53;Bretagne;29;1;04;011;Bohars;3559;91;3650
53;Bretagne;29;2;07;012;Bolazec;179;2;181
53;Bretagne;29;2;07;013;Botmeur;222;5;227
53;Bretagne;29;3;20;014;Botsorhel;431;9;440
53;Bretagne;29;1;18;015;Bourg-Blanc;3545;63;3608
53;Bretagne;29;2;07;016;Brasparts;1025;8;1033
53;Bretagne;29;1;27;017;Brélès;860;26;886
53;Bretagne;29;2;07;018;Brennilis;439;5;444
53;Bretagne;29;1;98;019;Brest;139456;2654;142110
53;Bretagne;29;4;06;020;Briec;5736;114;5850
53;Bretagne;29;1;15;021;Plounéour-Brignogan-plages;1926;54;1980
53;Bretagne;29;2;09;022;Camaret-sur-Mer;2462;54;2516
53;Bretagne;29;3;17;023;Carantec;3212;97;3309
53;Bretagne;29;2;07;024;Carhaix-Plouguer;7165;608;7773
53;Bretagne;29;2;09;025;Cast;1532;44;1576
53;Bretagne;29;2;09;026;Châteaulin;5156;422;5578
53;Bretagne;29;2;06;027;Châteauneuf-du-Faou;3650;91;3741
53;Bretagne;29;4;10;028;Cléden-Cap-Sizun;915;20;935
53;Bretagne;29;2;07;029;Cléden-Poher;1138;17;1155
53;Bretagne;29;3;26;030;Cléder;3635;111;3746
53;Bretagne;29;4;25;031;Clohars-Carnoët;4625;117;4742
53;Bretagne;29;4;11;032;Clohars-Fouesnant;2113;50;2163
53;Bretagne;29;2;06;033;Le Cloître-Pleyben;520;6;526
53;Bretagne;29;3;20;034;Le Cloître-Saint-Thégonnec;653;12;665
53;Bretagne;29;1;18;035;Coat-Méal;1121;19;1140
53;Bretagne;29;2;07;036;Collorec;603;9;612
53;Bretagne;29;4;19;037;Combrit;4236;128;4364
53;Bretagne;29;3;14;038;Commana;997;23;1020
53;Bretagne;29;4;08;039;Concarneau;20209;890;21099
53;Bretagne;29;1;27;040;Le Conquet;2768;76;2844
53;Bretagne;29;2;06;041;Coray;1887;33;1920
53;Bretagne;29;2;09;042;Crozon;7360;215;7575
53;Bretagne;29;1;21;043;Daoulas;1833;46;1879
53;Bretagne;29;2;09;044;Dinéault;1864;38;1902
53;Bretagne;29;1;21;045;Dirinon;2206;68;2274
53;Bretagne;29;4;10;046;Douarnenez;13956;423;14379
53;Bretagne;29;1;15;047;Le Drennec;1904;33;1937
53;Bretagne;29;4;06;048;Edern;2235;52;2287
53;Bretagne;29;4;08;049;Elliant;3328;143;3471
53;Bretagne;29;4;11;051;Ergué-Gabéric;8484;206;8690
53;Bretagne;29;2;21;053;Le Faou;1782;61;1843
53;Bretagne;29;2;07;054;La Feuillée;656;14;670
53;Bretagne;29;1;15;055;Le Folgoët;3239;77;3316
53;Bretagne;29;1;13;056;La Forest-Landerneau;1962;33;1995
53;Bretagne;29;4;11;057;La Forêt-Fouesnant;3459;124;3583
53;Bretagne;29;4;11;058;Fouesnant;10060;497;10557
53;Bretagne;29;3;20;059;Garlan;1052;32;1084
53;Bretagne;29;4;11;060;Gouesnach;2781;79;2860
53;Bretagne;29;1;04;061;Gouesnou;6281;112;6393
53;Bretagne;29;2;06;062;Gouézec;1104;25;1129
53;Bretagne;29;4;10;063;Goulien;430;7;437
53;Bretagne;29;1;15;064;Goulven;447;4;451
53;Bretagne;29;4;19;065;Gourlizon;924;11;935
53;Bretagne;29;4;23;066;Guengat;1824;30;1854
53;Bretagne;29;3;20;067;Guerlesquin;1286;41;1327
53;Bretagne;29;3;14;068;Guiclan;2529;48;2577
53;Bretagne;29;1;04;069;Guilers;8119;146;8265
53;Bretagne;29;4;19;070;Guiler-sur-Goyen;523;10;533
53;Bretagne;29;4;25;071;Guilligomarc'h;790;15;805
53;Bretagne;29;4;22;072;Guilvinec;2693;48;2741
53;Bretagne;29;3;20;073;Guimaëc;932;32;964
53;Bretagne;29;3;14;074;Guimiliau;1007;21;1028
53;Bretagne;29;1;12;075;Guipavas;15196;377;15573
53;Bretagne;29;1;27;076;Milizac-Guipronvel;4606;65;4671
53;Bretagne;29;1;15;077;Guissény;1983;47;2030
53;Bretagne;29;1;21;078;Hanvec;2036;41;2077
53;Bretagne;29;3;17;079;Henvic;1224;40;1264
53;Bretagne;29;1;21;080;Hôpital-Camfrout;2224;65;2289
53;Bretagne;29;2;07;081;Huelgoat;1405;26;1431
53;Bretagne;29;3;26;082;Île-de-Batz;450;12;462
53;Bretagne;29;4;10;083;Île-de-Sein;266;1;267
53;Bretagne;29;1;27;084;Île-Molène;162;5;167
53;Bretagne;29;4;19;085;Île-Tudy;737;18;755
53;Bretagne;29;1;21;086;Irvillac;1459;22;1481
53;Bretagne;29;4;10;087;Le Juch;725;16;741
53;Bretagne;29;2;07;089;Kergloff;852;22;874
53;Bretagne;29;4;10;090;Kerlaz;784;25;809
53;Bretagne;29;1;15;091;Kerlouan;2087;37;2124
53;Bretagne;29;1;15;093;Kernilis;1417;31;1448
53;Bretagne;29;1;15;094;Kernouës;651;14;665
53;Bretagne;29;1;18;095;Kersaint-Plabennec;1507;28;1535
53;Bretagne;29;3;14;097;Lampaul-Guimiliau;2023;49;2072
53;Bretagne;29;1;27;098;Lampaul-Plouarzel;2148;50;2198
53;Bretagne;29;1;18;099;Lampaul-Ploudalmézeau;825;21;846
53;Bretagne;29;1;15;100;Lanarvily;411;12;423
53;Bretagne;29;1;18;101;Landéda;3613;95;3708
53;Bretagne;29;2;07;102;Landeleau;963;13;976
53;Bretagne;29;1;13;103;Landerneau;16025;602;16627
53;Bretagne;29;2;09;104;Landévennec;342;8;350
53;Bretagne;29;3;14;105;Landivisiau;9204;318;9522
53;Bretagne;29;4;06;106;Landrévarzec;1855;42;1897
53;Bretagne;29;4;06;107;Landudal;888;14;902
53;Bretagne;29;4;19;108;Landudec;1490;39;1529
53;Bretagne;29;1;18;109;Landunvez;1487;37;1524
53;Bretagne;29;4;06;110;Langolen;854;14;868
53;Bretagne;29;3;26;111;Lanhouarneau;1317;22;1339
53;Bretagne;29;1;27;112;Lanildut;956;17;973
53;Bretagne;29;3;20;113;Lanmeur;2369;38;2407
53;Bretagne;29;3;20;114;Lannéanou;347;7;354
53;Bretagne;29;2;06;115;Lannédern;301;8;309
53;Bretagne;29;1;13;116;Lanneuffret;152;2;154
53;Bretagne;29;1;18;117;Lannilis;5694;114;5808
53;Bretagne;29;1;27;119;Lanrivoaré;1485;17;1502
53;Bretagne;29;2;09;120;Lanvéoc;1966;65;2031
53;Bretagne;29;2;06;122;Laz;683;15;698
53;Bretagne;29;2;06;123;Lennon;778;23;801
53;Bretagne;29;1;15;124;Lesneven;7285;221;7506
53;Bretagne;29;2;06;125;Leuhan;828;17;845
53;Bretagne;29;1;15;126;Loc-Brévalaire;208;7;215
53;Bretagne;29;3;14;128;Loc-Eguiner;396;5;401
53;Bretagne;29;1;27;130;Locmaria-Plouzané;5115;127;5242
53;Bretagne;29;3;14;131;Locmélar;472;12;484
53;Bretagne;29;3;17;132;Locquénolé;799;31;830
53;Bretagne;29;3;20;133;Locquirec;1521;43;1564
53;Bretagne;29;4;23;134;Locronan;790;25;815
53;Bretagne;29;4;22;135;Loctudy;3980;106;4086
53;Bretagne;29;4;25;136;Locunolé;1167;26;1193
53;Bretagne;29;1;21;137;Logonna-Daoulas;2120;49;2169
53;Bretagne;29;2;07;139;Lopérec;877;140;1017
53;Bretagne;29;1;21;140;Loperhet;3931;87;4018
53;Bretagne;29;2;07;141;Loqueffret;343;3;346
53;Bretagne;29;2;06;142;Lothey;463;4;467
53;Bretagne;29;4;10;143;Mahalon;971;21;992
53;Bretagne;29;1;21;144;La Martyre;757;9;766
53;Bretagne;29;4;10;145;Confort-Meilars;873;28;901
53;Bretagne;29;4;08;146;Melgven;3422;50;3472
53;Bretagne;29;4;25;147;Mellac;3303;81;3384
53;Bretagne;29;3;26;148;Mespaul;932;29;961
53;Bretagne;29;4;16;150;Moëlan-sur-Mer;6748;158;6906
53;Bretagne;29;3;17;151;Morlaix;14709;463;15172
53;Bretagne;29;2;07;152;Motreff;707;12;719
53;Bretagne;29;4;16;153;Névez;2694;54;2748
53;Bretagne;29;1;27;155;Ouessant;832;16;848
53;Bretagne;29;1;13;156;Pencran;2089;44;2133
53;Bretagne;29;4;22;158;Penmarch;5139;102;5241
53;Bretagne;29;4;19;159;Peumerit;865;18;883
53;Bretagne;29;1;18;160;Plabennec;8545;176;8721
53;Bretagne;29;4;11;161;Pleuven;3223;84;3307
53;Bretagne;29;2;06;162;Pleyben;3579;267;3846
53;Bretagne;29;3;17;163;Pleyber-Christ;3190;77;3267
53;Bretagne;29;4;22;165;Plobannalec-Lesconil;3615;82;3697
53;Bretagne;29;2;09;166;Ploéven;502;19;521
53;Bretagne;29;4;19;167;Plogastel-Saint-Germain;1989;43;2032
53;Bretagne;29;4;10;168;Plogoff;1230;19;1249
53;Bretagne;29;4;23;169;Plogonnec;3196;76;3272
53;Bretagne;29;4;23;170;Plomelin;4195;162;4357
53;Bretagne;29;4;19;171;Plomeur;3855;76;3931
53;Bretagne;29;2;09;172;Plomodiern;2245;68;2313
53;Bretagne;29;4;23;173;Plonéis;2449;60;2509
53;Bretagne;29;4;19;174;Plonéour-Lanvern;6300;185;6485
53;Bretagne;29;2;07;175;Plonévez-du-Faou;2130;44;2174
53;Bretagne;29;2;09;176;Plonévez-Porzay;1787;44;1831
53;Bretagne;29;1;27;177;Plouarzel;3924;93;4017
53;Bretagne;29;1;18;178;Ploudalmézeau;6333;132;6465
53;Bretagne;29;1;15;179;Ploudaniel;3750;118;3868
53;Bretagne;29;1;21;180;Ploudiry;894;22;916
53;Bretagne;29;1;13;181;Plouédern;3009;71;3080
53;Bretagne;29;3;20;182;Plouégat-Guérand;1061;23;1084
53;Bretagne;29;3;20;183;Plouégat-Moysan;716;14;730
53;Bretagne;29;3;26;184;Plouénan;2539;54;2593
53;Bretagne;29;3;26;185;Plouescat;3522;90;3612
53;Bretagne;29;3;20;186;Plouezoc'h;1620;59;1679
53;Bretagne;29;3;14;187;Plougar;794;27;821
53;Bretagne;29;3;20;188;Plougasnou;2724;120;2844
53;Bretagne;29;1;12;189;Plougastel-Daoulas;13277;360;13637
53;Bretagne;29;1;27;190;Plougonvelin;4299;97;4396
53;Bretagne;29;3;20;191;Plougonven;3432;93;3525
53;Bretagne;29;3;26;192;Plougoulm;1774;41;1815
53;Bretagne;29;3;14;193;Plougourvest;1449;29;1478
53;Bretagne;29;1;15;195;Plouguerneau;6633;127;6760
53;Bretagne;29;1;18;196;Plouguin;2173;42;2215
53;Bretagne;29;4;10;197;Plouhinec;3940;79;4019
53;Bretagne;29;1;15;198;Plouider;1824;45;1869
53;Bretagne;29;3;20;199;Plouigneau;5082;167;5249
53;Bretagne;29;1;27;201;Ploumoguer;2143;41;2184
53;Bretagne;29;3;17;202;Plounéour-Ménez;1296;35;1331
53;Bretagne;29;3;14;204;Plounéventer;2134;34;2168
53;Bretagne;29;2;07;205;Plounévézel;1171;25;1196
53;Bretagne;29;3;26;206;Plounévez-Lochrist;2297;94;2391
53;Bretagne;29;3;20;207;Plourin-lès-Morlaix;4510;291;4801
53;Bretagne;29;1;27;208;Plourin;1253;28;1281
53;Bretagne;29;1;18;209;Plouvien;3851;107;3958
53;Bretagne;29;3;14;210;Plouvorn;2879;72;2951
53;Bretagne;29;2;07;211;Plouyé;654;17;671
53;Bretagne;29;1;03;212;Plouzané;13558;250;13808
53;Bretagne;29;3;14;213;Plouzévédé;1775;36;1811
53;Bretagne;29;4;19;214;Plovan;683;20;703
53;Bretagne;29;4;19;215;Plozévet;2945;70;3015
53;Bretagne;29;4;23;216;Pluguffan;4196;104;4300
53;Bretagne;29;4;16;217;Pont-Aven;2831;57;2888
53;Bretagne;29;4;10;218;Pont-Croix;1566;30;1596
53;Bretagne;29;4;22;220;Pont-l'Abbé;8392;394;8786
53;Bretagne;29;1;27;221;Porspoder;1764;51;1815
53;Bretagne;29;2;09;222;Port-Launay;398;7;405
53;Bretagne;29;4;10;224;Pouldergat;1214;27;1241
53;Bretagne;29;4;19;225;Pouldreuzic;2157;43;2200
53;Bretagne;29;4;10;226;Poullan-sur-Mer;1485;80;1565
53;Bretagne;29;2;07;227;Poullaouen;1473;33;1506
53;Bretagne;29;4;10;228;Primelin;650;16;666
53;Bretagne;29;4;09;229;Quéménéven;1112;34;1146
53;Bretagne;29;4;25;230;Querrien;1665;34;1699
53;Bretagne;29;4;99;232;Quimper;63473;2402;65875
53;Bretagne;29;4;25;233;Quimperlé;12077;476;12553
53;Bretagne;29;4;25;234;Rédené;2911;65;2976
53;Bretagne;29;1;12;235;Le Relecq-Kerhuon;11710;220;11930
53;Bretagne;29;4;16;236;Riec-sur-Bélon;4240;87;4327
53;Bretagne;29;1;13;237;La Roche-Maurice;1810;44;1854
53;Bretagne;29;2;09;238;Roscanvel;830;30;860
53;Bretagne;29;3;26;239;Roscoff;3362;84;3446
53;Bretagne;29;2;21;240;Rosnoën;960;23;983
53;Bretagne;29;4;08;241;Rosporden;7594;161;7755
53;Bretagne;29;2;09;243;Saint-Coulitz;459;13;472
53;Bretagne;29;3;14;244;Saint-Derrien;829;13;842
53;Bretagne;29;1;13;245;Saint-Divy;1572;19;1591
53;Bretagne;29;1;21;246;Saint-Eloy;216;4;220
53;Bretagne;29;4;11;247;Saint-Évarzec;3521;114;3635
53;Bretagne;29;1;15;248;Saint-Frégant;851;8;859
53;Bretagne;29;2;06;249;Saint-Goazec;713;9;722
53;Bretagne;29;2;07;250;Saint-Hernin;750;17;767
53;Bretagne;29;3;20;251;Saint-Jean-du-Doigt;662;12;674
53;Bretagne;29;4;19;252;Saint-Jean-Trolimon;923;25;948
53;Bretagne;29;3;17;254;Saint-Martin-des-Champs;4707;119;4826
53;Bretagne;29;1;15;255;Saint-Méen;939;20;959
53;Bretagne;29;2;09;256;Saint-Nic;754;20;774
53;Bretagne;29;1;18;257;Saint-Pabu;2067;61;2128
53;Bretagne;29;3;26;259;Saint-Pol-de-Léon;6743;242;6985
53;Bretagne;29;1;27;260;Saint-Renan;8276;194;8470
53;Bretagne;29;2;07;261;Saint-Rivoal;214;3;217
53;Bretagne;29;3;14;262;Saint-Sauveur;784;10;794
53;Bretagne;29;2;21;263;Saint-Ségal;1124;17;1141
53;Bretagne;29;3;14;264;Saint-Servais;786;15;801
53;Bretagne;29;3;17;265;Sainte-Sève;1052;31;1083
53;Bretagne;29;3;17;266;Saint-Thégonnec Loc-Eguiner;3059;79;3138
53;Bretagne;29;2;06;267;Saint-Thois;722;17;739
53;Bretagne;29;1;13;268;Saint-Thonan;1916;37;1953
53;Bretagne;29;4;25;269;Saint-Thurien;1027;14;1041
53;Bretagne;29;1;21;270;Saint-Urbain;1667;32;1699
53;Bretagne;29;3;14;271;Saint-Vougay;887;25;912
53;Bretagne;29;4;08;272;Saint-Yvi;3308;67;3375
53;Bretagne;29;3;26;273;Santec;2385;76;2461
53;Bretagne;29;4;16;274;Scaër;5245;109;5354
53;Bretagne;29;2;07;275;Scrignac;739;20;759
53;Bretagne;29;3;26;276;Sibiril;1182;31;1213
53;Bretagne;29;3;14;277;Sizun;2304;77;2381
53;Bretagne;29;2;07;278;Spézet;1757;42;1799
53;Bretagne;29;3;17;279;Taulé;2878;73;2951
53;Bretagne;29;2;09;280;Telgruc-sur-Mer;2102;61;2163
53;Bretagne;29;4;08;281;Tourch;998;28;1026
53;Bretagne;29;1;27;282;Trébabu;363;10;373
53;Bretagne;29;4;22;284;Treffiagat;2410;107;2517
53;Bretagne;29;3;26;285;Tréflaouénan;523;8;531
53;Bretagne;29;1;21;286;Tréflévénez;244;8;252
53;Bretagne;29;3;26;287;Tréflez;975;19;994
53;Bretagne;29;1;15;288;Trégarantec;615;6;621
53;Bretagne;29;2;09;289;Trégarvan;112;7;119
53;Bretagne;29;1;18;290;Tréglonou;691;15;706
53;Bretagne;29;2;06;291;Trégourez;955;18;973
53;Bretagne;29;4;19;292;Tréguennec;314;6;320
53;Bretagne;29;4;16;293;Trégunc;7058;224;7282
53;Bretagne;29;1;21;294;Le Tréhou;644;11;655
53;Bretagne;29;1;13;295;Trémaouézan;511;21;532
53;Bretagne;29;4;19;296;Tréméoc;1400;39;1439
53;Bretagne;29;4;25;297;Tréméven;2329;48;2377
53;Bretagne;29;4;19;298;Tréogat;574;10;584
53;Bretagne;29;1;27;299;Tréouergat;329;3;332
53;Bretagne;29;4;16;300;Le Trévoux;1608;52;1660
53;Bretagne;29;3;14;301;Trézilidé;401;9;410
53;Bretagne;29;2;21;302;Pont-de-Buis-lès-Quimerch;3617;138;3755
94;Corse;2A;1;08;001;Afa;3277;58;3335
94;Corse;2A;1;98;004;Ajaccio;72647;836;73483
94;Corse;2A;1;05;006;Alata;3562;71;3633
94;Corse;2A;1;11;008;Albitreccia;1785;26;1811
94;Corse;2A;4;09;011;Altagène;54;2;56
94;Corse;2A;1;10;014;Ambiegna;74;0;74
94;Corse;2A;1;08;017;Appietto;1795;38;1833
94;Corse;2A;4;09;018;Arbellara;159;2;161
94;Corse;2A;1;10;019;Arbori;54;0;54
94;Corse;2A;4;11;021;Argiusta-Moriccio;77;1;78
94;Corse;2A;1;10;022;Arro;80;0;80
94;Corse;2A;4;09;024;Aullène;185;1;186
94;Corse;2A;1;11;026;Azilone-Ampaza;193;3;196
94;Corse;2A;1;10;027;Azzana;53;0;53
94;Corse;2A;1;10;028;Balogna;146;6;152
94;Corse;2A;1;08;031;Bastelica;517;6;523
94;Corse;2A;1;05;032;Bastelicaccia;4250;114;4364
94;Corse;2A;4;09;035;Belvédère-Campomoro;159;2;161
94;Corse;2A;4;09;038;Bilia;52;1;53
94;Corse;2A;1;08;040;Bocognano;372;7;379
94;Corse;2A;4;07;041;Bonifacio;3204;55;3259
94;Corse;2A;1;10;048;Calcatoggio;503;5;508
94;Corse;2A;1;11;056;Campo;105;5;110
94;Corse;2A;1;10;060;Cannelle;76;1;77
94;Corse;2A;4;07;061;Carbini;114;3;117
94;Corse;2A;1;08;062;Carbuccia;375;9;384
94;Corse;2A;1;11;064;Cardo-Torgia;31;2;33
94;Corse;2A;1;10;065;Cargèse;1280;21;1301
94;Corse;2A;4;09;066;Cargiaca;60;0;60
94;Corse;2A;1;10;070;Casaglione;384;6;390
94;Corse;2A;4;11;071;Casalabriva;219;4;223
94;Corse;2A;1;11;085;Cauro;1492;38;1530
94;Corse;2A;1;11;089;Ciamannacce;133;0;133
94;Corse;2A;1;10;090;Coggia;722;14;736
94;Corse;2A;1;11;091;Cognocoli-Monticchi;175;1;176
94;Corse;2A;4;06;092;Conca;1151;20;1171
94;Corse;2A;1;11;094;Corrano;73;1;74
94;Corse;2A;1;11;098;Coti-Chiavari;724;9;733
94;Corse;2A;1;11;099;Cozzano;278;1;279
94;Corse;2A;1;10;100;Cristinacce;67;0;67
94;Corse;2A;1;08;103;Cuttoli-Corticchiato;2032;33;2065
94;Corse;2A;1;11;104;Eccica-Suarella;1353;36;1389
94;Corse;2A;1;10;108;Évisa;213;5;218
94;Corse;2A;4;07;114;Figari;1559;34;1593
94;Corse;2A;4;09;115;Foce;151;2;153
94;Corse;2A;1;11;117;Forciolo;83;0;83
94;Corse;2A;4;09;118;Fozzano;209;2;211
94;Corse;2A;1;11;119;Frasseto;140;3;143
94;Corse;2A;4;09;127;Giuncheto;91;4;95
94;Corse;2A;4;09;128;Granace;93;2;95
94;Corse;2A;4;09;129;Grossa;53;1;54
94;Corse;2A;1;11;130;Grosseto-Prugna;3398;57;3455
94;Corse;2A;1;10;131;Guagno;158;2;160
94;Corse;2A;1;11;132;Guargualé;153;1;154
94;Corse;2A;1;11;133;Guitera-les-Bains;152;3;155
94;Corse;2A;4;06;139;Lecci;1889;31;1920
94;Corse;2A;1;10;141;Letia;128;0;128
94;Corse;2A;4;07;142;Levie;674;13;687
94;Corse;2A;1;10;144;Lopigna;102;3;105
94;Corse;2A;4;09;146;Loreto-di-Tallano;52;1;53
94;Corse;2A;1;10;154;Marignana;106;6;112
94;Corse;2A;4;09;158;Mela;28;1;29
94;Corse;2A;4;11;160;Moca-Croce;259;2;261
94;Corse;2A;4;07;163;Monacia-d'Aullène;559;15;574
94;Corse;2A;1;10;174;Murzo;101;3;104
94;Corse;2A;1;08;181;Ocana;628;17;645
94;Corse;2A;1;11;186;Olivese;218;1;219
94;Corse;2A;4;09;189;Olmeto;1217;28;1245
94;Corse;2A;4;09;191;Olmiccia;119;4;123
94;Corse;2A;1;10;196;Orto;50;1;51
94;Corse;2A;1;10;197;Osani;98;0;98
94;Corse;2A;1;10;198;Ota;511;9;520
94;Corse;2A;1;11;200;Palneca;134;3;137
94;Corse;2A;1;10;203;Partinello;95;0;95
94;Corse;2A;1;10;204;Pastricciola;96;1;97
94;Corse;2A;1;08;209;Peri;2038;33;2071
94;Corse;2A;4;11;211;Petreto-Bicchisano;564;17;581
94;Corse;2A;1;10;212;Piana;461;9;470
94;Corse;2A;4;07;215;Pianottoli-Caldarello;901;7;908
94;Corse;2A;1;11;228;Pietrosella;1945;19;1964
94;Corse;2A;1;11;232;Pila-Canale;278;3;281
94;Corse;2A;1;10;240;Poggiolo;114;0;114
94;Corse;2A;4;99;247;Porto-Vecchio;11040;170;11210
94;Corse;2A;4;09;249;Propriano;3705;42;3747
94;Corse;2A;1;11;253;Quasquara;51;0;51
94;Corse;2A;4;09;254;Quenza;195;4;199
94;Corse;2A;1;10;258;Renno;61;2;63
94;Corse;2A;1;10;259;Rezza;65;1;66
94;Corse;2A;1;10;262;Rosazia;50;1;51
94;Corse;2A;1;10;266;Salice;89;4;93
94;Corse;2A;1;11;268;Sampolo;81;0;81
94;Corse;2A;4;06;269;Sari-Solenzara;1411;20;1431
94;Corse;2A;1;10;270;Sari-d'Orcino;352;3;355
94;Corse;2A;1;08;271;Sarrola-Carcopino;3309;52;3361
94;Corse;2A;4;09;272;Sartène;3408;95;3503
94;Corse;2A;1;11;276;Serra-di-Ferro;563;10;573
94;Corse;2A;4;09;278;Serra-di-Scopamène;81;3;84
94;Corse;2A;1;10;279;Serriera;120;0;120
94;Corse;2A;1;10;282;Soccia;152;2;154
94;Corse;2A;4;11;284;Sollacaro;372;5;377
94;Corse;2A;4;09;285;Sorbollano;72;0;72
94;Corse;2A;4;07;288;Sotta;1556;22;1578
94;Corse;2A;1;10;295;Sant'Andréa-d'Orcino;125;4;129
94;Corse;2A;4;06;300;San-Gavino-di-Carbini;1077;21;1098
94;Corse;2A;4;09;308;Sainte-Lucie-de-Tallano;381;7;388
94;Corse;2A;4;09;310;Santa-Maria-Figaniella;102;0;102
94;Corse;2A;1;11;312;Santa-Maria-Siché;387;9;396
94;Corse;2A;1;11;322;Tasso;87;0;87
94;Corse;2A;1;08;323;Tavaco;405;7;412
94;Corse;2A;1;08;324;Tavera;394;4;398
94;Corse;2A;1;08;326;Tolla;121;2;123
94;Corse;2A;1;08;330;Ucciani;501;2;503
94;Corse;2A;1;11;331;Urbalacone;59;0;59
94;Corse;2A;1;08;336;Valle-di-Mezzana;522;11;533
94;Corse;2A;1;08;345;Vero;606;4;610
94;Corse;2A;1;10;348;Vico;929;11;940
94;Corse;2A;4;09;349;Viggianello;854;18;872
94;Corse;2A;1;05;351;Villanova;403;5;408
94;Corse;2A;4;09;357;Zérubia;48;3;51
94;Corse;2A;1;11;358;Zévaco;52;1;53
94;Corse;2A;1;11;359;Zicavo;219;2;221
94;Corse;2A;1;11;360;Zigliara;128;5;133
94;Corse;2A;4;06;362;Zonza;2755;35;2790
94;Corse;2A;4;09;363;Zoza;66;0;66
94;Corse;2B;3;13;002;Aghione;235;4;239
94;Corse;2B;3;14;003;Aiti;26;0;26
94;Corse;2B;3;14;005;Alando;27;2;29
94;Corse;2B;3;14;007;Albertacce;204;5;209
94;Corse;2B;3;13;009;Aléria;2185;26;2211
94;Corse;2B;5;07;010;Algajola;358;7;365
94;Corse;2B;3;13;012;Altiani;52;1;53
94;Corse;2B;3;14;013;Alzi;25;0;25
94;Corse;2B;3;13;015;Ampriani;25;0;25
94;Corse;2B;3;13;016;Antisanti;556;0;556
94;Corse;2B;5;07;020;Aregno;597;12;609
94;Corse;2B;3;14;023;Asco;115;1;116
94;Corse;2B;5;07;025;Avapessa;82;2;84
94;Corse;2B;5;05;029;Barbaggio;297;4;301
94;Corse;2B;2;08;030;Barrettali;132;4;136
94;Corse;2B;2;99;033;Bastia;48296;632;48928
94;Corse;2B;5;15;034;Belgodère;696;8;704
94;Corse;2B;3;14;036;Bigorno;87;0;87
94;Corse;2B;2;05;037;Biguglia;7732;126;7858
94;Corse;2B;3;14;039;Bisinchi;228;2;230
94;Corse;2B;2;06;042;Borgo;9254;178;9432
94;Corse;2B;2;08;043;Brando;1602;36;1638
94;Corse;2B;3;14;045;Bustanico;66;0;66
94;Corse;2B;2;08;046;Cagnano;154;3;157
94;Corse;2B;3;14;047;Calacuccia;268;3;271
94;Corse;2B;5;07;049;Calenzana;2520;31;2551
94;Corse;2B;5;07;050;Calvi;5766;82;5848
94;Corse;2B;3;14;051;Cambia;70;0;70
94;Corse;2B;3;10;052;Campana;20;0;20
94;Corse;2B;3;13;053;Campi;19;0;19
94;Corse;2B;3;14;054;Campile;185;4;189
94;Corse;2B;3;14;055;Campitello;116;1;117
94;Corse;2B;3;10;057;Canale-di-Verde;312;2;314
94;Corse;2B;2;08;058;Canari;316;1;317
94;Corse;2B;3;14;059;Canavaggia;112;1;113
94;Corse;2B;3;10;063;Carcheto-Brustico;39;0;39
94;Corse;2B;3;10;067;Carpineto;35;0;35
94;Corse;2B;3;14;068;Carticasi;25;0;25
94;Corse;2B;3;09;069;Casabianca;116;1;117
94;Corse;2B;3;09;072;Casalta;55;1;56
94;Corse;2B;3;14;073;Casamaccioli;109;2;111
94;Corse;2B;3;11;074;Casanova;395;3;398
94;Corse;2B;3;13;075;Casevecchie;72;2;74
94;Corse;2B;3;09;077;Castellare-di-Casinca;697;6;703
94;Corse;2B;3;14;078;Castellare-di-Mercurio;28;1;29
94;Corse;2B;3;14;079;Castello-di-Rostino;499;1;500
94;Corse;2B;3;14;080;Castifao;139;1;140
94;Corse;2B;3;14;081;Castiglione;42;0;42
94;Corse;2B;3;14;082;Castineta;38;0;38
94;Corse;2B;3;14;083;Castirla;154;2;156
94;Corse;2B;5;07;084;Cateri;244;1;245
94;Corse;2B;2;08;086;Centuri;185;1;186
94;Corse;2B;3;10;087;Cervione;2182;26;2208
94;Corse;2B;3;10;088;Chiatra;214;3;217
94;Corse;2B;5;15;093;Corbara;901;32;933
94;Corse;2B;3;14;095;Corscia;127;3;130
94;Corse;2B;3;11;096;Corte;7549;116;7665
94;Corse;2B;5;15;097;Costa;51;1;52
94;Corse;2B;3;09;101;Croce;80;3;83
94;Corse;2B;3;14;102;Crocicchia;80;0;80
94;Corse;2B;3;14;105;Erbajolo;108;0;108
94;Corse;2B;3;14;106;Érone;12;0;12
94;Corse;2B;2;08;107;Ersa;145;0;145
94;Corse;2B;5;08;109;Farinole;236;2;238
94;Corse;2B;3;14;110;Favalello;67;1;68
94;Corse;2B;3;10;111;Felce;51;0;51
94;Corse;2B;5;15;112;Feliceto;236;4;240
94;Corse;2B;3;09;113;Ficaja;56;1;57
94;Corse;2B;3;14;116;Focicchia;29;1;30
94;Corse;2B;2;04;120;Furiani;5772;129;5901
94;Corse;2B;5;07;121;Galéria;373;5;378
94;Corse;2B;3;14;122;Gavignano;59;0;59
94;Corse;2B;3;13;123;Ghisonaccia;4215;54;4269
94;Corse;2B;3;12;124;Ghisoni;207;6;213
94;Corse;2B;3;09;125;Giocatojo;53;0;53
94;Corse;2B;3;13;126;Giuncaggio;70;0;70
94;Corse;2B;5;15;134;L'Île-Rousse;3224;67;3291
94;Corse;2B;3;12;135;Isolaccio-di-Fiumorbo;315;4;319
94;Corse;2B;5;15;136;Lama;149;2;151
94;Corse;2B;3;14;137;Lano;22;0;22
94;Corse;2B;5;07;138;Lavatoggio;149;2;151
94;Corse;2B;3;14;140;Lento;107;0;107
94;Corse;2B;3;13;143;Linguizzetta;1104;8;1112
94;Corse;2B;3;09;145;Loreto-di-Casinca;208;6;214
94;Corse;2B;3;14;147;Lozzi;111;1;112
94;Corse;2B;2;06;148;Lucciana;6036;51;6087
94;Corse;2B;3;12;149;Lugo-di-Nazza;84;1;85
94;Corse;2B;5;07;150;Lumio;1237;36;1273
94;Corse;2B;2;08;152;Luri;848;9;857
94;Corse;2B;5;07;153;Manso;119;2;121
94;Corse;2B;3;13;155;Matra;49;0;49
94;Corse;2B;5;15;156;Mausoléo;26;0;26
94;Corse;2B;3;14;157;Mazzola;30;0;30
94;Corse;2B;2;08;159;Meria;80;1;81
94;Corse;2B;3;13;161;Moïta;64;0;64
94;Corse;2B;3;14;162;Moltifao;709;11;720
94;Corse;2B;3;10;164;Monacia-d'Orezza;22;0;22
94;Corse;2B;5;07;165;Moncale;337;6;343
94;Corse;2B;3;14;166;Monte;644;5;649
94;Corse;2B;5;07;167;Montegrosso;425;14;439
94;Corse;2B;5;15;168;Monticello;2000;44;2044
94;Corse;2B;3;14;169;Morosaglia;971;10;981
94;Corse;2B;2;08;170;Morsiglia;107;2;109
94;Corse;2B;3;11;171;Muracciole;34;1;35
94;Corse;2B;5;05;172;Murato;565;6;571
94;Corse;2B;5;15;173;Muro;257;3;260
94;Corse;2B;5;15;175;Nessa;114;3;117
94;Corse;2B;3;10;176;Nocario;76;2;78
94;Corse;2B;3;12;177;Noceta;59;2;61
94;Corse;2B;2;08;178;Nonza;71;1;72
94;Corse;2B;3;10;179;Novale;62;1;63
94;Corse;2B;5;15;180;Novella;79;1;80
94;Corse;2B;5;15;182;Occhiatana;264;2;266
94;Corse;2B;2;08;183;Ogliastro;93;2;95
94;Corse;2B;2;08;184;Olcani;93;1;94
94;Corse;2B;5;05;185;Oletta;1795;15;1810
94;Corse;2B;2;08;187;Olmeta-di-Capocorso;131;1;132
94;Corse;2B;5;05;188;Olmeta-di-Tuda;538;8;546
94;Corse;2B;5;15;190;Olmi-Cappella;185;4;189
94;Corse;2B;3;14;192;Olmo;147;3;150
94;Corse;2B;3;14;193;Omessa;600;6;606
94;Corse;2B;3;10;194;Ortale;26;0;26
94;Corse;2B;3;14;195;Ortiporio;123;1;124
94;Corse;2B;5;15;199;Palasca;185;5;190
94;Corse;2B;3;13;201;Pancheraccia;197;1;198
94;Corse;2B;3;10;202;Parata;24;0;24
94;Corse;2B;5;08;205;Patrimonio;881;12;893
94;Corse;2B;3;14;206;Penta-Acquatella;38;0;38
94;Corse;2B;3;09;207;Penta-di-Casinca;3366;38;3404
94;Corse;2B;3;10;208;Perelli;108;1;109
94;Corse;2B;3;09;210;Pero-Casevecchie;114;0;114
94;Corse;2B;3;13;213;Pianello;59;0;59
94;Corse;2B;3;09;214;Piano;19;0;19
94;Corse;2B;3;10;216;Piazzali;19;0;19
94;Corse;2B;3;10;217;Piazzole;44;0;44
94;Corse;2B;3;13;218;Piedicorte-di-Gaggio;99;3;102
94;Corse;2B;3;10;219;Piedicroce;83;1;84
94;Corse;2B;3;14;220;Piedigriggio;132;3;135
94;Corse;2B;3;10;221;Piedipartino;16;0;16
94;Corse;2B;3;10;222;Pie-d'Orezza;38;0;38
94;Corse;2B;5;14;223;Pietralba;496;3;499
94;Corse;2B;2;08;224;Pietracorbara;658;10;668
94;Corse;2B;3;10;225;Pietra-di-Verde;99;2;101
94;Corse;2B;3;13;226;Pietraserena;59;1;60
94;Corse;2B;3;10;227;Pietricaggio;33;1;34
94;Corse;2B;3;12;229;Pietroso;349;0;349
94;Corse;2B;5;05;230;Piève;111;0;111
94;Corse;2B;5;15;231;Pigna;109;6;115
94;Corse;2B;2;08;233;Pino;167;2;169
94;Corse;2B;3;10;234;Piobetta;17;0;17
94;Corse;2B;5;15;235;Pioggiola;85;0;85
94;Corse;2B;3;12;236;Poggio-di-Nazza;183;3;186
94;Corse;2B;3;11;238;Poggio-di-Venaco;208;7;215
94;Corse;2B;5;05;239;Poggio-d'Oletta;214;11;225
94;Corse;2B;3;09;241;Poggio-Marinaccio;32;1;33
94;Corse;2B;3;10;242;Poggio-Mezzana;699;13;712
94;Corse;2B;3;09;243;Polveroso;42;0;42
94;Corse;2B;3;14;244;Popolasca;42;0;42
94;Corse;2B;3;09;245;Porri;43;1;44
94;Corse;2B;3;09;246;La Porta;191;2;193
94;Corse;2B;3;14;248;Prato-di-Giovellina;45;2;47
94;Corse;2B;3;14;250;Prunelli-di-Casacconi;149;0;149
94;Corse;2B;3;12;251;Prunelli-di-Fiumorbo;3719;43;3762
94;Corse;2B;3;09;252;Pruno;181;3;184
94;Corse;2B;3;09;255;Quercitello;40;0;40
94;Corse;2B;3;10;256;Rapaggio;28;1;29
94;Corse;2B;5;05;257;Rapale;160;4;164
94;Corse;2B;3;11;260;Riventosa;152;3;155
94;Corse;2B;2;08;261;Rogliano;538;11;549
94;Corse;2B;3;12;263;Rospigliani;69;5;74
94;Corse;2B;3;14;264;Rusio;59;1;60
94;Corse;2B;5;05;265;Rutali;413;5;418
94;Corse;2B;3;14;267;Saliceto;45;3;48
94;Corse;2B;3;09;273;Scata;43;5;48
94;Corse;2B;3;14;274;Scolca;90;1;91
94;Corse;2B;3;14;275;Sermano;73;2;75
94;Corse;2B;3;12;277;Serra-di-Fiumorbo;334;3;337
94;Corse;2B;3;09;280;Silvareccio;106;0;106
94;Corse;2B;2;08;281;Sisco;1151;9;1160
94;Corse;2B;3;12;283;Solaro;730;12;742
94;Corse;2B;3;09;286;Sorbo-Ocagnano;882;19;901
94;Corse;2B;5;05;287;Sorio;142;0;142
94;Corse;2B;3;14;289;Soveria;116;0;116
94;Corse;2B;5;15;290;Speloncato;277;8;285
94;Corse;2B;3;10;291;Stazzona;34;1;35
94;Corse;2B;3;14;292;Sant'Andréa-di-Bozio;66;1;67
94;Corse;2B;3;10;293;Sant'Andréa-di-Cotone;206;2;208
94;Corse;2B;5;07;296;Sant'Antonino;136;5;141
94;Corse;2B;3;09;297;San-Damiano;55;0;55
94;Corse;2B;5;05;298;Saint-Florent;1688;18;1706
94;Corse;2B;3;09;299;San-Gavino-d'Ampugnani;105;1;106
94;Corse;2B;5;05;301;San-Gavino-di-Tenda;57;1;58
94;Corse;2B;3;10;302;San-Giovanni-di-Moriani;88;2;90
94;Corse;2B;3;10;303;San-Giuliano;758;6;764
94;Corse;2B;3;14;304;San-Lorenzo;142;2;144
94;Corse;2B;2;08;305;San-Martino-di-Lota;2920;42;2962
94;Corse;2B;3;14;306;Santa-Lucia-di-Mercurio;118;0;118
94;Corse;2B;3;10;307;Santa-Lucia-di-Moriani;1519;30;1549
94;Corse;2B;2;08;309;Santa-Maria-di-Lota;1971;102;2073
94;Corse;2B;3;10;311;Santa-Maria-Poggio;787;11;798
94;Corse;2B;3;10;313;San-Nicolao;2037;18;2055
94;Corse;2B;5;05;314;Santo-Pietro-di-Tenda;338;1;339
94;Corse;2B;3;11;315;Santo-Pietro-di-Venaco;284;5;289
94;Corse;2B;5;15;316;Santa-Reparata-di-Balagna;1000;14;1014
94;Corse;2B;3;10;317;Santa-Reparata-di-Moriani;59;0;59
94;Corse;2B;3;09;318;Taglio-Isolaccio;581;10;591
94;Corse;2B;3;09;319;Talasani;811;6;817
94;Corse;2B;3;13;320;Tallone;283;2;285
94;Corse;2B;3;10;321;Tarrano;15;0;15
94;Corse;2B;2;08;327;Tomino;184;3;187
94;Corse;2B;3;13;328;Tox;97;0;97
94;Corse;2B;3;14;329;Tralonca;111;1;112
94;Corse;2B;5;15;332;Urtaca;238;6;244
94;Corse;2B;5;05;333;Vallecalle;146;4;150
94;Corse;2B;3;10;334;Valle-d'Alesani;107;1;108
94;Corse;2B;3;10;335;Valle-di-Campoloro;352;7;359
94;Corse;2B;3;14;337;Valle-di-Rostino;141;2;143
94;Corse;2B;3;10;338;Valle-d'Orezza;28;0;28
94;Corse;2B;5;15;339;Vallica;28;0;28
94;Corse;2B;3;10;340;Velone-Orneto;117;2;119
94;Corse;2B;3;11;341;Venaco;690;8;698
94;Corse;2B;3;12;342;Ventiseri;2520;48;2568
94;Corse;2B;3;09;343;Venzolasca;1795;14;1809
94;Corse;2B;3;10;344;Verdèse;42;2;44
94;Corse;2B;3;09;346;Vescovato;3032;21;3053
94;Corse;2B;3;12;347;Vezzani;268;0;268
94;Corse;2B;2;06;350;Vignale;212;4;216
94;Corse;2B;5;15;352;Ville-di-Paraso;207;5;212
94;Corse;2B;2;01;353;Ville-di-Pietrabugno;3278;64;3342
94;Corse;2B;3;11;354;Vivario;428;5;433
94;Corse;2B;3;14;355;Volpajola;352;6;358
94;Corse;2B;3;13;356;Zalana;146;1;147
94;Corse;2B;5;07;361;Zilia;298;4;302
94;Corse;2B;3;13;364;Zuani;36;0;36
94;Corse;2B;3;12;365;San-Gavino-di-Fiumorbo;102;2;104
94;Corse;2B;3;12;366;Chisa;104;2;106
76;Occitanie;30;2;20;001;Aigaliers;525;14;539
76;Occitanie;30;3;15;002;Aigremont;770;16;786
76;Occitanie;30;2;01;003;Aigues-Mortes;8664;78;8742
76;Occitanie;30;2;21;004;Aigues-Vives;3339;60;3399
76;Occitanie;30;2;14;005;Aiguèze;218;3;221
76;Occitanie;30;2;01;006;Aimargues;5729;55;5784
76;Occitanie;30;1;98;007;Alès;42867;625;43492
76;Occitanie;30;1;18;008;Allègre-les-Fumades;984;17;1001
76;Occitanie;30;3;22;009;Alzon;173;2;175
76;Occitanie;30;1;02;010;Anduze;3335;39;3374
76;Occitanie;30;2;23;011;Les Angles;8507;207;8714
76;Occitanie;30;2;06;012;Aramon;4172;57;4229
76;Occitanie;30;2;16;013;Argilliers;448;21;469
76;Occitanie;30;2;20;014;Arpaillargues-et-Aureillac;1044;18;1062
76;Occitanie;30;3;22;015;Arphy;143;5;148
76;Occitanie;30;3;22;016;Arre;278;11;289
76;Occitanie;30;3;22;017;Arrigas;212;2;214
76;Occitanie;30;2;07;018;Aspères;530;16;546
76;Occitanie;30;2;01;019;Aubais;2952;60;3012
76;Occitanie;30;2;21;020;Aubord;2347;43;2390
76;Occitanie;30;2;20;021;Aubussargues;321;4;325
76;Occitanie;30;1;08;022;Aujac;178;6;184
76;Occitanie;30;2;07;023;Aujargues;788;14;802
76;Occitanie;30;3;22;024;Aulas;451;7;458
76;Occitanie;30;3;22;025;Aumessas;230;3;233
76;Occitanie;30;3;22;026;Avèze;1067;22;1089
76;Occitanie;30;1;02;027;Bagard;2570;61;2631
76;Occitanie;30;2;05;028;Bagnols-sur-Cèze;18072;333;18405
76;Occitanie;30;1;18;029;Barjac;1616;29;1645
76;Occitanie;30;2;20;030;Baron;358;10;368
76;Occitanie;30;2;20;031;La Bastide-d'Engras;202;2;204
76;Occitanie;30;2;06;032;Beaucaire;15659;141;15800
76;Occitanie;30;2;21;033;Beauvoisin;5323;55;5378
76;Occitanie;30;2;06;034;Bellegarde;7550;74;7624
76;Occitanie;30;2;03;035;Belvézet;240;1;241
76;Occitanie;30;2;21;036;Bernis;3452;26;3478
76;Occitanie;30;1;18;037;Bessèges;2766;27;2793
76;Occitanie;30;3;22;038;Bez-et-Esparon;326;11;337
76;Occitanie;30;2;16;039;Bezouce;2315;26;2341
76;Occitanie;30;3;22;040;Blandas;127;2;129
76;Occitanie;30;2;20;041;Blauzac;1233;21;1254
76;Occitanie;30;1;02;042;Boisset-et-Gaujac;2568;45;2613
76;Occitanie;30;2;07;043;Boissières;585;16;601
76;Occitanie;30;1;08;044;Bonnevaux;84;3;87
76;Occitanie;30;1;18;045;Bordezac;392;3;395
76;Occitanie;30;1;15;046;Boucoiran-et-Nozières;989;14;1003
76;Occitanie;30;2;09;047;Bouillargues;6238;136;6374
76;Occitanie;30;2;03;048;Bouquet;183;3;186
76;Occitanie;30;2;20;049;Bourdic;371;17;388
76;Occitanie;30;3;15;050;Bragassargues;167;1;168
76;Occitanie;30;1;08;051;Branoux-les-Taillades;1336;35;1371
76;Occitanie;30;3;22;052;Bréau-Mars;658;19;677
76;Occitanie;30;1;15;053;Brignon;762;10;772
76;Occitanie;30;3;15;054;Brouzet-lès-Quissac;303;4;307
76;Occitanie;30;1;03;055;Brouzet-lès-Alès;678;13;691
76;Occitanie;30;2;20;056;La Bruguière;329;7;336
76;Occitanie;30;2;16;057;Cabrières;1710;30;1740
76;Occitanie;30;3;22;058;La Cadière-et-Cambo;218;6;224
76;Occitanie;30;2;01;059;Le Cailar;2467;19;2486
76;Occitanie;30;2;09;060;Caissargues;4118;80;4198
76;Occitanie;30;2;20;061;La Calmette;2432;28;2460
76;Occitanie;30;2;07;062;Calvisson;5914;99;6013
76;Occitanie;30;3;22;064;Campestre-et-Luc;134;2;136
76;Occitanie;30;3;15;065;Canaules-et-Argentières;466;3;469
76;Occitanie;30;2;07;066;Cannes-et-Clairan;559;13;572
76;Occitanie;30;2;20;067;La Capelle-et-Masmolène;416;6;422
76;Occitanie;30;3;15;068;Cardet;905;23;928
76;Occitanie;30;3;15;069;Carnas;516;12;528
76;Occitanie;30;2;14;070;Carsan;770;25;795
76;Occitanie;30;3;15;071;Cassagnoles;413;8;421
76;Occitanie;30;1;04;072;Castelnau-Valence;481;10;491
76;Occitanie;30;2;16;073;Castillon-du-Gard;1679;86;1765
76;Occitanie;30;3;22;074;Causse-Bégon;26;0;26
76;Occitanie;30;2;19;075;Caveirac;4372;115;4487
76;Occitanie;30;2;05;076;Cavillargues;849;32;881
76;Occitanie;30;1;08;077;Cendras;1652;31;1683
76;Occitanie;30;1;08;079;Chambon;257;3;260
76;Occitanie;30;1;08;080;Chamborigaud;891;5;896
76;Occitanie;30;2;05;081;Chusclan;966;29;995
76;Occitanie;30;2;19;082;Clarensac;4190;97;4287
76;Occitanie;30;2;21;083;Codognan;2419;37;2456
76;Occitanie;30;2;17;084;Codolet;607;11;618
76;Occitanie;30;2;16;085;Collias;1066;15;1081
76;Occitanie;30;2;20;086;Collorgues;666;11;677
76;Occitanie;30;3;15;087;Colognac;226;6;232
76;Occitanie;30;2;07;088;Combas;677;13;690
76;Occitanie;30;2;06;089;Comps;1736;31;1767
76;Occitanie;30;1;08;090;Concoules;263;3;266
76;Occitanie;30;2;07;091;Congénies;1666;34;1700
76;Occitanie;30;2;05;092;Connaux;1701;49;1750
76;Occitanie;30;3;22;093;Conqueyrac;101;0;101
76;Occitanie;30;1;08;094;Corbès;150;1;151
76;Occitanie;30;3;15;095;Corconne;609;12;621
76;Occitanie;30;2;14;096;Cornillon;935;17;952
76;Occitanie;30;1;18;097;Courry;280;4;284
76;Occitanie;30;2;07;098;Crespian;436;4;440
76;Occitanie;30;3;15;099;Cros;237;8;245
76;Occitanie;30;1;15;100;Cruviers-Lascours;705;10;715
76;Occitanie;30;1;04;101;Deaux;656;17;673
76;Occitanie;30;2;20;102;Dions;539;9;548
76;Occitanie;30;2;16;103;Domazan;951;11;962
76;Occitanie;30;2;15;104;Domessargues;752;19;771
76;Occitanie;30;3;22;105;Dourbies;138;5;143
76;Occitanie;30;3;15;106;Durfort-et-Saint-Martin-de-Sossenac;750;17;767
76;Occitanie;30;2;16;107;Estézargues;605;12;617
76;Occitanie;30;3;22;108;L'Estréchure;155;5;160
76;Occitanie;30;1;04;109;Euzet;470;7;477
76;Occitanie;30;2;20;110;Flaux;365;9;374
76;Occitanie;30;2;20;111;Foissac;446;9;455
76;Occitanie;30;2;07;112;Fons;1733;16;1749
76;Occitanie;30;2;03;113;Fons-sur-Lussan;233;3;236
76;Occitanie;30;2;07;114;Fontanès;682;10;692
76;Occitanie;30;2;20;115;Fontarèches;247;8;255
76;Occitanie;30;2;16;116;Fournès;1073;13;1086
76;Occitanie;30;2;06;117;Fourques;2748;52;2800
76;Occitanie;30;3;15;119;Fressac;157;5;162
76;Occitanie;30;1;18;120;Gagnières;1088;16;1104
76;Occitanie;30;3;15;121;Gailhan;264;4;268
76;Occitanie;30;2;07;122;Gajan;723;13;736
76;Occitanie;30;2;01;123;Gallargues-le-Montueux;3596;113;3709
76;Occitanie;30;2;14;124;Le Garn;212;2;214
76;Occitanie;30;2;09;125;Garons;5035;50;5085
76;Occitanie;30;2;20;126;Garrigues-Sainte-Eulalie;734;19;753
76;Occitanie;30;2;05;127;Gaujac;1071;25;1096
76;Occitanie;30;2;19;128;Générac;4048;69;4117
76;Occitanie;30;1;02;129;Générargues;692;20;712
76;Occitanie;30;1;08;130;Génolhac;824;9;833
76;Occitanie;30;2;14;131;Goudargues;1108;32;1140
76;Occitanie;30;1;08;132;La Grand-Combe;4955;74;5029
76;Occitanie;30;2;01;133;Le Grau-du-Roi;8356;70;8426
76;Occitanie;30;2;14;134;Issirac;310;4;314
76;Occitanie;30;2;06;135;Jonquières-Saint-Vincent;3811;37;3848
76;Occitanie;30;2;07;136;Junas;1152;17;1169
76;Occitanie;30;1;08;137;Lamelouze;138;3;141
76;Occitanie;30;2;19;138;Langlade;2239;56;2295
76;Occitanie;30;3;22;139;Lanuéjols;339;29;368
76;Occitanie;30;3;22;140;Lasalle;1093;11;1104
76;Occitanie;30;2;17;141;Laudun-l'Ardoise;6327;120;6447
76;Occitanie;30;1;08;142;Laval-Pradel;1116;21;1137
76;Occitanie;30;2;14;143;Laval-Saint-Roman;214;5;219
76;Occitanie;30;2;07;144;Lecques;458;9;467
76;Occitanie;30;2;16;145;Lédenon;1651;24;1675
76;Occitanie;30;3;15;146;Lédignan;1491;24;1515
76;Occitanie;30;1;15;147;Lézan;1535;26;1561
76;Occitanie;30;3;15;148;Liouc;329;7;336
76;Occitanie;30;2;17;149;Lirac;922;20;942
76;Occitanie;30;3;15;150;Logrian-Florian;264;6;270
76;Occitanie;30;2;03;151;Lussan;499;7;506
76;Occitanie;30;1;18;152;Les Mages;2061;33;2094
76;Occitanie;30;1;08;153;Malons-et-Elze;124;0;124
76;Occitanie;30;3;22;154;Mandagout;389;10;399
76;Occitanie;30;2;09;155;Manduel;7092;93;7185
76;Occitanie;30;2;09;156;Marguerittes;8564;149;8713
76;Occitanie;30;1;04;158;Martignargues;436;9;445
76;Occitanie;30;1;18;159;Le Martinet;779;4;783
76;Occitanie;30;3;15;160;Maruéjols-lès-Gardon;266;4;270
76;Occitanie;30;1;15;161;Massanes;204;6;210
76;Occitanie;30;1;15;162;Massillargues-Attuech;669;15;684
76;Occitanie;30;2;15;163;Mauressargues;171;6;177
76;Occitanie;30;1;18;164;Méjannes-le-Clap;725;9;734
76;Occitanie;30;1;04;165;Méjannes-lès-Alès;1195;37;1232
76;Occitanie;30;2;16;166;Meynes;2542;151;2693
76;Occitanie;30;1;18;167;Meyrannes;791;16;807
76;Occitanie;30;1;08;168;Mialet;623;17;640
76;Occitanie;30;2;19;169;Milhaud;5821;136;5957
76;Occitanie;30;3;22;170;Molières-Cavaillac;912;31;943
76;Occitanie;30;1;18;171;Molières-sur-Cèze;1209;13;1222
76;Occitanie;30;3;15;172;Monoblet;767;8;775
76;Occitanie;30;1;03;173;Mons;1760;32;1792
76;Occitanie;30;2;20;174;Montaren-et-Saint-Médiers;1389;37;1426
76;Occitanie;30;2;14;175;Montclus;188;1;189
76;Occitanie;30;3;22;176;Montdardier;191;3;194
76;Occitanie;30;1;04;177;Monteils;647;10;657
76;Occitanie;30;2;17;178;Montfaucon;1521;38;1559
76;Occitanie;30;2;16;179;Montfrin;3149;50;3199
76;Occitanie;30;2;07;180;Montignargues;566;9;575
76;Occitanie;30;2;07;181;Montmirat;471;5;476
76;Occitanie;30;2;07;182;Montpezat;1388;24;1412
76;Occitanie;30;2;15;183;Moulézan;656;9;665
76;Occitanie;30;2;15;184;Moussac;1534;12;1546
76;Occitanie;30;2;21;185;Mus;1486;25;1511
76;Occitanie;30;2;07;186;Nages-et-Solorgues;2021;51;2072
76;Occitanie;30;1;18;187;Navacelles;304;8;312
76;Occitanie;30;1;15;188;Ners;712;13;725
76;Occitanie;30;2;99;189;Nîmes;147496;2265;149761
76;Occitanie;30;2;05;191;Orsan;1183;28;1211
76;Occitanie;30;3;15;192;Orthoux-Sérignac-Quilhan;435;12;447
76;Occitanie;30;2;07;193;Parignargues;711;6;717
76;Occitanie;30;1;18;194;Peyremale;277;3;280
76;Occitanie;30;3;22;195;Peyrolles;34;3;37
76;Occitanie;30;2;05;196;Le Pin;468;11;479
76;Occitanie;30;1;03;197;Les Plans;284;8;292
76;Occitanie;30;3;22;198;Les Plantiers;249;6;255
76;Occitanie;30;3;22;199;Pommiers;55;1;56
76;Occitanie;30;3;22;200;Pompignan;943;15;958
76;Occitanie;30;1;08;201;Ponteils-et-Brésis;372;5;377
76;Occitanie;30;2;14;202;Pont-Saint-Esprit;10482;178;10660
76;Occitanie;30;1;08;203;Portes;330;3;333
76;Occitanie;30;1;18;204;Potelières;358;5;363
76;Occitanie;30;2;20;205;Pougnadoresse;248;4;252
76;Occitanie;30;2;09;206;Poulx;4171;122;4293
76;Occitanie;30;2;16;207;Pouzilhac;739;15;754
76;Occitanie;30;3;15;208;Puechredon;46;0;46
76;Occitanie;30;2;23;209;Pujaut;3883;131;4014
76;Occitanie;30;3;15;210;Quissac;3333;33;3366
76;Occitanie;30;2;16;211;Redessan;4135;61;4196
76;Occitanie;30;2;16;212;Remoulins;2255;43;2298
76;Occitanie;30;3;22;213;Revens;20;0;20
76;Occitanie;30;1;02;214;Ribaute-les-Tavernes;2066;47;2113
76;Occitanie;30;1;18;215;Rivières;406;3;409
76;Occitanie;30;1;18;216;Robiac-Rochessadoule;834;14;848
76;Occitanie;30;2;23;217;Rochefort-du-Gard;7775;208;7983
76;Occitanie;30;1;18;218;Rochegude;253;5;258
76;Occitanie;30;3;22;219;Rogues;106;2;108
76;Occitanie;30;3;22;220;Roquedur;264;6;270
76;Occitanie;30;2;17;221;Roquemaure;5531;67;5598
76;Occitanie;30;2;14;222;La Roque-sur-Cèze;177;7;184
76;Occitanie;30;1;18;223;Rousson;4325;115;4440
76;Occitanie;30;2;07;224;La Rouvière;607;15;622
76;Occitanie;30;2;05;225;Sabran;1610;52;1662
76;Occitanie;30;2;14;226;Saint-Alexandre;1245;31;1276
76;Occitanie;30;1;18;227;Saint-Ambroix;3324;42;3366
76;Occitanie;30;2;20;228;Sainte-Anastasie;1740;33;1773
76;Occitanie;30;3;22;229;Saint-André-de-Majencoules;603;9;612
76;Occitanie;30;2;14;230;Saint-André-de-Roquepertuis;590;9;599
76;Occitanie;30;3;22;231;Saint-André-de-Valborgne;361;11;372
76;Occitanie;30;2;14;232;Saint-André-d'Olérargues;438;15;453
76;Occitanie;30;2;07;233;Saint-Bauzély;660;10;670
76;Occitanie;30;3;15;234;Saint-Bénézet;284;6;290
76;Occitanie;30;2;16;235;Saint-Bonnet-du-Gard;851;12;863
76;Occitanie;30;1;08;236;Saint-Bonnet-de-Salendrinque;115;3;118
76;Occitanie;30;1;18;237;Saint-Brès;648;10;658
76;Occitanie;30;3;22;238;Saint-Bresson;66;0;66
76;Occitanie;30;1;08;239;Sainte-Cécile-d'Andorge;572;9;581
76;Occitanie;30;1;04;240;Saint-Césaire-de-Gauzignan;388;3;391
76;Occitanie;30;2;20;241;Saint-Chaptes;1979;31;2010
76;Occitanie;30;2;14;242;Saint-Christol-de-Rodières;160;2;162
76;Occitanie;30;1;02;243;Saint-Christol-lez-Alès;7106;185;7291
76;Occitanie;30;2;07;244;Saint-Clément;354;6;360
76;Occitanie;30;2;19;245;Saint-Côme-et-Maruéjols;800;14;814
76;Occitanie;30;1;08;246;Sainte-Croix-de-Caderle;107;7;114
76;Occitanie;30;1;18;247;Saint-Denis;292;9;301
76;Occitanie;30;2;20;248;Saint-Dézéry;462;4;466
76;Occitanie;30;2;19;249;Saint-Dionisy;1073;13;1086
76;Occitanie;30;1;04;250;Saint-Étienne-de-l'Olm;401;7;408
76;Occitanie;30;2;05;251;Saint-Étienne-des-Sorts;540;11;551
76;Occitanie;30;3;15;252;Saint-Félix-de-Pallières;214;7;221
76;Occitanie;30;1;18;253;Saint-Florent-sur-Auzonnet;1169;17;1186
76;Occitanie;30;2;17;254;Saint-Geniès-de-Comolas;1999;39;2038
76;Occitanie;30;2;07;255;Saint-Geniès-de-Malgoirès;3067;33;3100
76;Occitanie;30;2;14;256;Saint-Gervais;781;16;797
76;Occitanie;30;2;16;257;Saint-Gervasy;1997;26;2023
76;Occitanie;30;2;19;258;Saint-Gilles;14197;116;14313
76;Occitanie;30;1;04;259;Saint-Hilaire-de-Brethmas;4598;81;4679
76;Occitanie;30;2;16;260;Saint-Hilaire-d'Ozilhan;1096;22;1118
76;Occitanie;30;1;04;261;Saint-Hippolyte-de-Caton;249;5;254
76;Occitanie;30;2;20;262;Saint-Hippolyte-de-Montaigu;253;12;265
76;Occitanie;30;3;22;263;Saint-Hippolyte-du-Fort;3752;134;3886
76;Occitanie;30;1;04;264;Saint-Jean-de-Ceyrargues;175;1;176
76;Occitanie;30;3;15;265;Saint-Jean-de-Crieulon;241;2;243
76;Occitanie;30;1;18;266;Saint-Jean-de-Maruéjols-et-Avéjan;852;11;863
76;Occitanie;30;1;15;267;Saint-Jean-de-Serres;523;11;534
76;Occitanie;30;1;18;268;Saint-Jean-de-Valériscle;605;15;620
76;Occitanie;30;1;08;269;Saint-Jean-du-Gard;2436;169;2605
76;Occitanie;30;1;02;270;Saint-Jean-du-Pin;1539;40;1579
76;Occitanie;30;1;18;271;Saint-Julien-de-Cassagnas;727;15;742
76;Occitanie;30;3;22;272;Saint-Julien-de-la-Nef;144;2;146
76;Occitanie;30;2;14;273;Saint-Julien-de-Peyrolas;1440;27;1467
76;Occitanie;30;1;18;274;Saint-Julien-les-Rosiers;3417;65;3482
76;Occitanie;30;1;03;275;Saint-Just-et-Vacquières;322;5;327
76;Occitanie;30;2;01;276;Saint-Laurent-d'Aigouze;3576;44;3620
76;Occitanie;30;2;14;277;Saint-Laurent-de-Carnols;500;9;509
76;Occitanie;30;2;17;278;Saint-Laurent-des-Arbres;2968;66;3034
76;Occitanie;30;2;20;279;Saint-Laurent-la-Vernède;672;16;688
76;Occitanie;30;3;22;280;Saint-Laurent-le-Minier;369;11;380
76;Occitanie;30;2;07;281;Saint-Mamert-du-Gard;1641;32;1673
76;Occitanie;30;2;14;282;Saint-Marcel-de-Careiret;867;19;886
76;Occitanie;30;3;22;283;Saint-Martial;183;2;185
76;Occitanie;30;1;03;284;Saint-Martin-de-Valgalgues;4592;62;4654
76;Occitanie;30;1;04;285;Saint-Maurice-de-Cazevieille;756;19;775
76;Occitanie;30;2;20;286;Saint-Maximin;778;18;796
76;Occitanie;30;2;14;287;Saint-Michel-d'Euzet;664;11;675
76;Occitanie;30;2;14;288;Saint-Nazaire;1269;20;1289
76;Occitanie;30;3;15;289;Saint-Nazaire-des-Gardies;87;0;87
76;Occitanie;30;2;14;290;Saint-Paulet-de-Caisson;1840;61;1901
76;Occitanie;30;1;08;291;Saint-Paul-la-Coste;303;7;310
76;Occitanie;30;2;05;292;Saint-Pons-la-Calm;467;13;480
76;Occitanie;30;1;18;293;Saint-Privat-de-Champclos;349;5;354
76;Occitanie;30;1;03;294;Saint-Privat-des-Vieux;5373;127;5500
76;Occitanie;30;2;20;295;Saint-Quentin-la-Poterie;3049;62;3111
76;Occitanie;30;3;22;296;Saint-Roman-de-Codières;156;6;162
76;Occitanie;30;3;22;297;Saint-Sauveur-Camprieu;221;11;232
76;Occitanie;30;1;08;298;Saint-Sébastien-d'Aigrefeuille;505;19;524
76;Occitanie;30;2;20;299;Saint-Siffret;1112;49;1161
76;Occitanie;30;3;15;300;Saint-Théodorit;541;11;552
76;Occitanie;30;2;20;301;Saint-Victor-des-Oules;313;4;317
76;Occitanie;30;2;17;302;Saint-Victor-la-Coste;2166;47;2213
76;Occitanie;30;1;18;303;Saint-Victor-de-Malcap;844;21;865
76;Occitanie;30;2;14;304;Salazac;188;3;191
76;Occitanie;30;1;03;305;Salindres;3651;44;3695
76;Occitanie;30;2;07;306;Salinelles;553;9;562
76;Occitanie;30;1;08;307;Les Salles-du-Gardon;2507;25;2532
76;Occitanie;30;2;20;308;Sanilhac-Sagriès;793;49;842
76;Occitanie;30;3;15;309;Sardan;348;1;349
76;Occitanie;30;3;22;310;Saumane;282;6;288
76;Occitanie;30;3;15;311;Sauve;1893;22;1915
76;Occitanie;30;2;17;312;Sauveterre;2045;46;2091
76;Occitanie;30;2;07;313;Sauzet;776;7;783
76;Occitanie;30;3;15;314;Savignargues;239;4;243
76;Occitanie;30;2;23;315;Saze;2112;39;2151
76;Occitanie;30;1;08;316;Sénéchas;242;6;248
76;Occitanie;30;2;16;317;Sernhac;1782;16;1798
76;Occitanie;30;1;03;318;Servas;207;4;211
76;Occitanie;30;2;20;319;Serviers-et-Labaume;627;24;651
76;Occitanie;30;1;03;320;Seynes;157;2;159
76;Occitanie;30;2;07;321;Sommières;5053;56;5109
76;Occitanie;30;3;22;322;Soudorgues;262;6;268
76;Occitanie;30;1;08;323;Soustelle;121;2;123
76;Occitanie;30;2;07;324;Souvignargues;883;15;898
76;Occitanie;30;3;22;325;Sumène;1308;33;1341
76;Occitanie;30;2;17;326;Tavel;2029;47;2076
76;Occitanie;30;1;18;327;Tharaux;55;2;57
76;Occitanie;30;2;16;328;Théziers;1035;19;1054
76;Occitanie;30;1;08;329;Thoiras;438;8;446
76;Occitanie;30;1;15;330;Tornac;947;26;973
76;Occitanie;30;2;05;331;Tresques;1803;40;1843
76;Occitanie;30;3;22;332;Trèves;111;1;112
76;Occitanie;30;2;21;333;Uchaud;4542;44;4586
76;Occitanie;30;2;20;334;Uzès;8390;331;8721
76;Occitanie;30;1;08;335;Vabres;137;4;141
76;Occitanie;30;2;06;336;Vallabrègues;1375;20;1395
76;Occitanie;30;2;20;337;Vallabrix;417;6;423
76;Occitanie;30;2;03;338;Vallérargues;139;2;141
76;Occitanie;30;3;22;339;Val-d'Aigoual;1419;28;1447
76;Occitanie;30;2;16;340;Valliguières;611;10;621
76;Occitanie;30;2;21;341;Vauvert;11465;108;11573
76;Occitanie;30;2;14;342;Vénéjan;1261;40;1301
76;Occitanie;30;2;14;343;Verfeuil;600;8;608
76;Occitanie;30;2;21;344;Vergèze;5465;71;5536
76;Occitanie;30;1;08;345;La Vernarède;347;1;348
76;Occitanie;30;2;16;346;Vers-Pont-du-Gard;1785;33;1818
76;Occitanie;30;2;21;347;Vestric-et-Candiac;1360;21;1381
76;Occitanie;30;1;04;348;Vézénobres;1824;103;1927
76;Occitanie;30;3;15;349;Vic-le-Fesq;561;3;564
76;Occitanie;30;3;22;350;Le Vigan;3708;116;3824
76;Occitanie;30;2;23;351;Villeneuve-lès-Avignon;12848;401;13249
76;Occitanie;30;2;07;352;Villevieille;1832;37;1869
76;Occitanie;30;3;22;353;Vissec;67;1;68
76;Occitanie;30;2;15;354;Montagnac;196;4;200
76;Occitanie;30;2;17;355;Saint-Paul-les-Fonts;1029;21;1050
76;Occitanie;30;2;09;356;Rodilhan;2836;164;3000
76;Occitanie;31;2;06;001;Agassac;120;2;122
76;Occitanie;31;3;07;002;Aignes;242;5;247
76;Occitanie;31;3;07;003;Aigrefeuille;1271;29;1300
76;Occitanie;31;3;07;004;Ayguesvives;2721;67;2788
76;Occitanie;31;2;06;005;Alan;291;8;299
76;Occitanie;31;3;13;006;Albiac;226;6;232
76;Occitanie;31;2;06;007;Ambax;62;0;62
76;Occitanie;31;2;06;008;Anan;258;3;261
76;Occitanie;31;2;02;009;Antichan-de-Frontignes;187;2;189
76;Occitanie;31;2;02;010;Antignac;90;1;91
76;Occitanie;31;2;02;011;Arbas;273;9;282
76;Occitanie;31;2;02;012;Arbon;97;2;99
76;Occitanie;31;2;02;013;Ardiège;354;11;365
76;Occitanie;31;2;02;014;Arguenos;86;4;90
76;Occitanie;31;2;02;015;Argut-Dessous;22;1;23
76;Occitanie;31;2;02;017;Arlos;102;2;104
76;Occitanie;31;2;02;018;Arnaud-Guilhem;228;5;233
76;Occitanie;31;2;02;019;Artigue;31;1;32
76;Occitanie;31;2;02;020;Aspet;888;62;950
76;Occitanie;31;2;14;021;Aspret-Sarrat;124;3;127
76;Occitanie;31;3;05;022;Aucamville;9245;95;9340
76;Occitanie;31;2;06;023;Aulon;311;7;318
76;Occitanie;31;1;07;024;Auragne;418;5;423
76;Occitanie;31;3;04;025;Aureville;969;16;985
76;Occitanie;31;3;13;026;Auriac-sur-Vendinelle;1062;21;1083
76;Occitanie;31;1;01;027;Auribail;198;5;203
76;Occitanie;31;2;06;028;Aurignac;1242;70;1312
76;Occitanie;31;3;13;029;Aurin;344;6;350
76;Occitanie;31;2;02;030;Ausseing;80;1;81
76;Occitanie;31;2;14;031;Ausson;592;18;610
76;Occitanie;31;3;03;032;Aussonne;7265;83;7348
76;Occitanie;31;1;01;033;Auterive;9966;96;10062
76;Occitanie;31;2;02;034;Auzas;227;9;236
76;Occitanie;31;3;04;035;Auzeville-Tolosane;4075;247;4322
76;Occitanie;31;3;04;036;Auzielle;1587;48;1635
76;Occitanie;31;3;13;037;Avignonet-Lauragais;1615;12;1627
76;Occitanie;31;3;10;038;Azas;664;11;675
76;Occitanie;31;2;06;039;Bachas;86;2;88
76;Occitanie;31;2;02;040;Bachos;35;1;36
76;Occitanie;31;2;02;041;Bagiry;112;2;114
76;Occitanie;31;2;02;042;Bagnères-de-Luchon;2222;146;2368
76;Occitanie;31;2;14;043;Balesta;137;6;143
76;Occitanie;31;3;24;044;Balma;17006;294;17300
76;Occitanie;31;2;02;045;Barbazan;498;10;508
76;Occitanie;31;2;02;046;Baren;12;0;12
76;Occitanie;31;1;01;047;Bax;93;1;94
76;Occitanie;31;3;07;048;Baziège;3456;46;3502
76;Occitanie;31;3;10;049;Bazus;592;14;606
76;Occitanie;31;2;02;050;Beauchalot;645;7;652
76;Occitanie;31;1;06;051;Beaufort;472;10;482
76;Occitanie;31;1;01;052;Beaumont-sur-Lèze;1590;32;1622
76;Occitanie;31;3;24;053;Beaupuy;1302;30;1332
76;Occitanie;31;3;13;054;Beauteville;186;1;187
76;Occitanie;31;3;13;055;Beauville;173;3;176
76;Occitanie;31;3;03;056;Beauzelle;7127;89;7216
76;Occitanie;31;3;07;057;Belberaud;1520;53;1573
76;Occitanie;31;3;07;058;Belbèze-de-Lauragais;129;1;130
76;Occitanie;31;2;02;059;Belbèze-en-Comminges;114;6;120
76;Occitanie;31;3;13;060;Bélesta-en-Lauragais;109;5;114
76;Occitanie;31;3;08;061;Bellegarde-Sainte-Marie;195;9;204
76;Occitanie;31;3;08;062;Bellesserre;105;4;109
76;Occitanie;31;2;06;063;Benque;168;2;170
76;Occitanie;31;2;02;064;Benque-Dessous-et-Dessus;28;0;28
76;Occitanie;31;1;06;065;Bérat;3063;60;3123
76;Occitanie;31;3;27;066;Bessières;4194;64;4258
76;Occitanie;31;2;02;067;Bezins-Garraux;41;0;41
76;Occitanie;31;2;02;068;Billière;29;0;29
76;Occitanie;31;3;03;069;Blagnac;26101;499;26600
76;Occitanie;31;2;14;070;Blajan;446;8;454
76;Occitanie;31;1;01;071;Bois-de-la-Pierre;447;9;456
76;Occitanie;31;2;06;072;Boissède;68;2;70
76;Occitanie;31;3;27;073;Bondigoux;720;21;741
76;Occitanie;31;3;10;074;Bonrepos-Riquet;289;8;297
76;Occitanie;31;1;11;075;Bonrepos-sur-Aussonnelle;1249;23;1272
76;Occitanie;31;2;14;076;Bordes-de-Rivière;470;13;483
76;Occitanie;31;3;27;077;Le Born;619;16;635
76;Occitanie;31;2;14;078;Boudrac;147;2;149
76;Occitanie;31;3;27;079;Bouloc;4754;91;4845
76;Occitanie;31;2;14;080;Boulogne-sur-Gesse;1654;34;1688
76;Occitanie;31;2;02;081;Bourg-d'Oueil;7;0;7
76;Occitanie;31;3;13;082;Bourg-Saint-Bernard;1110;14;1124
76;Occitanie;31;2;06;083;Boussan;234;2;236
76;Occitanie;31;1;06;084;Boussens;1054;23;1077
76;Occitanie;31;2;02;085;Boutx;253;3;256
76;Occitanie;31;2;06;086;Bouzin;86;4;90
76;Occitanie;31;1;11;087;Bragayrac;317;2;319
76;Occitanie;31;3;21;088;Brax;2887;96;2983
76;Occitanie;31;3;08;089;Bretx;675;18;693
76;Occitanie;31;3;08;090;Brignemont;369;5;374
76;Occitanie;31;3;05;091;Bruguières;6005;106;6111
76;Occitanie;31;2;02;092;Burgalays;119;0;119
76;Occitanie;31;3;08;093;Le Burgaud;943;11;954
76;Occitanie;31;3;27;094;Buzet-sur-Tarn;2859;51;2910
76;Occitanie;31;2;02;095;Cabanac-Cazaux;129;2;131
76;Occitanie;31;3;08;096;Cabanac-Séguenville;179;2;181
76;Occitanie;31;3;13;097;Le Cabanial;463;13;476
76;Occitanie;31;3;08;098;Cadours;1102;19;1121
76;Occitanie;31;3;07;099;Caignac;409;4;413
76;Occitanie;31;3;07;100;Calmont;2371;32;2403
76;Occitanie;31;1;06;101;Cambernard;477;4;481
76;Occitanie;31;3;13;102;Cambiac;227;3;230
76;Occitanie;31;1;01;103;Canens;58;0;58
76;Occitanie;31;1;01;104;Capens;677;13;690
76;Occitanie;31;3;13;105;Caragoudes;231;5;236
76;Occitanie;31;3;13;106;Caraman;2524;62;2586
76;Occitanie;31;1;01;107;Carbonne;5841;113;5954
76;Occitanie;31;2;14;108;Cardeilhac;265;7;272
76;Occitanie;31;2;06;109;Cassagnabère-Tournas;467;4;471
76;Occitanie;31;2;02;110;Cassagne;645;14;659
76;Occitanie;31;1;01;111;Castagnac;293;4;297
76;Occitanie;31;2;02;112;Castagnède;189;5;194
76;Occitanie;31;3;04;113;Castanet-Tolosan;14377;259;14636
76;Occitanie;31;2;02;114;Castelbiague;241;3;244
76;Occitanie;31;2;06;115;Castelgaillard;58;1;59
76;Occitanie;31;3;05;116;Castelginest;10784;117;10901
76;Occitanie;31;3;10;117;Castelmaurou;4406;102;4508
76;Occitanie;31;3;27;118;Castelnau-d'Estrétefonds;6689;107;6796
76;Occitanie;31;1;06;119;Castelnau-Picampeau;209;5;214
76;Occitanie;31;3;08;120;Le Castéra;745;18;763
76;Occitanie;31;2;14;121;Castéra-Vignoles;61;1;62
76;Occitanie;31;1;06;122;Casties-Labrande;107;2;109
76;Occitanie;31;2;02;123;Castillon-de-Larboust;76;1;77
76;Occitanie;31;2;02;124;Castillon-de-Saint-Martory;392;9;401
76;Occitanie;31;2;02;125;Cathervielle;36;0;36
76;Occitanie;31;3;08;126;Caubiac;411;10;421
76;Occitanie;31;2;02;127;Caubous;4;1;5
76;Occitanie;31;1;01;128;Caujac;856;22;878
76;Occitanie;31;2;02;129;Cazarilh-Laspènes;16;4;20
76;Occitanie;31;2;14;130;Cazaril-Tambourès;85;3;88
76;Occitanie;31;2;02;131;Cazaunous;69;1;70
76;Occitanie;31;2;02;132;Cazaux-Layrisse;66;1;67
76;Occitanie;31;2;02;133;Cazeaux-de-Larboust;102;4;106
76;Occitanie;31;2;06;134;Cazeneuve-Montaut;85;0;85
76;Occitanie;31;1;06;135;Cazères;4753;71;4824
76;Occitanie;31;3;27;136;Cépet;2224;28;2252
76;Occitanie;31;3;13;137;Cessales;158;0;158
76;Occitanie;31;2;14;138;Charlas;250;5;255
76;Occitanie;31;2;02;139;Chaum;195;6;201
76;Occitanie;31;2;02;140;Chein-Dessus;187;4;191
76;Occitanie;31;2;14;141;Ciadoux;220;2;222
76;Occitanie;31;2;02;142;Cier-de-Luchon;234;6;240
76;Occitanie;31;2;02;143;Cier-de-Rivière;274;5;279
76;Occitanie;31;2;02;144;Cierp-Gaud;719;14;733
76;Occitanie;31;1;01;145;Cintegabelle;2959;65;3024
76;Occitanie;31;2;02;146;Cirès;14;0;14
76;Occitanie;31;2;14;147;Clarac;668;12;680
76;Occitanie;31;3;04;148;Clermont-le-Fort;518;17;535
76;Occitanie;31;3;21;149;Colomiers;39866;476;40342
76;Occitanie;31;3;03;150;Cornebarrieu;7715;112;7827
76;Occitanie;31;3;07;151;Corronsac;871;28;899
76;Occitanie;31;2;06;152;Coueilles;95;5;100
76;Occitanie;31;1;06;153;Couladère;412;12;424
76;Occitanie;31;2;02;155;Couret;229;3;232
76;Occitanie;31;3;08;156;Cox;366;12;378
76;Occitanie;31;3;26;157;Cugnaux;20100;258;20358
76;Occitanie;31;2;14;158;Cuguron;174;7;181
76;Occitanie;31;2;14;159;Le Cuing;476;4;480
76;Occitanie;31;3;08;160;Daux;2440;28;2468
76;Occitanie;31;3;07;161;Deyme;1300;24;1324
76;Occitanie;31;3;07;162;Donneville;1117;86;1203
76;Occitanie;31;3;24;163;Drémil-Lafage;2649;65;2714
76;Occitanie;31;3;08;164;Drudas;201;6;207
76;Occitanie;31;1;12;165;Eaunes;6448;99;6547
76;Occitanie;31;1;11;166;Empeaux;291;4;295
76;Occitanie;31;2;02;167;Encausse-les-Thermes;699;14;713
76;Occitanie;31;2;06;168;Eoux;130;0;130
76;Occitanie;31;3;07;169;Escalquens;6982;129;7111
76;Occitanie;31;2;14;170;Escanecrabe;232;2;234
76;Occitanie;31;3;07;171;Espanès;290;9;299
76;Occitanie;31;2;06;172;Esparron;42;1;43
76;Occitanie;31;1;01;173;Esperce;266;4;270
76;Occitanie;31;2;02;174;Estadens;534;4;538
76;Occitanie;31;2;14;175;Estancarbon;610;10;620
76;Occitanie;31;2;02;176;Esténos;192;5;197
76;Occitanie;31;2;02;177;Eup;135;2;137
76;Occitanie;31;2;06;178;Fabas;200;4;204
76;Occitanie;31;3;13;179;Le Faget;312;19;331
76;Occitanie;31;3;13;180;Falga;143;6;149
76;Occitanie;31;1;09;181;Le Fauga;2178;28;2206
76;Occitanie;31;3;05;182;Fenouillet;5462;47;5509
76;Occitanie;31;2;02;183;Figarol;315;8;323
76;Occitanie;31;3;24;184;Flourens;2048;38;2086
76;Occitanie;31;3;13;185;Folcarde;115;1;116
76;Occitanie;31;3;05;186;Fonbeauzard;2993;29;3022
76;Occitanie;31;1;11;187;Fonsorbes;12119;335;12454
76;Occitanie;31;1;11;188;Fontenilles;5872;160;6032
76;Occitanie;31;1;06;189;Forgues;223;4;227
76;Occitanie;31;2;02;190;Fos;232;0;232
76;Occitanie;31;2;02;191;Fougaron;100;1;101
76;Occitanie;31;3;07;192;Fourquevaux;774;22;796
76;Occitanie;31;1;06;193;Le Fousseret;1895;33;1928
76;Occitanie;31;3;13;194;Francarville;174;2;176
76;Occitanie;31;2;02;195;Francazal;30;0;30
76;Occitanie;31;1;06;196;Francon;242;3;245
76;Occitanie;31;2;14;197;Franquevielle;331;8;339
76;Occitanie;31;2;02;198;Le Fréchet;103;3;106
76;Occitanie;31;2;02;199;Fronsac;195;8;203
76;Occitanie;31;2;02;200;Frontignan-de-Comminges;78;4;82
76;Occitanie;31;2;06;201;Frontignan-Savès;71;2;73
76;Occitanie;31;3;27;202;Fronton;6413;122;6535
76;Occitanie;31;1;09;203;Frouzins;9382;164;9546
76;Occitanie;31;1;06;204;Fustignac;79;2;81
76;Occitanie;31;3;05;205;Gagnac-sur-Garonne;3161;31;3192
76;Occitanie;31;1;01;206;Gaillac-Toulza;1320;15;1335
76;Occitanie;31;2;02;207;Galié;81;6;87
76;Occitanie;31;2;02;208;Ganties;320;5;325
76;Occitanie;31;3;08;209;Garac;153;6;159
76;Occitanie;31;3;13;210;Gardouch;1312;32;1344
76;Occitanie;31;3;27;211;Gargas;703;8;711
76;Occitanie;31;3;10;212;Garidech;1918;26;1944
76;Occitanie;31;2;02;213;Garin;158;5;163
76;Occitanie;31;3;10;215;Gauré;465;15;480
76;Occitanie;31;3;10;216;Gémil;279;10;289
76;Occitanie;31;2;02;217;Génos;71;1;72
76;Occitanie;31;2;14;218;Gensac-de-Boulogne;113;4;117
76;Occitanie;31;1;01;219;Gensac-sur-Garonne;448;4;452
76;Occitanie;31;3;07;220;Gibel;383;5;388
76;Occitanie;31;2;02;221;Gouaux-de-Larboust;56;1;57
76;Occitanie;31;2;02;222;Gouaux-de-Luchon;45;1;46
76;Occitanie;31;2;06;223;Goudex;41;1;42
76;Occitanie;31;2;02;224;Gourdan-Polignan;1182;183;1365
76;Occitanie;31;1;01;225;Goutevernisse;185;3;188
76;Occitanie;31;1;01;226;Gouzens;81;5;86
76;Occitanie;31;3;04;227;Goyrans;843;37;880
76;Occitanie;31;3;10;228;Gragnague;2141;48;2189
76;Occitanie;31;1;06;229;Gratens;706;18;724
76;Occitanie;31;3;05;230;Gratentour;4501;82;4583
76;Occitanie;31;1;01;231;Grazac;743;9;752
76;Occitanie;31;3;08;232;Grenade;8846;170;9016
76;Occitanie;31;1;01;233;Grépiac;1003;33;1036
76;Occitanie;31;3;08;234;Le Grès;443;8;451
76;Occitanie;31;2;02;235;Guran;49;0;49
76;Occitanie;31;2;02;236;Herran;71;1;72
76;Occitanie;31;2;02;237;His;236;29;265
76;Occitanie;31;2;02;238;Huos;482;10;492
76;Occitanie;31;2;06;239;L'Isle-en-Dodon;1636;26;1662
76;Occitanie;31;3;07;240;Issus;620;8;628
76;Occitanie;31;2;02;241;Izaut-de-l'Hôtel;295;5;300
76;Occitanie;31;2;02;242;Jurvielle;17;2;19
76;Occitanie;31;3;13;243;Juzes;67;4;71
76;Occitanie;31;2;02;244;Juzet-de-Luchon;378;17;395
76;Occitanie;31;2;02;245;Juzet-d'Izaut;188;5;193
76;Occitanie;31;2;14;246;Labarthe-Inard;867;15;882
76;Occitanie;31;2;14;247;Labarthe-Rivière;1299;28;1327
76;Occitanie;31;1;12;248;Labarthe-sur-Lèze;6364;115;6479
76;Occitanie;31;3;07;249;Labastide-Beauvoir;1248;26;1274
76;Occitanie;31;1;06;250;Labastide-Clermont;680;17;697
76;Occitanie;31;2;06;251;Labastide-Paumès;147;1;148
76;Occitanie;31;3;10;252;Labastide-Saint-Sernin;1954;46;2000
76;Occitanie;31;1;09;253;Labastidette;2940;41;2981
76;Occitanie;31;3;04;254;Labège;4122;146;4268
76;Occitanie;31;2;02;255;Labroquère;322;10;332
76;Occitanie;31;1;01;256;Labruyère-Dorsa;293;6;299
76;Occitanie;31;1;01;258;Lacaugne;242;6;248
76;Occitanie;31;3;04;259;Lacroix-Falgarde;2089;49;2138
76;Occitanie;31;2;02;260;Laffite-Toupière;98;1;99
76;Occitanie;31;1;01;261;Lafitte-Vigordane;1201;44;1245
76;Occitanie;31;3;13;262;Lagarde;429;11;440
76;Occitanie;31;1;12;263;Lagardelle-sur-Lèze;3231;57;3288
76;Occitanie;31;1;01;264;Lagrâce-Dieu;563;7;570
76;Occitanie;31;3;08;265;Lagraulet-Saint-Nicolas;256;6;262
76;Occitanie;31;1;06;266;Lahage;196;1;197
76;Occitanie;31;1;01;267;Lahitère;62;2;64
76;Occitanie;31;2;14;268;Lalouret-Laffiteau;135;3;138
76;Occitanie;31;1;09;269;Lamasquère;1558;23;1581
76;Occitanie;31;2;14;270;Landorthe;1018;29;1047
76;Occitanie;31;3;13;271;Lanta;2197;42;2239
76;Occitanie;31;1;01;272;Lapeyrère;63;3;66
76;Occitanie;31;3;10;273;Lapeyrouse-Fossat;2919;70;2989
76;Occitanie;31;2;14;274;Larcan;185;5;190
76;Occitanie;31;3;08;275;Laréole;161;5;166
76;Occitanie;31;2;14;276;Larroque;289;5;294
76;Occitanie;31;3;08;277;Lasserre-Pradère;1622;44;1666
76;Occitanie;31;2;06;278;Latoue;313;4;317
76;Occitanie;31;1;01;279;Latour;76;1;77
76;Occitanie;31;1;01;280;Latrape;395;8;403
76;Occitanie;31;3;08;281;Launac;1323;32;1355
76;Occitanie;31;3;22;282;Launaguet;9309;116;9425
76;Occitanie;31;1;06;283;Lautignac;260;3;263
76;Occitanie;31;3;07;284;Lauzerville;1653;56;1709
76;Occitanie;31;3;10;285;Lavalette;773;13;786
76;Occitanie;31;1;01;286;Lavelanet-de-Comminges;628;7;635
76;Occitanie;31;1;09;287;Lavernose-Lacasse;3394;88;3482
76;Occitanie;31;3;27;288;Layrac-sur-Tarn;317;9;326
76;Occitanie;31;2;14;289;Lécussan;284;3;287
76;Occitanie;31;2;02;290;Lège;33;3;36
76;Occitanie;31;3;08;291;Léguevin;9361;254;9615
76;Occitanie;31;1;06;292;Lescuns;73;1;74
76;Occitanie;31;3;05;293;Lespinasse;2862;22;2884
76;Occitanie;31;2;14;294;Lespiteau;85;1;86
76;Occitanie;31;2;14;295;Lespugue;86;0;86
76;Occitanie;31;2;02;296;Lestelle-de-Saint-Martory;435;11;446
76;Occitanie;31;3;08;297;Lévignac;2206;43;2249
76;Occitanie;31;1;06;299;Lherm;3804;83;3887
76;Occitanie;31;2;14;300;Lieoux;127;3;130
76;Occitanie;31;2;06;301;Lilhac;129;1;130
76;Occitanie;31;2;14;302;Lodes;295;7;302
76;Occitanie;31;1;01;303;Longages;3213;37;3250
76;Occitanie;31;3;13;304;Loubens-Lauragais;452;11;463
76;Occitanie;31;2;14;305;Loudet;199;6;205
76;Occitanie;31;2;02;306;Lourde;93;0;93
76;Occitanie;31;2;02;308;Luscan;47;0;47
76;Occitanie;31;1;06;309;Lussan-Adeilhac;232;2;234
76;Occitanie;31;3;13;310;Lux;340;5;345
76;Occitanie;31;3;27;311;La Magdelaine-sur-Tarn;1200;22;1222
76;Occitanie;31;1;01;312;Mailholas;35;1;36
76;Occitanie;31;2;02;313;Malvezie;108;2;110
76;Occitanie;31;2;02;314;Mancioux;378;7;385
76;Occitanie;31;2;02;315;Mane;958;48;1006
76;Occitanie;31;2;02;316;Marignac;497;6;503
76;Occitanie;31;1;06;317;Marignac-Lasclares;465;9;474
76;Occitanie;31;1;06;318;Marignac-Laspeyres;200;5;205
76;Occitanie;31;1;01;319;Marliac;135;1;136
76;Occitanie;31;1;01;320;Marquefave;951;41;992
76;Occitanie;31;2;02;321;Marsoulas;130;7;137
76;Occitanie;31;2;06;322;Martisserre;66;2;68
76;Occitanie;31;2;02;323;Martres-de-Rivière;373;10;383
76;Occitanie;31;1;06;324;Martres-Tolosane;2407;43;2450
76;Occitanie;31;3;13;325;Mascarville;185;5;190
76;Occitanie;31;1;01;326;Massabrac;98;0;98
76;Occitanie;31;1;06;327;Mauran;205;1;206
76;Occitanie;31;3;13;328;Mauremont;322;10;332
76;Occitanie;31;3;13;329;Maurens;208;3;211
76;Occitanie;31;1;01;330;Mauressac;500;11;511
76;Occitanie;31;3;13;331;Maureville;305;12;317
76;Occitanie;31;3;07;332;Mauvaisin;214;4;218
76;Occitanie;31;2;06;333;Mauvezin;87;3;90
76;Occitanie;31;1;01;334;Mauzac;1327;24;1351
76;Occitanie;31;2;02;335;Mayrègne;27;0;27
76;Occitanie;31;2;02;336;Mazères-sur-Salat;637;12;649
76;Occitanie;31;2;02;337;Melles;90;1;91
76;Occitanie;31;3;08;338;Menville;788;23;811
76;Occitanie;31;3;08;339;Mérenvielle;491;6;497
76;Occitanie;31;3;04;340;Mervilla;290;9;299
76;Occitanie;31;3;08;341;Merville;6241;88;6329
76;Occitanie;31;2;02;342;Milhas;179;3;182
76;Occitanie;31;2;06;343;Mirambeau;61;0;61
76;Occitanie;31;2;14;344;Miramont-de-Comminges;759;13;772
76;Occitanie;31;1;01;345;Miremont;2687;37;2724
76;Occitanie;31;3;27;346;Mirepoix-sur-Tarn;1114;19;1133
76;Occitanie;31;2;06;347;Molas;166;3;169
76;Occitanie;31;2;02;348;Moncaup;36;0;36
76;Occitanie;31;1;06;349;Mondavezan;911;17;928
76;Occitanie;31;2;14;350;Mondilhan;81;1;82
76;Occitanie;31;3;03;351;Mondonville;5483;99;5582
76;Occitanie;31;3;24;352;Mondouzil;219;11;230
76;Occitanie;31;1;06;353;Monès;84;0;84
76;Occitanie;31;3;07;354;Monestrol;51;0;51
76;Occitanie;31;3;24;355;Mons;1789;44;1833
76;Occitanie;31;3;08;356;Montaigut-sur-Save;1897;48;1945
76;Occitanie;31;2;02;357;Montastruc-de-Salies;310;4;314
76;Occitanie;31;3;10;358;Montastruc-la-Conseillère;3616;104;3720
76;Occitanie;31;1;06;359;Montastruc-Savès;66;2;68
76;Occitanie;31;2;02;360;Montauban-de-Luchon;521;8;529
76;Occitanie;31;1;01;361;Montaut;512;5;517
76;Occitanie;31;1;06;362;Montberaud;199;6;205
76;Occitanie;31;2;06;363;Montbernard;215;5;220
76;Occitanie;31;3;10;364;Montberon;3099;57;3156
76;Occitanie;31;1;01;365;Montbrun-Bocage;506;9;515
76;Occitanie;31;3;07;366;Montbrun-Lauragais;679;22;701
76;Occitanie;31;1;06;367;Montclar-de-Comminges;74;5;79
76;Occitanie;31;3;13;368;Montclar-Lauragais;240;13;253
76;Occitanie;31;2;02;369;Mont-de-Galié;36;4;40
76;Occitanie;31;1;06;370;Montégut-Bourjac;138;0;138
76;Occitanie;31;3;13;371;Montégut-Lauragais;418;15;433
76;Occitanie;31;2;02;372;Montespan;460;9;469
76;Occitanie;31;2;06;373;Montesquieu-Guittaut;177;5;182
76;Occitanie;31;3;13;374;Montesquieu-Lauragais;1025;13;1038
76;Occitanie;31;1;01;375;Montesquieu-Volvestre;3109;51;3160
76;Occitanie;31;2;02;376;Montgaillard-de-Salies;105;3;108
76;Occitanie;31;3;13;377;Montgaillard-Lauragais;695;9;704
76;Occitanie;31;2;14;378;Montgaillard-sur-Save;77;4;81
76;Occitanie;31;1;01;379;Montgazin;169;2;171
76;Occitanie;31;3;07;380;Montgeard;525;8;533
76;Occitanie;31;3;07;381;Montgiscard;2561;62;2623
76;Occitanie;31;1;06;382;Montgras;111;2;113
76;Occitanie;31;3;10;383;Montjoire;1299;26;1325
76;Occitanie;31;3;07;384;Montlaur;1791;36;1827
76;Occitanie;31;2;14;385;Montmaurin;197;5;202
76;Occitanie;31;2;06;386;Montoulieu-Saint-Bernard;217;6;223
76;Occitanie;31;1;06;387;Montoussin;129;0;129
76;Occitanie;31;3;10;388;Montpitol;371;12;383
76;Occitanie;31;3;24;389;Montrabé;4099;77;4176
76;Occitanie;31;2;14;390;Montréjeau;2726;32;2758
76;Occitanie;31;2;02;391;Montsaunès;454;31;485
76;Occitanie;31;3;13;392;Mourvilles-Basses;80;4;84
76;Occitanie;31;3;13;393;Mourvilles-Hautes;166;5;171
76;Occitanie;31;2;02;394;Moustajon;126;3;129
76;Occitanie;31;1;09;395;Muret;24762;574;25336
76;Occitanie;31;3;07;396;Nailloux;3955;64;4019
76;Occitanie;31;2;14;397;Nénigan;52;1;53
76;Occitanie;31;2;14;398;Nizan-Gesse;96;1;97
76;Occitanie;31;1;01;399;Noé;2938;63;3001
76;Occitanie;31;3;13;400;Nogaret;93;0;93
76;Occitanie;31;3;07;401;Noueilles;389;6;395
76;Occitanie;31;3;07;402;Odars;908;31;939
76;Occitanie;31;3;08;403;Ondes;775;133;908
76;Occitanie;31;2;02;404;Oô;102;4;106
76;Occitanie;31;2;02;405;Ore;121;3;124
76;Occitanie;31;1;06;406;Palaminy;814;10;824
76;Occitanie;31;3;10;407;Paulhac;1241;29;1270
76;Occitanie;31;2;02;408;Payssous;86;0;86
76;Occitanie;31;3;04;409;Péchabou;2363;55;2418
76;Occitanie;31;3;10;410;Pechbonnieu;4624;90;4714
76;Occitanie;31;3;04;411;Pechbusque;996;24;1020
76;Occitanie;31;2;14;412;Péguilhan;263;8;271
76;Occitanie;31;3;08;413;Pelleport;520;18;538
76;Occitanie;31;2;06;414;Peyrissas;77;2;79
76;Occitanie;31;2;06;415;Peyrouzet;80;2;82
76;Occitanie;31;1;01;416;Peyssies;619;8;627
76;Occitanie;31;3;21;417;Pibrac;8523;253;8776
76;Occitanie;31;3;24;418;Pin-Balma;954;33;987
76;Occitanie;31;1;06;419;Le Pin-Murelet;172;4;176
76;Occitanie;31;1;12;420;Pinsaguel;2829;37;2866
76;Occitanie;31;1;12;421;Pins-Justaret;4335;76;4411
76;Occitanie;31;1;06;422;Plagne;94;0;94
76;Occitanie;31;1;06;423;Plagnole;318;3;321
76;Occitanie;31;3;11;424;Plaisance-du-Touch;19462;442;19904
76;Occitanie;31;1;06;425;Le Plan;439;10;449
76;Occitanie;31;2;02;426;Pointis-de-Rivière;857;12;869
76;Occitanie;31;2;14;427;Pointis-Inard;934;19;953
76;Occitanie;31;1;06;428;Polastron;53;2;55
76;Occitanie;31;3;07;429;Pompertuzat;2298;35;2333
76;Occitanie;31;2;14;430;Ponlat-Taillebourg;600;16;616
76;Occitanie;31;2;02;431;Portet-d'Aspet;59;1;60
76;Occitanie;31;2;02;432;Portet-de-Luchon;39;3;42
76;Occitanie;31;1;12;433;Portet-sur-Garonne;9832;123;9955
76;Occitanie;31;2;02;434;Poubeau;79;4;83
76;Occitanie;31;1;06;435;Poucharramet;956;14;970
76;Occitanie;31;1;06;436;Pouy-de-Touges;419;5;424
76;Occitanie;31;3;07;437;Pouze;83;4;87
76;Occitanie;31;3;07;439;Préserville;723;17;740
76;Occitanie;31;2;02;440;Proupiary;69;1;70
76;Occitanie;31;3;13;441;Prunet;149;4;153
76;Occitanie;31;1;01;442;Puydaniel;555;10;565
76;Occitanie;31;2;06;443;Puymaurin;297;7;304
76;Occitanie;31;3;08;444;Puysségur;135;4;139
76;Occitanie;31;3;24;445;Quint-Fonsegrives;5950;88;6038
76;Occitanie;31;3;25;446;Ramonville-Saint-Agne;14730;287;15017
76;Occitanie;31;2;02;447;Razecueillé;34;1;35
76;Occitanie;31;3;04;448;Rebigue;475;25;500
76;Occitanie;31;2;14;449;Régades;137;4;141
76;Occitanie;31;3;13;450;Renneville;543;13;556
76;Occitanie;31;3;13;451;Revel;9652;295;9947
76;Occitanie;31;2;14;452;Rieucazé;58;0;58
76;Occitanie;31;3;13;453;Rieumajou;137;5;142
76;Occitanie;31;1;06;454;Rieumes;3659;87;3746
76;Occitanie;31;1;01;455;Rieux-Volvestre;2627;57;2684
76;Occitanie;31;2;06;456;Riolas;52;1;53
76;Occitanie;31;2;02;457;Roquefort-sur-Garonne;794;13;807
76;Occitanie;31;1;12;458;Roques;4939;54;4993
76;Occitanie;31;3;10;459;Roquesérière;763;19;782
76;Occitanie;31;1;12;460;Roquettes;4294;71;4365
76;Occitanie;31;2;02;461;Rouède;288;3;291
76;Occitanie;31;3;10;462;Rouffiac-Tolosan;1989;42;2031
76;Occitanie;31;3;13;463;Roumens;250;4;254
76;Occitanie;31;1;11;464;Sabonnères;327;9;336
76;Occitanie;31;2;02;465;Saccourvielle;20;0;20
76;Occitanie;31;1;11;466;Saiguède;807;17;824
76;Occitanie;31;3;05;467;Saint-Alban;6269;50;6319
76;Occitanie;31;2;06;468;Saint-André;237;8;245
76;Occitanie;31;1;06;469;Saint-Araille;129;3;132
76;Occitanie;31;2;02;470;Saint-Aventin;62;4;66
76;Occitanie;31;2;02;471;Saint-Béat-Lez;383;3;386
76;Occitanie;31;2;02;472;Saint-Bertrand-de-Comminges;237;5;242
76;Occitanie;31;3;08;473;Saint-Cézert;436;1;437
76;Occitanie;31;1;01;474;Saint-Christaud;237;5;242
76;Occitanie;31;1;09;475;Saint-Clar-de-Rivière;1495;31;1526
76;Occitanie;31;1;06;476;Saint-Élix-le-Château;921;21;942
76;Occitanie;31;2;06;477;Saint-Élix-Séglan;43;0;43
76;Occitanie;31;3;13;478;Saint-Félix-Lauragais;1261;36;1297
76;Occitanie;31;2;14;479;Saint-Ferréol-de-Comminges;61;1;62
76;Occitanie;31;3;07;480;Sainte-Foy-d'Aigrefeuille;2312;69;2381
76;Occitanie;31;1;06;481;Sainte-Foy-de-Peyrolières;2101;48;2149
76;Occitanie;31;2;06;482;Saint-Frajou;214;2;216
76;Occitanie;31;2;14;483;Saint-Gaudens;11664;540;12204
76;Occitanie;31;3;10;484;Saint-Geniès-Bellevue;2512;59;2571
76;Occitanie;31;3;13;485;Saint-Germier;118;2;120
76;Occitanie;31;1;09;486;Saint-Hilaire;1571;25;1596
76;Occitanie;31;2;14;487;Saint-Ignan;229;5;234
76;Occitanie;31;3;23;488;Saint-Jean;11114;145;11259
76;Occitanie;31;3;10;489;Saint-Jean-Lherm;394;12;406
76;Occitanie;31;3;05;490;Saint-Jory;6777;76;6853
76;Occitanie;31;3;13;491;Saint-Julia;413;11;424
76;Occitanie;31;1;01;492;Saint-Julien-sur-Garonne;551;7;558
76;Occitanie;31;2;14;493;Saint-Lary-Boujean;127;6;133
76;Occitanie;31;2;06;494;Saint-Laurent;178;1;179
76;Occitanie;31;3;07;495;Saint-Léon;1300;13;1313
76;Occitanie;31;3;08;496;Sainte-Livrade;258;13;271
76;Occitanie;31;3;10;497;Saint-Loup-Cammas;2315;48;2363
76;Occitanie;31;2;14;498;Saint-Loup-en-Comminges;38;0;38
76;Occitanie;31;1;11;499;Saint-Lys;9555;182;9737
76;Occitanie;31;2;02;500;Saint-Mamet;554;18;572
76;Occitanie;31;3;10;501;Saint-Marcel-Paulel;439;7;446
76;Occitanie;31;2;14;502;Saint-Marcet;362;9;371
76;Occitanie;31;2;02;503;Saint-Martory;1056;11;1067
76;Occitanie;31;2;02;504;Saint-Médard;224;16;240
76;Occitanie;31;1;06;505;Saint-Michel;316;6;322
76;Occitanie;31;3;04;506;Saint-Orens-de-Gameville;13163;238;13401
76;Occitanie;31;3;08;507;Saint-Paul-sur-Save;1615;25;1640
76;Occitanie;31;2;02;508;Saint-Paul-d'Oueil;34;2;36
76;Occitanie;31;2;02;509;Saint-Pé-d'Ardet;159;3;162
76;Occitanie;31;2;14;510;Saint-Pé-Delbosc;143;0;143
76;Occitanie;31;3;10;511;Saint-Pierre;247;8;255
76;Occitanie;31;3;13;512;Saint-Pierre-de-Lages;896;27;923
76;Occitanie;31;2;14;513;Saint-Plancard;393;8;401
76;Occitanie;31;3;13;514;Saint-Rome;59;1;60
76;Occitanie;31;3;27;515;Saint-Rustice;431;9;440
76;Occitanie;31;3;27;516;Saint-Sauveur;1940;34;1974
76;Occitanie;31;1;01;517;Saint-Sulpice-sur-Lèze;2293;61;2354
76;Occitanie;31;1;11;518;Saint-Thomas;592;16;608
76;Occitanie;31;3;13;519;Saint-Vincent;206;8;214
76;Occitanie;31;1;06;520;Sajas;116;2;118
76;Occitanie;31;2;02;521;Saleich;338;15;353
76;Occitanie;31;2;06;522;Salerm;60;2;62
76;Occitanie;31;2;02;523;Salies-du-Salat;1755;105;1860
76;Occitanie;31;2;02;524;Salles-et-Pratviel;127;2;129
76;Occitanie;31;1;01;525;Salles-sur-Garonne;592;14;606
76;Occitanie;31;3;08;526;La Salvetat-Saint-Gilles;8497;197;8694
76;Occitanie;31;3;13;527;La Salvetat-Lauragais;151;3;154
76;Occitanie;31;2;14;528;Saman;130;1;131
76;Occitanie;31;2;06;529;Samouillan;111;2;113
76;Occitanie;31;1;06;530;Sana;245;5;250
76;Occitanie;31;2;14;531;Sarrecave;78;0;78
76;Occitanie;31;2;14;532;Sarremezan;91;0;91
76;Occitanie;31;1;12;533;Saubens;2324;53;2377
76;Occitanie;31;3;13;534;Saussens;211;0;211
76;Occitanie;31;2;02;535;Sauveterre-de-Comminges;706;18;724
76;Occitanie;31;2;14;536;Saux-et-Pomarède;249;8;257
76;Occitanie;31;2;14;537;Savarthès;185;4;189
76;Occitanie;31;1;06;538;Savères;222;4;226
76;Occitanie;31;2;14;539;Sédeilhac;63;3;66
76;Occitanie;31;3;13;540;Ségreville;331;8;339
76;Occitanie;31;3;03;541;Seilh;3287;74;3361
76;Occitanie;31;2;02;542;Seilhan;209;7;216
76;Occitanie;31;1;06;543;Sénarens;118;2;120
76;Occitanie;31;2;02;544;Sengouagnet;219;2;221
76;Occitanie;31;2;02;545;Sepx;207;4;211
76;Occitanie;31;3;07;546;Seyre;128;2;130
76;Occitanie;31;1;09;547;Seysses;9725;129;9854
76;Occitanie;31;2;02;548;Signac;47;0;47
76;Occitanie;31;2;02;549;Sode;21;0;21
76;Occitanie;31;2;02;550;Soueich;520;15;535
76;Occitanie;31;3;13;551;Tarabel;579;18;597
76;Occitanie;31;2;06;552;Terrebasse;139;4;143
76;Occitanie;31;3;08;553;Thil;1141;25;1166
76;Occitanie;31;2;02;554;Touille;241;6;247
76;Occitanie;31;3;99;555;Toulouse;498003;5017;503020
76;Occitanie;31;2;14;556;Les Tourreilles;377;9;386
76;Occitanie;31;3;26;557;Tournefeuille;28763;642;29405
76;Occitanie;31;3;13;558;Toutens;402;7;409
76;Occitanie;31;2;02;559;Trébons-de-Luchon;7;0;7
76;Occitanie;31;3;13;560;Trébons-sur-la-Grasse;470;8;478
76;Occitanie;31;3;23;561;L'Union;12339;172;12511
76;Occitanie;31;2;02;562;Urau;118;1;119
76;Occitanie;31;3;27;563;Vacquiers;1334;36;1370
76;Occitanie;31;2;02;564;Valcabrère;144;3;147
76;Occitanie;31;2;14;565;Valentine;878;14;892
76;Occitanie;31;3;13;566;Vallègue;517;4;521
76;Occitanie;31;3;13;567;Vallesvilles;441;6;447
76;Occitanie;31;3;07;568;Varennes;267;7;274
76;Occitanie;31;3;13;569;Vaudreuille;384;10;394
76;Occitanie;31;3;13;570;Vaux;308;5;313
76;Occitanie;31;3;13;571;Vendine;290;4;294
76;Occitanie;31;1;12;572;Venerque;2747;89;2836
76;Occitanie;31;3;10;573;Verfeil;3727;65;3792
76;Occitanie;31;1;12;574;Vernet;3138;37;3175
76;Occitanie;31;3;04;575;Vieille-Toulouse;1211;39;1250
76;Occitanie;31;3;13;576;Vieillevigne;358;7;365
76;Occitanie;31;3;08;577;Vignaux;146;0;146
76;Occitanie;31;3;04;578;Vigoulet-Auzil;967;32;999
76;Occitanie;31;3;10;579;Villariès;796;13;809
76;Occitanie;31;1;12;580;Villate;1094;23;1117
76;Occitanie;31;3;27;581;Villaudric;1599;32;1631
76;Occitanie;31;3;13;582;Villefranche-de-Lauragais;4848;68;4916
76;Occitanie;31;3;27;583;Villematier;1090;25;1115
76;Occitanie;31;3;27;584;Villemur-sur-Tarn;6105;79;6184
76;Occitanie;31;2;14;585;Villeneuve-de-Rivière;1756;30;1786
76;Occitanie;31;2;14;586;Villeneuve-Lécussan;562;4;566
76;Occitanie;31;3;27;587;Villeneuve-lès-Bouloc;1629;11;1640
76;Occitanie;31;3;26;588;Villeneuve-Tolosane;10112;126;10238
76;Occitanie;31;3;13;589;Villenouvelle;1438;19;1457
76;Occitanie;31;2;02;590;Binos;45;0;45
76;Occitanie;31;2;02;591;Escoulis;79;1;80
76;Occitanie;31;3;08;592;Larra;2114;38;2152
76;Occitanie;31;2;06;593;Cazac;85;0;85
76;Occitanie;32;3;01;001;Aignan;722;47;769
76;Occitanie;32;1;05;002;Ansan;77;5;82
76;Occitanie;32;1;10;003;Antras;44;3;47
76;Occitanie;32;3;01;004;Arblade-le-Bas;133;3;136
76;Occitanie;32;2;12;005;Arblade-le-Haut;328;6;334
76;Occitanie;32;2;11;007;Ardizas;221;5;226
76;Occitanie;32;3;16;008;Armentieux;73;0;73
76;Occitanie;32;3;16;009;Armous-et-Cau;92;1;93
76;Occitanie;32;3;03;010;Arrouède;89;0;89
76;Occitanie;32;1;05;012;Aubiet;1119;28;1147
76;Occitanie;32;1;99;013;Auch;22518;1106;23624
76;Occitanie;32;1;10;014;Augnax;114;5;119
76;Occitanie;32;3;03;015;Aujan-Mournède;90;1;91
76;Occitanie;32;1;13;016;Auradé;673;16;689
76;Occitanie;32;3;01;017;Aurensan;133;5;138
76;Occitanie;32;1;03;018;Aurimont;214;3;217
76;Occitanie;32;1;06;019;Auterive;521;16;537
76;Occitanie;32;3;15;020;Aux-Aussat;275;9;284
76;Occitanie;32;2;11;021;Avensac;75;1;76
76;Occitanie;32;3;01;022;Avéron-Bergelle;176;7;183
76;Occitanie;32;2;09;023;Avezan;104;1;105
76;Occitanie;32;1;07;024;Ayguetinte;159;3;162
76;Occitanie;32;2;12;025;Ayzieu;160;2;162
76;Occitanie;32;2;11;026;Bajonnette;111;0;111
76;Occitanie;32;3;01;027;Barcelonne-du-Gers;1367;39;1406
76;Occitanie;32;3;15;028;Barcugnan;104;3;107
76;Occitanie;32;3;04;029;Barran;664;20;684
76;Occitanie;32;3;16;030;Bars;129;3;132
76;Occitanie;32;2;08;031;Bascous;172;2;174
76;Occitanie;32;3;16;032;Bassoues;323;10;333
76;Occitanie;32;1;08;033;Bazian;109;0;109
76;Occitanie;32;3;15;034;Bazugues;56;0;56
76;Occitanie;32;2;07;035;Beaucaire;239;3;242
76;Occitanie;32;3;16;036;Beaumarchés;657;40;697
76;Occitanie;32;2;02;037;Beaumont;128;7;135
76;Occitanie;32;1;11;038;Beaupuy;208;8;216
76;Occitanie;32;3;15;039;Beccas;120;3;123
76;Occitanie;32;1;03;040;Bédéchan;137;1;138
76;Occitanie;32;3;03;041;Bellegarde;165;4;169
76;Occitanie;32;3;15;042;Belloc-Saint-Clamens;139;4;143
76;Occitanie;32;1;08;043;Belmont;151;4;155
76;Occitanie;32;2;07;044;Béraut;302;8;310
76;Occitanie;32;3;15;045;Berdoues;416;19;435
76;Occitanie;32;3;01;046;Bernède;199;6;205
76;Occitanie;32;2;14;047;Berrac;112;1;113
76;Occitanie;32;1;17;048;Betcave-Aguin;90;0;90
76;Occitanie;32;2;12;049;Bétous;73;3;76
76;Occitanie;32;3;15;050;Betplan;95;5;100
76;Occitanie;32;1;17;051;Bézéril;122;7;129
76;Occitanie;32;1;08;052;Bezolles;138;4;142
76;Occitanie;32;3;03;053;Bézues-Bajon;192;0;192
76;Occitanie;32;1;10;054;Biran;381;9;390
76;Occitanie;32;2;09;055;Bivès;134;2;136
76;Occitanie;32;1;05;056;Blanquefort;45;4;49
76;Occitanie;32;2;07;057;Blaziert;130;2;132
76;Occitanie;32;3;16;058;Blousson-Sérian;39;2;41
76;Occitanie;32;1;10;059;Bonas;136;2;138
76;Occitanie;32;3;06;060;Boucagnères;215;3;218
76;Occitanie;32;1;03;061;Boulaur;187;3;190
76;Occitanie;32;2;12;062;Bourrouillan;166;4;170
76;Occitanie;32;3;01;063;Bouzon-Gellenave;165;8;173
76;Occitanie;32;2;02;064;Bretagne-d'Armagnac;397;11;408
76;Occitanie;32;3;04;065;Le Brouilh-Monbert;244;6;250
76;Occitanie;32;2;09;066;Brugnens;253;2;255
76;Occitanie;32;3;03;067;Cabas-Loumassès;50;1;51
76;Occitanie;32;2;09;068;Cadeilhan;136;3;139
76;Occitanie;32;1;17;069;Cadeillan;68;3;71
76;Occitanie;32;3;01;070;Cahuzac-sur-Adour;207;3;210
76;Occitanie;32;1;08;071;Caillavet;178;9;187
76;Occitanie;32;1;08;072;Callian;50;1;51
76;Occitanie;32;2;12;073;Campagne-d'Armagnac;214;4;218
76;Occitanie;32;2;02;075;Cassaigne;232;4;236
76;Occitanie;32;1;03;076;Castelnau-Barbarens;547;10;557
76;Occitanie;32;3;16;077;Castelnau-d'Anglès;86;2;88
76;Occitanie;32;2;09;078;Castelnau-d'Arbieu;231;9;240
76;Occitanie;32;2;02;079;Castelnau d'Auzan Labarrère;1197;20;1217
76;Occitanie;32;2;07;080;Castelnau-sur-l'Auvignon;145;2;147
76;Occitanie;32;3;01;081;Castelnavet;131;2;133
76;Occitanie;32;2;14;082;Castéra-Lectourois;354;6;360
76;Occitanie;32;1;07;083;Castéra-Verduzan;1015;23;1038
76;Occitanie;32;2;09;084;Castéron;52;2;54
76;Occitanie;32;2;14;085;Castet-Arrouy;173;7;180
76;Occitanie;32;3;15;086;Castex;77;2;79
76;Occitanie;32;2;12;087;Castex-d'Armagnac;127;4;131
76;Occitanie;32;1;08;088;Castillon-Debats;324;0;324
76;Occitanie;32;1;10;089;Castillon-Massas;240;5;245
76;Occitanie;32;1;17;090;Castillon-Savès;339;8;347
76;Occitanie;32;1;10;091;Castin;361;17;378
76;Occitanie;32;2;11;092;Catonvielle;96;1;97
76;Occitanie;32;3;01;093;Caumont;103;7;110
76;Occitanie;32;2;12;094;Caupenne-d'Armagnac;435;11;446
76;Occitanie;32;2;07;095;Caussens;592;13;605
76;Occitanie;32;2;12;096;Cazaubon;1670;35;1705
76;Occitanie;32;1;08;097;Cazaux-d'Anglès;114;5;119
76;Occitanie;32;1;17;098;Cazaux-Savès;328;5;333
76;Occitanie;32;3;16;099;Cazaux-Villecomtal;72;2;74
76;Occitanie;32;2;02;100;Cazeneuve;162;4;166
76;Occitanie;32;2;09;101;Céran;229;3;232
76;Occitanie;32;2;09;102;Cézan;219;4;223
76;Occitanie;32;3;03;103;Chélan;168;8;176
76;Occitanie;32;3;15;104;Clermont-Pouyguillès;160;3;163
76;Occitanie;32;1;13;105;Clermont-Savès;414;11;425
76;Occitanie;32;2;11;106;Cologne;928;69;997
76;Occitanie;32;2;07;107;Condom;6478;192;6670
76;Occitanie;32;3;01;108;Corneillan;154;10;164
76;Occitanie;32;3;16;109;Couloumé-Mondebat;196;5;201
76;Occitanie;32;2;08;110;Courrensan;397;5;402
76;Occitanie;32;3;16;111;Courties;49;0;49
76;Occitanie;32;1;10;112;Crastes;255;4;259
76;Occitanie;32;2;12;113;Cravencères;89;2;91
76;Occitanie;32;3;03;114;Cuélas;124;3;127
76;Occitanie;32;2;08;115;Dému;325;3;328
76;Occitanie;32;3;15;116;Duffort;150;4;154
76;Occitanie;32;1;10;117;Duran;854;28;882
76;Occitanie;32;3;06;118;Durban;137;4;141
76;Occitanie;32;2;02;119;Eauze;3998;71;4069
76;Occitanie;32;2;11;120;Encausse;431;7;438
76;Occitanie;32;1;13;121;Endoufielle;505;16;521
76;Occitanie;32;3;03;122;Esclassan-Labastide;346;11;357
76;Occitanie;32;1;11;123;Escornebœuf;566;12;578
76;Occitanie;32;1;17;124;Espaon;186;0;186
76;Occitanie;32;2;12;125;Espas;125;1;126
76;Occitanie;32;3;15;126;Estampes;162;1;163
76;Occitanie;32;2;12;127;Estang;665;13;678
76;Occitanie;32;3;16;128;Estipouy;207;12;219
76;Occitanie;32;2;09;129;Estramiac;140;0;140
76;Occitanie;32;3;03;130;Faget-Abbatial;218;1;219
76;Occitanie;32;2;14;131;Flamarens;150;2;152
76;Occitanie;32;2;09;132;Fleurance;5890;111;6001
76;Occitanie;32;2;02;133;Fourcès;262;2;264
76;Occitanie;32;1;13;134;Frégouville;339;7;346
76;Occitanie;32;3;01;135;Fustérouau;135;5;140
76;Occitanie;32;3;16;136;Galiax;177;5;182
76;Occitanie;32;1;17;138;Garravet;152;4;156
76;Occitanie;32;2;09;139;Gaudonville;110;1;111
76;Occitanie;32;1;17;140;Gaujac;72;0;72
76;Occitanie;32;1;17;141;Gaujan;114;0;114
76;Occitanie;32;2;09;142;Gavarret-sur-Aulouste;139;3;142
76;Occitanie;32;2;14;143;Gazaupouy;264;11;275
76;Occitanie;32;1;08;144;Gazax-et-Baccarisse;72;0;72
76;Occitanie;32;3;01;145;Gée-Rivière;46;2;48
76;Occitanie;32;2;14;146;Gimbrède;272;4;276
76;Occitanie;32;1;11;147;Gimont;3008;70;3078
76;Occitanie;32;1;11;148;Giscaro;104;0;104
76;Occitanie;32;2;02;149;Gondrin;1201;32;1233
76;Occitanie;32;2;09;150;Goutz;213;6;219
76;Occitanie;32;3;01;151;Goux;62;1;63
76;Occitanie;32;3;15;152;Haget;332;11;343
76;Occitanie;32;3;06;153;Haulies;163;6;169
76;Occitanie;32;2;11;154;Homps;110;1;111
76;Occitanie;32;2;12;155;Le Houga;1158;51;1209
76;Occitanie;32;3;15;156;Idrac-Respaillès;215;5;220
76;Occitanie;32;1;05;157;L'Isle-Arné;193;3;196
76;Occitanie;32;2;14;158;L'Isle-Bouzon;241;10;251
76;Occitanie;32;3;16;159;L'Isle-de-Noé;552;14;566
76;Occitanie;32;1;13;160;L'Isle-Jourdain;9227;227;9454
76;Occitanie;32;3;16;161;Izotges;89;4;93
76;Occitanie;32;1;10;162;Jegun;1164;46;1210
76;Occitanie;32;3;16;163;Jû-Belloc;291;10;301
76;Occitanie;32;3;16;164;Juillac;117;2;119
76;Occitanie;32;1;05;165;Juilles;222;4;226
76;Occitanie;32;1;08;166;Justian;116;5;121
76;Occitanie;32;3;15;167;Laas;312;5;317
76;Occitanie;32;3;03;169;Labarthe;148;4;152
76;Occitanie;32;3;01;170;Labarthète;141;3;144
76;Occitanie;32;1;17;171;Labastide-Savès;180;2;182
76;Occitanie;32;3;15;172;Labéjan;294;16;310
76;Occitanie;32;2;11;173;Labrihe;215;8;223
76;Occitanie;32;3;16;174;Ladevèze-Rivière;220;4;224
76;Occitanie;32;3;16;175;Ladevèze-Ville;217;7;224
76;Occitanie;32;2;14;176;Lagarde;122;5;127
76;Occitanie;32;3;15;177;Lagarde-Hachan;167;5;172
76;Occitanie;32;2;07;178;Lagardère;77;2;79
76;Occitanie;32;2;02;180;Lagraulet-du-Gers;555;10;565
76;Occitanie;32;3;15;181;Laguian-Mazous;246;2;248
76;Occitanie;32;1;17;182;Lahas;180;6;186
76;Occitanie;32;1;05;183;Lahitte;228;11;239
76;Occitanie;32;2;09;184;Lalanne;130;3;133
76;Occitanie;32;3;03;185;Lalanne-Arqué;150;4;154
76;Occitanie;32;3;03;186;Lamaguère;80;0;80
76;Occitanie;32;3;15;187;Lamazère;123;2;125
76;Occitanie;32;2;09;188;Lamothe-Goas;80;3;83
76;Occitanie;32;2;12;189;Lannemaignan;106;3;109
76;Occitanie;32;2;08;190;Lannepax;512;7;519
76;Occitanie;32;2;12;191;Lanne-Soubiran;145;0;145
76;Occitanie;32;3;01;192;Lannux;229;7;236
76;Occitanie;32;2;12;193;Larée;238;3;241
76;Occitanie;32;2;02;194;Larressingle;210;5;215
76;Occitanie;32;2;14;195;Larroque-Engalin;45;1;46
76;Occitanie;32;2;07;196;Larroque-Saint-Sernin;164;2;166
76;Occitanie;32;2;02;197;Larroque-sur-l'Osse;221;6;227
76;Occitanie;32;1;03;198;Lartigue;198;4;202
76;Occitanie;32;3;16;199;Lasserrade;187;9;196
76;Occitanie;32;3;04;200;Lasséran;366;11;377
76;Occitanie;32;3;06;201;Lasseube-Propre;338;15;353
76;Occitanie;32;2;12;202;Laujuzan;282;15;297
76;Occitanie;32;2;02;203;Lauraët;253;3;256
76;Occitanie;32;1;10;204;Lavardens;368;11;379
76;Occitanie;32;3;16;205;Laveraët;105;1;106
76;Occitanie;32;1;17;206;Laymont;219;2;221
76;Occitanie;32;1;05;207;Leboulin;340;17;357
76;Occitanie;32;2;14;208;Lectoure;3687;362;4049
76;Occitanie;32;3;01;209;Lelin-Lapujolle;280;7;287
76;Occitanie;32;1;13;210;Lias;744;15;759
76;Occitanie;32;2;12;211;Lias-d'Armagnac;197;3;200
76;Occitanie;32;2;14;212;Ligardes;212;4;216
76;Occitanie;32;1;17;213;Lombez;2152;37;2189
76;Occitanie;32;2;12;214;Loubédat;98;4;102
76;Occitanie;32;3;15;215;Loubersan;151;7;158
76;Occitanie;32;3;03;216;Lourties-Monbrun;168;1;169
76;Occitanie;32;3;16;217;Louslitges;58;2;60
76;Occitanie;32;3;01;218;Loussous-Débat;66;1;67
76;Occitanie;32;1;08;219;Lupiac;311;11;322
76;Occitanie;32;2;12;220;Luppé-Violles;138;3;141
76;Occitanie;32;1;05;221;Lussan;236;3;239
76;Occitanie;32;2;12;222;Magnan;233;7;240
76;Occitanie;32;2;09;223;Magnas;60;31;91
76;Occitanie;32;2;07;224;Maignaut-Tauzia;228;2;230
76;Occitanie;32;3;15;225;Malabat;101;5;106
76;Occitanie;32;3;15;226;Manas-Bastanous;82;5;87
76;Occitanie;32;2;12;227;Manciet;789;18;807
76;Occitanie;32;3;03;228;Manent-Montané;91;1;92
76;Occitanie;32;2;11;229;Mansempuy;63;8;71
76;Occitanie;32;2;02;230;Mansencôme;45;4;49
76;Occitanie;32;1;08;231;Marambat;433;14;447
76;Occitanie;32;2;11;232;Maravat;39;0;39
76;Occitanie;32;3;16;233;Marciac;1203;85;1288
76;Occitanie;32;1;13;234;Marestaing;332;7;339
76;Occitanie;32;3;01;235;Margouët-Meymes;157;9;166
76;Occitanie;32;2;12;236;Marguestau;60;3;63
76;Occitanie;32;1;05;237;Marsan;477;9;486
76;Occitanie;32;3;15;238;Marseillan;85;3;88
76;Occitanie;32;2;14;239;Marsolan;448;11;459
76;Occitanie;32;3;16;240;Mascaras;63;4;67
76;Occitanie;32;2;14;241;Mas-d'Auvignon;170;6;176
76;Occitanie;32;3;03;242;Masseube;1501;396;1897
76;Occitanie;32;2;12;243;Mauléon-d'Armagnac;266;3;269
76;Occitanie;32;3;01;244;Maulichères;161;3;164
76;Occitanie;32;3;01;245;Maumusson-Laguian;145;7;152
76;Occitanie;32;2;12;246;Maupas;199;2;201
76;Occitanie;32;1;11;247;Maurens;308;15;323
76;Occitanie;32;2;09;248;Mauroux;143;4;147
76;Occitanie;32;2;11;249;Mauvezin;2237;50;2287
76;Occitanie;32;3;03;250;Meilhan;77;3;80
76;Occitanie;32;1;10;251;Mérens;69;0;69
76;Occitanie;32;3;15;252;Miélan;1117;18;1135
76;Occitanie;32;2;14;253;Miradoux;537;12;549
76;Occitanie;32;3;15;254;Miramont-d'Astarac;347;8;355
76;Occitanie;32;2;09;255;Miramont-Latour;151;5;156
76;Occitanie;32;3;15;256;Mirande;3445;288;3733
76;Occitanie;32;1;08;257;Mirannes;59;4;63
76;Occitanie;32;1;10;258;Mirepoix;232;5;237
76;Occitanie;32;3;03;260;Monbardon;73;4;77
76;Occitanie;32;1;17;261;Monblanc;379;7;386
76;Occitanie;32;2;11;262;Monbrun;404;14;418
76;Occitanie;32;3;15;263;Moncassin;126;3;129
76;Occitanie;32;2;12;264;Monclar;218;4;222
76;Occitanie;32;3;16;265;Monclar-sur-Losse;109;2;111
76;Occitanie;32;3;03;266;Moncorneil-Grazan;144;1;145
76;Occitanie;32;3;03;267;Monferran-Plavès;111;2;113
76;Occitanie;32;1;13;268;Monferran-Savès;825;28;853
76;Occitanie;32;2;11;269;Monfort;504;7;511
76;Occitanie;32;1;17;270;Mongausy;88;1;89
76;Occitanie;32;2;12;271;Monguilhem;292;10;302
76;Occitanie;32;3;03;272;Monlaur-Bernet;164;3;167
76;Occitanie;32;3;16;273;Monlezun;171;12;183
76;Occitanie;32;2;12;274;Monlezun-d'Armagnac;199;0;199
76;Occitanie;32;3;16;275;Monpardiac;44;1;45
76;Occitanie;32;1;17;276;Montadet;69;1;70
76;Occitanie;32;1;17;277;Montamat;114;3;117
76;Occitanie;32;3;15;278;Montaut;120;2;122
76;Occitanie;32;1;10;279;Montaut-les-Créneaux;711;18;729
76;Occitanie;32;3;03;280;Mont-d'Astarac;93;2;95
76;Occitanie;32;3;15;281;Mont-de-Marrast;105;5;110
76;Occitanie;32;1;05;282;Montégut;645;18;663
76;Occitanie;32;3;15;283;Montégut-Arros;282;7;289
76;Occitanie;32;1;17;284;Montégut-Savès;65;1;66
76;Occitanie;32;3;16;285;Montesquiou;571;18;589
76;Occitanie;32;2;09;286;Montestruc-sur-Gers;701;16;717
76;Occitanie;32;3;03;287;Monties;79;1;80
76;Occitanie;32;1;05;288;Montiron;143;1;144
76;Occitanie;32;1;17;289;Montpézat;240;3;243
76;Occitanie;32;2;02;290;Montréal;1178;35;1213
76;Occitanie;32;2;12;291;Mormès;116;3;119
76;Occitanie;32;2;02;292;Mouchan;393;9;402
76;Occitanie;32;3;16;293;Mouchès;73;2;75
76;Occitanie;32;1;08;294;Mourède;73;3;76
76;Occitanie;32;1;17;295;Nizas;137;8;145
76;Occitanie;32;2;12;296;Nogaro;2097;141;2238
76;Occitanie;32;1;17;297;Noilhan;383;11;394
76;Occitanie;32;1;05;298;Nougaroulet;376;8;384
76;Occitanie;32;2;08;299;Noulens;101;0;101
76;Occitanie;32;3;06;300;Orbessan;286;4;290
76;Occitanie;32;1;10;301;Ordan-Larroque;884;24;908
76;Occitanie;32;3;06;302;Ornézan;219;7;226
76;Occitanie;32;3;16;303;Pallanne;63;2;65
76;Occitanie;32;3;03;304;Panassac;289;8;297
76;Occitanie;32;2;12;305;Panjas;418;8;426
76;Occitanie;32;2;09;306;Pauilhac;610;48;658
76;Occitanie;32;1;04;307;Pavie;2513;119;2632
76;Occitanie;32;1;17;308;Pébées;109;2;111
76;Occitanie;32;1;17;309;Pellefigue;115;5;120
76;Occitanie;32;2;12;310;Perchède;117;2;119
76;Occitanie;32;2;14;311;Pergain-Taillac;336;6;342
76;Occitanie;32;1;06;312;Pessan;672;15;687
76;Occitanie;32;2;09;313;Pessoulens;139;4;143
76;Occitanie;32;2;14;314;Peyrecave;73;5;78
76;Occitanie;32;1;08;315;Peyrusse-Grande;151;2;153
76;Occitanie;32;1;10;316;Peyrusse-Massas;109;3;112
76;Occitanie;32;1;08;317;Peyrusse-Vieille;65;2;67
76;Occitanie;32;2;09;318;Pis;106;2;108
76;Occitanie;32;3;16;319;Plaisance;1416;30;1446
76;Occitanie;32;2;14;320;Plieux;153;10;163
76;Occitanie;32;1;17;321;Polastron;273;6;279
76;Occitanie;32;1;17;322;Pompiac;210;3;213
76;Occitanie;32;3;15;323;Ponsampère;104;5;109
76;Occitanie;32;3;03;324;Ponsan-Soubiran;78;2;80
76;Occitanie;32;3;01;325;Pouydraguin;129;3;132
76;Occitanie;32;3;16;326;Pouylebon;147;3;150
76;Occitanie;32;3;03;327;Pouy-Loubrin;85;1;86
76;Occitanie;32;2;14;328;Pouy-Roquelaure;118;5;123
76;Occitanie;32;2;09;329;Préchac;161;3;164
76;Occitanie;32;3;16;330;Préchac-sur-Adour;194;5;199
76;Occitanie;32;1;10;331;Preignan;1237;35;1272
76;Occitanie;32;1;08;332;Préneron;121;1;122
76;Occitanie;32;3;01;333;Projan;182;0;182
76;Occitanie;32;1;13;334;Pujaudran;1616;41;1657
76;Occitanie;32;1;10;335;Puycasquier;444;10;454
76;Occitanie;32;1;17;336;Puylausic;160;8;168
76;Occitanie;32;2;09;337;Puységur;73;3;76
76;Occitanie;32;2;08;338;Ramouzens;173;4;177
76;Occitanie;32;1;11;339;Razengues;251;8;259
76;Occitanie;32;2;12;340;Réans;283;2;285
76;Occitanie;32;2;09;341;Réjaumont;247;4;251
76;Occitanie;32;3;16;342;Ricourt;52;2;54
76;Occitanie;32;1;08;343;Riguepeu;171;7;178
76;Occitanie;32;3;01;344;Riscle;1761;122;1883
76;Occitanie;32;2;14;345;La Romieu;562;14;576
76;Occitanie;32;1;08;346;Roquebrune;211;6;217
76;Occitanie;32;1;10;347;Roquefort;276;7;283
76;Occitanie;32;1;10;348;Roquelaure;571;23;594
76;Occitanie;32;2;11;349;Roquelaure-Saint-Aubin;102;4;106
76;Occitanie;32;2;07;350;Roquepine;31;2;33
76;Occitanie;32;1;08;351;Roques;110;1;111
76;Occitanie;32;1;08;352;Rozès;110;4;114
76;Occitanie;32;1;17;353;Sabaillan;148;3;151
76;Occitanie;32;3;01;354;Sabazan;134;4;138
76;Occitanie;32;3;15;355;Sadeillan;85;1;86
76;Occitanie;32;1;17;356;Saint-André;129;1;130
76;Occitanie;32;2;11;357;Sainte-Anne;127;6;133
76;Occitanie;32;2;14;358;Saint-Antoine;188;4;192
76;Occitanie;32;2;11;359;Saint-Antonin;154;5;159
76;Occitanie;32;1;08;360;Saint-Arailles;141;3;144
76;Occitanie;32;3;03;361;Saint-Arroman;132;8;140
76;Occitanie;32;3;16;362;Saint-Aunix-Lengros;143;2;145
76;Occitanie;32;3;15;363;Sainte-Aurence-Cazaux;92;3;95
76;Occitanie;32;2;14;364;Saint-Avit-Frandat;93;3;96
76;Occitanie;32;3;03;365;Saint-Blancard;332;6;338
76;Occitanie;32;2;11;366;Saint-Brès;73;1;74
76;Occitanie;32;3;16;367;Saint-Christaud;62;2;64
76;Occitanie;32;1;10;368;Sainte-Christie;546;11;557
76;Occitanie;32;2;12;369;Sainte-Christie-d'Armagnac;374;13;387
76;Occitanie;32;2;09;370;Saint-Clar;1049;66;1115
76;Occitanie;32;2;09;371;Saint-Créac;83;4;87
76;Occitanie;32;2;11;372;Saint-Cricq;285;5;290
76;Occitanie;32;3;15;373;Sainte-Dode;212;4;216
76;Occitanie;32;1;17;374;Saint-Élix-d'Astarac;183;6;189
76;Occitanie;32;3;15;375;Saint-Élix-Theux;89;4;93
76;Occitanie;32;2;11;376;Sainte-Gemme;113;3;116
76;Occitanie;32;2;11;377;Saint-Georges;184;7;191
76;Occitanie;32;3;01;378;Saint-Germé;498;7;505
76;Occitanie;32;2;11;379;Saint-Germier;210;4;214
76;Occitanie;32;2;12;380;Saint-Griède;140;9;149
76;Occitanie;32;3;04;381;Saint-Jean-le-Comtal;403;10;413
76;Occitanie;32;1;08;382;Saint-Jean-Poutge;312;14;326
76;Occitanie;32;3;16;383;Saint-Justin;126;6;132
76;Occitanie;32;1;10;384;Saint-Lary;278;6;284
76;Occitanie;32;2;09;385;Saint-Léonard;187;1;188
76;Occitanie;32;1;17;386;Saint-Lizier-du-Planté;146;1;147
76;Occitanie;32;1;17;387;Saint-Loube;103;2;105
76;Occitanie;32;1;11;388;Sainte-Marie;423;10;433
76;Occitanie;32;3;15;389;Saint-Martin;458;20;478
76;Occitanie;32;2;12;390;Saint-Martin-d'Armagnac;237;4;241
76;Occitanie;32;2;14;391;Saint-Martin-de-Goyne;119;7;126
76;Occitanie;32;1;03;392;Saint-Martin-Gimois;87;1;88
76;Occitanie;32;3;15;393;Saint-Maur;136;5;141
76;Occitanie;32;3;15;394;Saint-Médard;343;5;348
76;Occitanie;32;2;14;395;Sainte-Mère;209;4;213
76;Occitanie;32;2;14;396;Saint-Mézard;239;3;242
76;Occitanie;32;3;15;397;Saint-Michel;244;16;260
76;Occitanie;32;3;01;398;Saint-Mont;310;10;320
76;Occitanie;32;2;11;399;Saint-Orens;84;3;87
76;Occitanie;32;2;07;400;Saint-Orens-Pouy-Petit;212;9;221
76;Occitanie;32;3;15;401;Saint-Ost;87;1;88
76;Occitanie;32;1;08;402;Saint-Paul-de-Baïse;107;3;110
76;Occitanie;32;1;08;403;Saint-Pierre-d'Aubézies;60;1;61
76;Occitanie;32;2;07;404;Saint-Puy;588;14;602
76;Occitanie;32;2;09;405;Sainte-Radegonde;176;6;182
76;Occitanie;32;1;11;406;Saint-Sauvy;351;10;361
76;Occitanie;32;1;17;407;Saint-Soulan;162;3;165
76;Occitanie;32;2;12;408;Salles-d'Armagnac;136;5;141
76;Occitanie;32;3;03;409;Samaran;86;5;91
76;Occitanie;32;1;17;410;Samatan;2380;104;2484
76;Occitanie;32;3;06;411;Sansan;99;3;102
76;Occitanie;32;1;03;412;Saramon;853;13;866
76;Occitanie;32;3;03;413;Sarcos;82;2;84
76;Occitanie;32;3;01;414;Sarragachies;228;6;234
76;Occitanie;32;3;15;415;Sarraguzan;89;1;90
76;Occitanie;32;2;11;416;Sarrant;361;10;371
76;Occitanie;32;2;09;417;La Sauvetat;408;13;421
76;Occitanie;32;1;17;418;Sauveterre;291;29;320
76;Occitanie;32;3;15;419;Sauviac;107;2;109
76;Occitanie;32;1;17;420;Sauvimont;67;2;69
76;Occitanie;32;1;17;421;Savignac-Mona;144;0;144
76;Occitanie;32;3;16;422;Scieurac-et-Flourès;42;1;43
76;Occitanie;32;2;08;423;Séailles;63;3;66
76;Occitanie;32;3;01;424;Ségos;224;8;232
76;Occitanie;32;1;13;425;Ségoufielle;1160;27;1187
76;Occitanie;32;3;03;426;Seissan;1097;11;1108
76;Occitanie;32;3;16;427;Sembouès;59;1;60
76;Occitanie;32;1;03;428;Sémézies-Cachan;62;2;64
76;Occitanie;32;2;14;429;Sempesserre;294;6;300
76;Occitanie;32;3;03;430;Sère;79;0;79
76;Occitanie;32;2;11;431;Sérempuy;42;4;46
76;Occitanie;32;1;17;432;Seysses-Savès;246;2;248
76;Occitanie;32;1;17;433;Simorre;707;17;724
76;Occitanie;32;2;12;434;Sion;97;3;100
76;Occitanie;32;2;11;435;Sirac;164;9;173
76;Occitanie;32;2;11;436;Solomiac;488;8;496
76;Occitanie;32;2;12;437;Sorbets;219;1;220
76;Occitanie;32;3;03;438;Tachoires;106;0;106
76;Occitanie;32;3;01;439;Tarsac;165;2;167
76;Occitanie;32;3;16;440;Tasque;248;6;254
76;Occitanie;32;2;09;441;Taybosc;61;0;61
76;Occitanie;32;2;14;442;Terraube;378;4;382
76;Occitanie;32;3;01;443;Termes-d'Armagnac;182;4;186
76;Occitanie;32;2;11;444;Thoux;259;7;266
76;Occitanie;32;3;16;445;Tieste-Uragnoux;153;5;158
76;Occitanie;32;3;16;446;Tillac;283;8;291
76;Occitanie;32;1;03;447;Tirent-Pontéjac;92;1;93
76;Occitanie;32;2;11;448;Touget;503;16;519
76;Occitanie;32;2;12;449;Toujouse;282;3;285
76;Occitanie;32;3;16;450;Tourdun;131;4;135
76;Occitanie;32;1;17;451;Tournan;181;3;184
76;Occitanie;32;2;09;452;Tournecoupe;260;8;268
76;Occitanie;32;1;10;453;Tourrenquets;110;6;116
76;Occitanie;32;3;03;454;Traversères;70;2;72
76;Occitanie;32;3;16;455;Troncens;176;11;187
76;Occitanie;32;1;08;456;Tudelle;54;0;54
76;Occitanie;32;2;09;457;Urdens;277;13;290
76;Occitanie;32;2;12;458;Urgosse;234;5;239
76;Occitanie;32;2;07;459;Valence-sur-Baïse;1118;23;1141
76;Occitanie;32;3;01;460;Vergoignan;307;8;315
76;Occitanie;32;3;01;461;Verlus;118;3;121
76;Occitanie;32;1;08;462;Vic-Fezensac;3583;57;3640
76;Occitanie;32;3;01;463;Viella;509;12;521
76;Occitanie;32;3;15;464;Villecomtal-sur-Arros;837;20;857
76;Occitanie;32;1;17;465;Villefranche;138;0;138
76;Occitanie;32;3;15;466;Viozan;107;1;108
76;Occitanie;32;1;05;467;Saint-Caprais;143;4;147
76;Occitanie;32;3;03;468;Aussos;77;0;77
75;Nouvelle-Aquitaine;33;5;21;001;Abzac;1998;25;2023
75;Nouvelle-Aquitaine;33;3;27;002;Aillas;840;14;854
75;Nouvelle-Aquitaine;33;2;26;003;Ambarès-et-Lagrave;16591;162;16753
75;Nouvelle-Aquitaine;33;2;26;004;Ambès;3123;21;3144
75;Nouvelle-Aquitaine;33;6;01;005;Andernos-les-Bains;12284;285;12569
75;Nouvelle-Aquitaine;33;1;13;006;Anglade;915;13;928
75;Nouvelle-Aquitaine;33;3;15;007;Arbanats;1359;8;1367
75;Nouvelle-Aquitaine;33;3;12;008;Porte-de-Benauge;494;8;502
75;Nouvelle-Aquitaine;33;6;32;009;Arcachon;11076;315;11391
75;Nouvelle-Aquitaine;33;4;30;010;Arcins;548;7;555
75;Nouvelle-Aquitaine;33;6;01;011;Arès;6413;123;6536
75;Nouvelle-Aquitaine;33;4;30;012;Arsac;3873;50;3923
75;Nouvelle-Aquitaine;33;2;17;013;Artigues-près-Bordeaux;8663;77;8740
75;Nouvelle-Aquitaine;33;5;21;014;Les Artigues-de-Lussac;1111;22;1133
75;Nouvelle-Aquitaine;33;5;16;015;Arveyres;2000;37;2037
75;Nouvelle-Aquitaine;33;5;16;016;Asques;439;9;448
75;Nouvelle-Aquitaine;33;3;29;017;Aubiac;278;11;289
75;Nouvelle-Aquitaine;33;1;20;018;Val de Virvée;3701;43;3744
75;Nouvelle-Aquitaine;33;6;01;019;Audenge;9136;131;9267
75;Nouvelle-Aquitaine;33;3;27;020;Auriolles;141;5;146
75;Nouvelle-Aquitaine;33;3;27;021;Auros;1048;23;1071
75;Nouvelle-Aquitaine;33;4;30;022;Avensan;3049;42;3091
75;Nouvelle-Aquitaine;33;2;08;023;Ayguemorte-les-Graves;1357;15;1372
75;Nouvelle-Aquitaine;33;3;27;024;Bagas;297;5;302
75;Nouvelle-Aquitaine;33;3;12;025;Baigneaux;447;6;453
75;Nouvelle-Aquitaine;33;3;15;026;Balizac;505;7;512
75;Nouvelle-Aquitaine;33;3;27;027;Barie;285;9;294
75;Nouvelle-Aquitaine;33;5;10;028;Baron;1181;16;1197
75;Nouvelle-Aquitaine;33;6;15;029;Le Barp;5625;81;5706
75;Nouvelle-Aquitaine;33;3;15;030;Barsac;2069;23;2092
75;Nouvelle-Aquitaine;33;3;27;031;Bassanne;131;2;133
75;Nouvelle-Aquitaine;33;2;17;032;Bassens;7425;61;7486
75;Nouvelle-Aquitaine;33;2;11;033;Baurech;939;7;946
75;Nouvelle-Aquitaine;33;5;21;034;Bayas;461;4;465
75;Nouvelle-Aquitaine;33;1;13;035;Bayon-sur-Gironde;729;2;731
75;Nouvelle-Aquitaine;33;3;29;036;Bazas;4806;258;5064
75;Nouvelle-Aquitaine;33;2;08;037;Beautiran;2404;40;2444
75;Nouvelle-Aquitaine;33;4;22;038;Bégadan;906;8;914
75;Nouvelle-Aquitaine;33;2;96;039;Bègles;30543;347;30890
75;Nouvelle-Aquitaine;33;3;12;040;Béguey;1206;13;1219
75;Nouvelle-Aquitaine;33;6;15;042;Belin-Béliet;5831;98;5929
75;Nouvelle-Aquitaine;33;3;12;043;Bellebat;295;1;296
75;Nouvelle-Aquitaine;33;3;12;044;Bellefond;217;6;223
75;Nouvelle-Aquitaine;33;5;10;045;Belvès-de-Castillon;334;7;341
75;Nouvelle-Aquitaine;33;3;29;046;Bernos-Beaulac;1135;30;1165
75;Nouvelle-Aquitaine;33;1;13;047;Berson;1808;30;1838
75;Nouvelle-Aquitaine;33;3;27;048;Berthez;272;7;279
75;Nouvelle-Aquitaine;33;2;26;049;Beychac-et-Caillau;2554;27;2581
75;Nouvelle-Aquitaine;33;3;29;050;Bieujac;648;9;657
75;Nouvelle-Aquitaine;33;6;01;051;Biganos;11065;121;11186
75;Nouvelle-Aquitaine;33;5;16;052;Les Billaux;1164;36;1200
75;Nouvelle-Aquitaine;33;3;29;053;Birac;229;1;230
75;Nouvelle-Aquitaine;33;3;27;054;Blaignac;290;5;295
75;Nouvelle-Aquitaine;33;4;22;055;Blaignan-Prignac;459;10;469
75;Nouvelle-Aquitaine;33;2;25;056;Blanquefort;15276;586;15862
75;Nouvelle-Aquitaine;33;3;27;057;Blasimon;924;19;943
75;Nouvelle-Aquitaine;33;1;13;058;Blaye;4897;117;5014
75;Nouvelle-Aquitaine;33;2;12;059;Blésignac;309;6;315
75;Nouvelle-Aquitaine;33;3;29;060;Bommes;439;67;506
75;Nouvelle-Aquitaine;33;2;11;061;Bonnetan;1011;19;1030
75;Nouvelle-Aquitaine;33;5;21;062;Bonzac;759;12;771
75;Nouvelle-Aquitaine;33;2;97;063;Bordeaux;259809;3438;263247
75;Nouvelle-Aquitaine;33;5;10;064;Bossugan;38;0;38
75;Nouvelle-Aquitaine;33;2;09;065;Bouliac;3741;77;3818
75;Nouvelle-Aquitaine;33;3;27;066;Bourdelles;93;1;94
75;Nouvelle-Aquitaine;33;1;13;067;Bourg;2303;39;2342
75;Nouvelle-Aquitaine;33;3;29;068;Bourideys;95;3;98
75;Nouvelle-Aquitaine;33;2;07;069;Le Bouscat;24006;282;24288
75;Nouvelle-Aquitaine;33;4;30;070;Brach;817;13;830
75;Nouvelle-Aquitaine;33;5;10;071;Branne;1317;16;1333
75;Nouvelle-Aquitaine;33;3;27;072;Brannens;239;4;243
75;Nouvelle-Aquitaine;33;1;13;073;Braud-et-Saint-Louis;1500;28;1528
75;Nouvelle-Aquitaine;33;3;27;074;Brouqueyran;206;8;214
75;Nouvelle-Aquitaine;33;2;07;075;Bruges;19863;203;20066
75;Nouvelle-Aquitaine;33;3;15;076;Budos;812;15;827
75;Nouvelle-Aquitaine;33;2;08;077;Cabanac-et-Villagrains;2409;39;2448
75;Nouvelle-Aquitaine;33;5;10;078;Cabara;503;12;515
75;Nouvelle-Aquitaine;33;5;16;079;Cadarsac;355;7;362
75;Nouvelle-Aquitaine;33;2;08;080;Cadaujac;6623;72;6695
75;Nouvelle-Aquitaine;33;3;12;081;Cadillac;2846;31;2877
75;Nouvelle-Aquitaine;33;5;16;082;Cadillac-en-Fronsadais;1350;16;1366
75;Nouvelle-Aquitaine;33;2;11;083;Camarsac;1025;14;1039
75;Nouvelle-Aquitaine;33;2;11;084;Cambes;1766;17;1783
75;Nouvelle-Aquitaine;33;2;11;085;Camblanes-et-Meynac;3040;140;3180
75;Nouvelle-Aquitaine;33;5;10;086;Camiac-et-Saint-Denis;360;5;365
75;Nouvelle-Aquitaine;33;3;27;087;Camiran;415;3;418
75;Nouvelle-Aquitaine;33;5;21;088;Camps-sur-l'Isle;605;10;615
75;Nouvelle-Aquitaine;33;1;13;089;Campugnan;504;6;510
75;Nouvelle-Aquitaine;33;2;23;090;Canéjan;5997;77;6074
75;Nouvelle-Aquitaine;33;3;12;093;Capian;771;17;788
75;Nouvelle-Aquitaine;33;5;27;094;Caplong;227;4;231
75;Nouvelle-Aquitaine;33;3;29;095;Captieux;1344;20;1364
75;Nouvelle-Aquitaine;33;2;26;096;Carbon-Blanc;8272;83;8355
75;Nouvelle-Aquitaine;33;4;30;097;Carcans;2420;35;2455
75;Nouvelle-Aquitaine;33;3;12;098;Cardan;514;5;519
75;Nouvelle-Aquitaine;33;2;11;099;Carignan-de-Bordeaux;4161;46;4207
75;Nouvelle-Aquitaine;33;1;13;100;Cars;1213;21;1234
75;Nouvelle-Aquitaine;33;1;13;101;Cartelègue;1254;23;1277
75;Nouvelle-Aquitaine;33;3;27;102;Casseuil;376;5;381
75;Nouvelle-Aquitaine;33;3;27;103;Castelmoron-d'Albret;53;0;53
75;Nouvelle-Aquitaine;33;4;30;104;Castelnau-de-Médoc;4820;65;4885
75;Nouvelle-Aquitaine;33;3;27;105;Castelviel;214;8;222
75;Nouvelle-Aquitaine;33;3;29;106;Castets et Castillon;1487;32;1519
75;Nouvelle-Aquitaine;33;5;10;108;Castillon-la-Bataille;3238;27;3265
75;Nouvelle-Aquitaine;33;2;08;109;Castres-Gironde;2462;34;2496
75;Nouvelle-Aquitaine;33;3;12;111;Caudrot;1111;15;1126
75;Nouvelle-Aquitaine;33;3;27;112;Caumont;140;2;142
75;Nouvelle-Aquitaine;33;3;29;113;Cauvignac;147;3;150
75;Nouvelle-Aquitaine;33;1;20;114;Cavignac;2292;16;2308
75;Nouvelle-Aquitaine;33;3;29;115;Cazalis;239;1;240
75;Nouvelle-Aquitaine;33;3;29;116;Cazats;400;5;405
75;Nouvelle-Aquitaine;33;3;27;117;Cazaugitat;217;3;220
75;Nouvelle-Aquitaine;33;2;11;118;Cénac;2118;35;2153
75;Nouvelle-Aquitaine;33;2;09;119;Cenon;26047;231;26278
75;Nouvelle-Aquitaine;33;3;15;120;Cérons;2133;42;2175
75;Nouvelle-Aquitaine;33;3;12;121;Cessac;193;2;195
75;Nouvelle-Aquitaine;33;2;23;122;Cestas;16932;287;17219
75;Nouvelle-Aquitaine;33;1;20;123;Cézac;2678;33;2711
75;Nouvelle-Aquitaine;33;5;21;124;Chamadelle;724;15;739
75;Nouvelle-Aquitaine;33;4;22;125;Cissac-Médoc;2213;29;2242
75;Nouvelle-Aquitaine;33;1;20;126;Civrac-de-Blaye;845;18;863
75;Nouvelle-Aquitaine;33;5;10;127;Civrac-sur-Dordogne;222;5;227
75;Nouvelle-Aquitaine;33;4;22;128;Civrac-en-Médoc;642;14;656
75;Nouvelle-Aquitaine;33;3;27;129;Cleyrac;153;0;153
75;Nouvelle-Aquitaine;33;3;27;130;Coimères;1057;27;1084
75;Nouvelle-Aquitaine;33;3;12;131;Coirac;212;2;214
75;Nouvelle-Aquitaine;33;1;13;132;Comps;553;8;561
75;Nouvelle-Aquitaine;33;5;10;133;Coubeyrac;71;0;71
75;Nouvelle-Aquitaine;33;4;22;134;Couquèques;269;7;276
75;Nouvelle-Aquitaine;33;3;12;135;Courpiac;126;0;126
75;Nouvelle-Aquitaine;33;3;27;136;Cours-de-Monségur;269;3;272
75;Nouvelle-Aquitaine;33;3;29;137;Cours-les-Bains;218;4;222
75;Nouvelle-Aquitaine;33;5;21;138;Coutras;8623;123;8746
75;Nouvelle-Aquitaine;33;3;27;139;Coutures;97;2;99
75;Nouvelle-Aquitaine;33;2;11;140;Créon;4899;99;4998
75;Nouvelle-Aquitaine;33;2;11;141;Croignon;715;9;724
75;Nouvelle-Aquitaine;33;1;20;142;Cubnezais;1726;17;1743
75;Nouvelle-Aquitaine;33;1;20;143;Cubzac-les-Ponts;2531;27;2558
75;Nouvelle-Aquitaine;33;3;29;144;Cudos;789;130;919
75;Nouvelle-Aquitaine;33;2;11;145;Cursan;663;18;681
75;Nouvelle-Aquitaine;33;4;30;146;Cussac-Fort-Médoc;2363;29;2392
75;Nouvelle-Aquitaine;33;5;10;147;Daignac;465;6;471
75;Nouvelle-Aquitaine;33;5;10;148;Dardenac;90;5;95
75;Nouvelle-Aquitaine;33;3;27;149;Daubèze;155;1;156
75;Nouvelle-Aquitaine;33;3;27;150;Dieulivol;338;2;340
75;Nouvelle-Aquitaine;33;1;20;151;Donnezac;925;10;935
75;Nouvelle-Aquitaine;33;3;12;152;Donzac;120;5;125
75;Nouvelle-Aquitaine;33;5;10;153;Doulezon;263;4;267
75;Nouvelle-Aquitaine;33;5;21;154;Les Églisottes-et-Chalaures;2145;102;2247
75;Nouvelle-Aquitaine;33;3;29;155;Escaudes;160;3;163
75;Nouvelle-Aquitaine;33;3;12;156;Escoussans;283;8;291
75;Nouvelle-Aquitaine;33;5;10;157;Espiet;780;11;791
75;Nouvelle-Aquitaine;33;3;27;158;Les Esseintes;241;7;248
75;Nouvelle-Aquitaine;33;1;13;159;Étauliers;1470;14;1484
75;Nouvelle-Aquitaine;33;5;27;160;Eynesse;594;16;610
75;Nouvelle-Aquitaine;33;1;13;161;Eyrans;761;6;767
75;Nouvelle-Aquitaine;33;2;25;162;Eysines;24202;281;24483
75;Nouvelle-Aquitaine;33;3;12;163;Faleyras;430;9;439
75;Nouvelle-Aquitaine;33;3;29;164;Fargues;1647;33;1680
75;Nouvelle-Aquitaine;33;2;11;165;Fargues-Saint-Hilaire;3303;28;3331
75;Nouvelle-Aquitaine;33;5;21;166;Le Fieu;501;4;505
75;Nouvelle-Aquitaine;33;2;09;167;Floirac;18013;117;18130
75;Nouvelle-Aquitaine;33;5;10;168;Flaujagues;594;9;603
75;Nouvelle-Aquitaine;33;3;27;169;Floudès;110;4;114
75;Nouvelle-Aquitaine;33;3;27;170;Fontet;769;19;788
75;Nouvelle-Aquitaine;33;3;27;171;Fossès-et-Baleyssac;228;6;234
75;Nouvelle-Aquitaine;33;1;13;172;Fours;273;11;284
75;Nouvelle-Aquitaine;33;5;21;173;Francs;184;6;190
75;Nouvelle-Aquitaine;33;5;16;174;Fronsac;1132;34;1166
75;Nouvelle-Aquitaine;33;3;12;175;Frontenac;749;10;759
75;Nouvelle-Aquitaine;33;3;12;176;Gabarnac;356;7;363
75;Nouvelle-Aquitaine;33;4;22;177;Gaillan-en-Médoc;2355;42;2397
75;Nouvelle-Aquitaine;33;3;29;178;Gajac;372;6;378
75;Nouvelle-Aquitaine;33;5;16;179;Galgon;3030;55;3085
75;Nouvelle-Aquitaine;33;3;29;180;Gans;192;8;200
75;Nouvelle-Aquitaine;33;5;10;181;Gardegan-et-Tourtirac;279;4;283
75;Nouvelle-Aquitaine;33;1;13;182;Gauriac;721;16;737
75;Nouvelle-Aquitaine;33;1;20;183;Gauriaguet;1432;16;1448
75;Nouvelle-Aquitaine;33;1;20;184;Générac;544;15;559
75;Nouvelle-Aquitaine;33;5;10;185;Génissac;1992;36;2028
75;Nouvelle-Aquitaine;33;5;10;186;Gensac;701;13;714
75;Nouvelle-Aquitaine;33;3;27;187;Gironde-sur-Dropt;1321;24;1345
75;Nouvelle-Aquitaine;33;3;29;188;Giscos;184;3;187
75;Nouvelle-Aquitaine;33;3;12;189;Gornac;436;10;446
75;Nouvelle-Aquitaine;33;3;29;190;Goualade;86;1;87
75;Nouvelle-Aquitaine;33;5;21;191;Gours;564;8;572
75;Nouvelle-Aquitaine;33;2;24;192;Gradignan;25871;337;26208
75;Nouvelle-Aquitaine;33;4;22;193;Grayan-et-l'Hôpital;1543;25;1568
75;Nouvelle-Aquitaine;33;5;10;194;Grézillac;691;15;706
75;Nouvelle-Aquitaine;33;3;29;195;Grignols;1192;8;1200
75;Nouvelle-Aquitaine;33;5;10;196;Guillac;158;4;162
75;Nouvelle-Aquitaine;33;3;15;197;Guillos;451;6;457
75;Nouvelle-Aquitaine;33;5;21;198;Guîtres;1606;29;1635
75;Nouvelle-Aquitaine;33;6;14;199;Gujan-Mestras;22036;449;22485
75;Nouvelle-Aquitaine;33;2;18;200;Le Haillan;11567;189;11756
75;Nouvelle-Aquitaine;33;2;12;201;Haux;836;18;854
75;Nouvelle-Aquitaine;33;3;15;202;Hostens;1482;19;1501
75;Nouvelle-Aquitaine;33;4;30;203;Hourtin;3967;70;4037
75;Nouvelle-Aquitaine;33;3;27;204;Hure;557;7;564
75;Nouvelle-Aquitaine;33;3;15;205;Illats;1378;21;1399
75;Nouvelle-Aquitaine;33;2;08;206;Isle-Saint-Georges;521;3;524
75;Nouvelle-Aquitaine;33;5;16;207;Izon;6298;67;6365
75;Nouvelle-Aquitaine;33;4;22;208;Jau-Dignac-et-Loirac;954;9;963
75;Nouvelle-Aquitaine;33;5;10;209;Jugazan;275;7;282
75;Nouvelle-Aquitaine;33;5;10;210;Juillac;225;4;229
75;Nouvelle-Aquitaine;33;4;30;211;Labarde;610;2;612
75;Nouvelle-Aquitaine;33;3;29;212;Labescau;126;1;127
75;Nouvelle-Aquitaine;33;2;08;213;La Brède;4461;494;4955
75;Nouvelle-Aquitaine;33;4;30;214;Lacanau;5064;77;5141
75;Nouvelle-Aquitaine;33;3;12;215;Ladaux;192;6;198
75;Nouvelle-Aquitaine;33;3;27;216;Lados;173;3;176
75;Nouvelle-Aquitaine;33;5;21;218;Lagorce;1642;24;1666
75;Nouvelle-Aquitaine;33;5;16;219;La Lande-de-Fronsac;2579;25;2604
75;Nouvelle-Aquitaine;33;4;30;220;Lamarque;1340;12;1352
75;Nouvelle-Aquitaine;33;3;27;221;Lamothe-Landerron;1132;21;1153
75;Nouvelle-Aquitaine;33;5;16;222;Lalande-de-Pomerol;656;15;671
75;Nouvelle-Aquitaine;33;3;27;223;Landerrouat;222;3;225
75;Nouvelle-Aquitaine;33;3;27;224;Landerrouet-sur-Ségur;101;0;101
75;Nouvelle-Aquitaine;33;3;15;225;Landiras;2190;39;2229
75;Nouvelle-Aquitaine;33;3;12;226;Langoiran;2172;39;2211
75;Nouvelle-Aquitaine;33;3;29;227;Langon;7366;150;7516
75;Nouvelle-Aquitaine;33;1;13;228;Lansac;682;10;692
75;Nouvelle-Aquitaine;33;6;01;229;Lanton;7273;140;7413
75;Nouvelle-Aquitaine;33;5;21;230;Lapouyade;516;5;521
75;Nouvelle-Aquitaine;33;3;12;231;Laroque;291;4;295
75;Nouvelle-Aquitaine;33;3;29;232;Lartigue;40;0;40
75;Nouvelle-Aquitaine;33;1;20;233;Laruscade;2821;22;2843
75;Nouvelle-Aquitaine;33;2;11;234;Latresne;3578;144;3722
75;Nouvelle-Aquitaine;33;3;29;235;Lavazan;230;2;232
75;Nouvelle-Aquitaine;33;6;01;236;Lège-Cap-Ferret;8334;170;8504
75;Nouvelle-Aquitaine;33;3;29;237;Léogeats;843;21;864
75;Nouvelle-Aquitaine;33;2;08;238;Léognan;10641;163;10804
75;Nouvelle-Aquitaine;33;3;29;239;Lerm-et-Musset;476;5;481
75;Nouvelle-Aquitaine;33;4;22;240;Lesparre-Médoc;5826;94;5920
75;Nouvelle-Aquitaine;33;3;12;241;Lestiac-sur-Garonne;578;9;587
75;Nouvelle-Aquitaine;33;5;27;242;Les Lèves-et-Thoumeyragues;561;10;571
75;Nouvelle-Aquitaine;33;5;16;243;Libourne;24432;509;24941
75;Nouvelle-Aquitaine;33;3;29;244;Lignan-de-Bazas;427;6;433
75;Nouvelle-Aquitaine;33;2;11;245;Lignan-de-Bordeaux;830;15;845
75;Nouvelle-Aquitaine;33;5;27;246;Ligueux;149;6;155
75;Nouvelle-Aquitaine;33;3;27;247;Listrac-de-Durèze;163;4;167
75;Nouvelle-Aquitaine;33;4;30;248;Listrac-Médoc;2790;36;2826
75;Nouvelle-Aquitaine;33;2;17;249;Lormont;22913;318;23231
75;Nouvelle-Aquitaine;33;3;27;250;Loubens;309;8;317
75;Nouvelle-Aquitaine;33;3;15;251;Louchats;725;9;734
75;Nouvelle-Aquitaine;33;2;11;252;Loupes;884;13;897
75;Nouvelle-Aquitaine;33;3;12;253;Loupiac;1106;17;1123
75;Nouvelle-Aquitaine;33;3;27;254;Loupiac-de-la-Réole;520;8;528
75;Nouvelle-Aquitaine;33;3;29;255;Lucmau;245;3;248
75;Nouvelle-Aquitaine;33;2;25;256;Ludon-Médoc;5252;46;5298
75;Nouvelle-Aquitaine;33;5;10;257;Lugaignac;475;12;487
75;Nouvelle-Aquitaine;33;3;12;258;Lugasson;308;6;314
75;Nouvelle-Aquitaine;33;5;16;259;Lugon-et-l'Île-du-Carnay;1369;26;1395
75;Nouvelle-Aquitaine;33;6;15;260;Lugos;995;22;1017
75;Nouvelle-Aquitaine;33;5;21;261;Lussac;1223;10;1233
75;Nouvelle-Aquitaine;33;2;30;262;Macau;4478;25;4503
75;Nouvelle-Aquitaine;33;2;11;263;Madirac;293;4;297
75;Nouvelle-Aquitaine;33;5;21;264;Maransin;1021;12;1033
75;Nouvelle-Aquitaine;33;1;20;266;Marcenais;821;19;840
75;Nouvelle-Aquitaine;33;4;30;268;Margaux-Cantenac;2832;29;2861
75;Nouvelle-Aquitaine;33;5;27;269;Margueron;390;4;394
75;Nouvelle-Aquitaine;33;3;29;270;Marimbault;181;8;189
75;Nouvelle-Aquitaine;33;3;29;271;Marions;221;2;223
75;Nouvelle-Aquitaine;33;1;20;272;Marsas;1222;22;1244
75;Nouvelle-Aquitaine;33;2;19;273;Martignas-sur-Jalle;7741;131;7872
75;Nouvelle-Aquitaine;33;2;08;274;Martillac;3406;41;3447
75;Nouvelle-Aquitaine;33;3;12;275;Martres;103;2;105
75;Nouvelle-Aquitaine;33;3;29;276;Masseilles;140;5;145
75;Nouvelle-Aquitaine;33;3;27;277;Massugas;221;6;227
75;Nouvelle-Aquitaine;33;3;27;278;Mauriac;232;6;238
75;Nouvelle-Aquitaine;33;3;29;279;Mazères;778;10;788
75;Nouvelle-Aquitaine;33;1;13;280;Mazion;554;4;558
75;Nouvelle-Aquitaine;33;2;98;281;Mérignac;74009;766;74775
75;Nouvelle-Aquitaine;33;3;27;282;Mérignas;333;6;339
75;Nouvelle-Aquitaine;33;3;27;283;Mesterrieux;228;1;229
75;Nouvelle-Aquitaine;33;6;14;284;Mios;11180;132;11312
75;Nouvelle-Aquitaine;33;1;13;285;Mombrier;440;9;449
75;Nouvelle-Aquitaine;33;3;27;287;Mongauzy;599;6;605
75;Nouvelle-Aquitaine;33;3;12;288;Monprimblanc;281;4;285
75;Nouvelle-Aquitaine;33;3;27;289;Monségur;1598;70;1668
75;Nouvelle-Aquitaine;33;5;21;290;Montagne;1519;129;1648
75;Nouvelle-Aquitaine;33;3;27;291;Montagoudin;177;3;180
75;Nouvelle-Aquitaine;33;3;12;292;Montignac;136;6;142
75;Nouvelle-Aquitaine;33;2;17;293;Montussan;3412;51;3463
75;Nouvelle-Aquitaine;33;3;27;294;Morizès;543;4;547
75;Nouvelle-Aquitaine;33;5;16;295;Mouillac;89;9;98
75;Nouvelle-Aquitaine;33;5;10;296;Mouliets-et-Villemartin;1031;15;1046
75;Nouvelle-Aquitaine;33;4;30;297;Moulis-en-Médoc;1893;33;1926
75;Nouvelle-Aquitaine;33;5;10;298;Moulon;1020;20;1040
75;Nouvelle-Aquitaine;33;3;12;299;Mourens;383;8;391
75;Nouvelle-Aquitaine;33;4;22;300;Naujac-sur-Mer;1080;23;1103
75;Nouvelle-Aquitaine;33;5;10;301;Naujan-et-Postiac;617;6;623
75;Nouvelle-Aquitaine;33;5;21;302;Néac;340;10;350
75;Nouvelle-Aquitaine;33;5;10;303;Nérigean;842;8;850
75;Nouvelle-Aquitaine;33;3;27;304;Neuffons;141;4;145
75;Nouvelle-Aquitaine;33;3;29;305;Le Nizan;503;5;508
75;Nouvelle-Aquitaine;33;3;27;306;Noaillac;518;6;524
75;Nouvelle-Aquitaine;33;3;29;307;Noaillan;1671;37;1708
75;Nouvelle-Aquitaine;33;3;12;308;Omet;308;2;310
75;Nouvelle-Aquitaine;33;4;22;309;Ordonnac;492;6;498
75;Nouvelle-Aquitaine;33;3;15;310;Origne;187;2;189
75;Nouvelle-Aquitaine;33;3;12;311;Paillet;1208;24;1232
75;Nouvelle-Aquitaine;33;2;25;312;Parempuyre;9786;92;9878
75;Nouvelle-Aquitaine;33;4;22;314;Pauillac;5084;80;5164
75;Nouvelle-Aquitaine;33;5;21;315;Les Peintures;1634;21;1655
75;Nouvelle-Aquitaine;33;3;27;316;Pellegrue;903;13;916
75;Nouvelle-Aquitaine;33;5;20;317;Périssac;1192;16;1208
75;Nouvelle-Aquitaine;33;2;99;318;Pessac;65866;740;66606
75;Nouvelle-Aquitaine;33;5;10;319;Pessac-sur-Dordogne;441;9;450
75;Nouvelle-Aquitaine;33;5;21;320;Petit-Palais-et-Cornemps;725;17;742
75;Nouvelle-Aquitaine;33;1;20;321;Peujard;2161;28;2189
75;Nouvelle-Aquitaine;33;2;25;322;Le Pian-Médoc;6995;143;7138
75;Nouvelle-Aquitaine;33;3;12;323;Le Pian-sur-Garonne;940;19;959
75;Nouvelle-Aquitaine;33;5;27;324;Pineuilh;4421;116;4537
75;Nouvelle-Aquitaine;33;1;13;325;Plassac;938;19;957
75;Nouvelle-Aquitaine;33;1;13;326;Pleine-Selve;218;5;223
75;Nouvelle-Aquitaine;33;3;15;327;Podensac;3258;51;3309
75;Nouvelle-Aquitaine;33;5;16;328;Pomerol;589;6;595
75;Nouvelle-Aquitaine;33;3;29;329;Pompéjac;271;3;274
75;Nouvelle-Aquitaine;33;2;11;330;Pompignac;3301;56;3357
75;Nouvelle-Aquitaine;33;3;27;331;Pondaurat;460;4;464
75;Nouvelle-Aquitaine;33;5;21;332;Porchères;871;10;881
75;Nouvelle-Aquitaine;33;4;30;333;Le Porge;3324;47;3371
75;Nouvelle-Aquitaine;33;3;15;334;Portets;2713;35;2748
75;Nouvelle-Aquitaine;33;2;11;335;Le Pout;621;8;629
75;Nouvelle-Aquitaine;33;3;29;336;Préchac;1022;19;1041
75;Nouvelle-Aquitaine;33;3;15;337;Preignac;2172;35;2207
75;Nouvelle-Aquitaine;33;1;13;339;Prignac-et-Marcamps;1383;29;1412
75;Nouvelle-Aquitaine;33;1;13;341;Pugnac;2354;34;2388
75;Nouvelle-Aquitaine;33;5;21;342;Puisseguin;818;21;839
75;Nouvelle-Aquitaine;33;3;15;343;Pujols-sur-Ciron;865;16;881
75;Nouvelle-Aquitaine;33;5;10;344;Pujols;526;6;532
75;Nouvelle-Aquitaine;33;3;27;345;Le Puy;403;7;410
75;Nouvelle-Aquitaine;33;3;27;346;Puybarban;411;11;422
75;Nouvelle-Aquitaine;33;5;21;347;Puynormand;307;5;312
75;Nouvelle-Aquitaine;33;4;22;348;Queyrac;1360;16;1376
75;Nouvelle-Aquitaine;33;2;11;349;Quinsac;2214;23;2237
75;Nouvelle-Aquitaine;33;5;10;350;Rauzan;1248;25;1273
75;Nouvelle-Aquitaine;33;1;13;351;Reignac;1613;26;1639
75;Nouvelle-Aquitaine;33;3;27;352;La Réole;4351;84;4435
75;Nouvelle-Aquitaine;33;3;27;353;Rimons;197;1;198
75;Nouvelle-Aquitaine;33;5;27;354;Riocaud;197;5;202
75;Nouvelle-Aquitaine;33;3;12;355;Rions;1509;36;1545
75;Nouvelle-Aquitaine;33;5;16;356;La Rivière;425;5;430
75;Nouvelle-Aquitaine;33;3;29;357;Roaillan;1760;27;1787
75;Nouvelle-Aquitaine;33;3;12;358;Romagne;471;8;479
75;Nouvelle-Aquitaine;33;3;27;359;Roquebrune;283;3;286
75;Nouvelle-Aquitaine;33;5;27;360;La Roquille;313;3;316
75;Nouvelle-Aquitaine;33;3;27;361;Ruch;579;8;587
75;Nouvelle-Aquitaine;33;5;21;362;Sablons;1309;15;1324
75;Nouvelle-Aquitaine;33;2;11;363;Sadirac;4626;72;4698
75;Nouvelle-Aquitaine;33;5;16;364;Saillans;376;7;383
75;Nouvelle-Aquitaine;33;5;16;365;Saint-Aignan;199;9;208
75;Nouvelle-Aquitaine;33;1;20;366;Saint-André-de-Cubzac;12735;189;12924
75;Nouvelle-Aquitaine;33;3;12;367;Saint-André-du-Bois;431;3;434
75;Nouvelle-Aquitaine;33;5;27;369;Saint-André-et-Appelles;669;13;682
75;Nouvelle-Aquitaine;33;1;13;370;Saint-Androny;556;7;563
75;Nouvelle-Aquitaine;33;3;27;372;Saint-Antoine-du-Queyret;55;2;57
75;Nouvelle-Aquitaine;33;5;21;373;Saint-Antoine-sur-l'Isle;581;9;590
75;Nouvelle-Aquitaine;33;1;13;374;Saint-Aubin-de-Blaye;846;11;857
75;Nouvelle-Aquitaine;33;5;10;375;Saint-Aubin-de-Branne;376;8;384
75;Nouvelle-Aquitaine;33;2;28;376;Saint-Aubin-de-Médoc;7574;215;7789
75;Nouvelle-Aquitaine;33;5;27;377;Saint-Avit-de-Soulège;78;3;81
75;Nouvelle-Aquitaine;33;5;27;378;Saint-Avit-Saint-Nazaire;1485;21;1506
75;Nouvelle-Aquitaine;33;3;27;379;Saint-Brice;314;1;315
75;Nouvelle-Aquitaine;33;1;13;380;Val-de-Livenne;1786;23;1809
75;Nouvelle-Aquitaine;33;2;11;381;Saint-Caprais-de-Bordeaux;3419;48;3467
75;Nouvelle-Aquitaine;33;1;20;382;Saint-Christoly-de-Blaye;1870;29;1899
75;Nouvelle-Aquitaine;33;4;22;383;Saint-Christoly-Médoc;277;3;280
75;Nouvelle-Aquitaine;33;5;21;384;Saint-Christophe-des-Bardes;406;7;413
75;Nouvelle-Aquitaine;33;5;21;385;Saint-Christophe-de-Double;615;5;620
75;Nouvelle-Aquitaine;33;5;21;386;Saint-Cibard;192;6;198
75;Nouvelle-Aquitaine;33;5;21;387;Saint-Ciers-d'Abzac;1502;24;1526
75;Nouvelle-Aquitaine;33;1;13;388;Saint-Ciers-de-Canesse;759;16;775
75;Nouvelle-Aquitaine;33;1;13;389;Saint-Ciers-sur-Gironde;3029;42;3071
75;Nouvelle-Aquitaine;33;5;10;390;Sainte-Colombe;423;8;431
75;Nouvelle-Aquitaine;33;3;29;391;Saint-Côme;335;4;339
75;Nouvelle-Aquitaine;33;3;12;392;Sainte-Croix-du-Mont;848;16;864
75;Nouvelle-Aquitaine;33;5;21;393;Saint-Denis-de-Pile;5791;71;5862
75;Nouvelle-Aquitaine;33;5;10;394;Saint-Émilion;1844;45;1889
75;Nouvelle-Aquitaine;33;4;22;395;Saint-Estèphe;1604;37;1641
75;Nouvelle-Aquitaine;33;5;10;396;Saint-Étienne-de-Lisse;190;4;194
75;Nouvelle-Aquitaine;33;2;26;397;Sainte-Eulalie;4932;85;5017
75;Nouvelle-Aquitaine;33;3;27;398;Saint-Exupéry;169;2;171
75;Nouvelle-Aquitaine;33;3;27;399;Saint-Félix-de-Foncaude;290;7;297
75;Nouvelle-Aquitaine;33;3;27;400;Saint-Ferme;340;5;345
75;Nouvelle-Aquitaine;33;5;10;401;Sainte-Florence;149;2;151
75;Nouvelle-Aquitaine;33;5;27;402;Sainte-Foy-la-Grande;2665;32;2697
75;Nouvelle-Aquitaine;33;3;12;403;Sainte-Foy-la-Longue;136;3;139
75;Nouvelle-Aquitaine;33;3;27;404;Sainte-Gemme;192;3;195
75;Nouvelle-Aquitaine;33;1;13;405;Saint-Genès-de-Blaye;499;12;511
75;Nouvelle-Aquitaine;33;5;10;406;Saint-Genès-de-Castillon;373;7;380
75;Nouvelle-Aquitaine;33;5;20;407;Saint-Genès-de-Fronsac;889;18;907
75;Nouvelle-Aquitaine;33;2;11;408;Saint-Genès-de-Lombaud;390;17;407
75;Nouvelle-Aquitaine;33;3;12;409;Saint-Genis-du-Bois;86;1;87
75;Nouvelle-Aquitaine;33;3;12;411;Saint-Germain-de-Grave;152;4;156
75;Nouvelle-Aquitaine;33;4;22;412;Saint-Germain-d'Esteuil;1286;13;1299
75;Nouvelle-Aquitaine;33;5;10;413;Saint-Germain-du-Puch;2259;36;2295
75;Nouvelle-Aquitaine;33;5;16;414;Saint-Germain-de-la-Rivière;393;3;396
75;Nouvelle-Aquitaine;33;1;20;415;Saint-Gervais;1919;20;1939
75;Nouvelle-Aquitaine;33;1;20;416;Saint-Girons-d'Aiguevives;940;10;950
75;Nouvelle-Aquitaine;33;4;30;417;Sainte-Hélène;2939;46;2985
75;Nouvelle-Aquitaine;33;3;27;418;Saint-Hilaire-de-la-Noaille;376;8;384
75;Nouvelle-Aquitaine;33;3;27;419;Saint-Hilaire-du-Bois;81;0;81
75;Nouvelle-Aquitaine;33;5;10;420;Saint-Hippolyte;133;1;134
75;Nouvelle-Aquitaine;33;5;10;421;Saint-Jean-de-Blaignac;459;5;464
75;Nouvelle-Aquitaine;33;2;19;422;Saint-Jean-d'Illac;9106;165;9271
75;Nouvelle-Aquitaine;33;4;22;423;Saint-Julien-Beychevelle;616;0;616
75;Nouvelle-Aquitaine;33;4;30;424;Saint-Laurent-Médoc;4905;91;4996
75;Nouvelle-Aquitaine;33;1;20;425;Saint-Laurent-d'Arce;1500;28;1528
75;Nouvelle-Aquitaine;33;5;10;426;Saint-Laurent-des-Combes;245;4;249
75;Nouvelle-Aquitaine;33;3;12;427;Saint-Laurent-du-Bois;250;5;255
75;Nouvelle-Aquitaine;33;3;12;428;Saint-Laurent-du-Plan;83;0;83
75;Nouvelle-Aquitaine;33;3;15;429;Saint-Léger-de-Balson;323;5;328
75;Nouvelle-Aquitaine;33;2;12;431;Saint-Léon;327;9;336
75;Nouvelle-Aquitaine;33;3;29;432;Saint-Loubert;241;2;243
75;Nouvelle-Aquitaine;33;2;26;433;Saint-Loubès;9953;106;10059
75;Nouvelle-Aquitaine;33;2;26;434;Saint-Louis-de-Montferrand;2149;15;2164
75;Nouvelle-Aquitaine;33;3;12;435;Saint-Macaire;2035;102;2137
75;Nouvelle-Aquitaine;33;6;15;436;Saint-Magne;1109;12;1121
75;Nouvelle-Aquitaine;33;5;10;437;Saint-Magne-de-Castillon;2030;26;2056
75;Nouvelle-Aquitaine;33;3;12;438;Saint-Maixant;2014;51;2065
75;Nouvelle-Aquitaine;33;1;20;439;Saint-Mariens;1619;17;1636
75;Nouvelle-Aquitaine;33;3;12;440;Saint-Martial;238;5;243
75;Nouvelle-Aquitaine;33;1;13;441;Saint-Martin-Lacaussade;1160;97;1257
75;Nouvelle-Aquitaine;33;5;21;442;Saint-Martin-de-Laye;551;7;558
75;Nouvelle-Aquitaine;33;3;27;443;Saint-Martin-de-Lerm;155;3;158
75;Nouvelle-Aquitaine;33;3;12;444;Saint-Martin-de-Sescas;571;10;581
75;Nouvelle-Aquitaine;33;5;21;445;Saint-Martin-du-Bois;835;17;852
75;Nouvelle-Aquitaine;33;3;27;446;Saint-Martin-du-Puy;164;1;165
75;Nouvelle-Aquitaine;33;5;21;447;Saint-Médard-de-Guizières;2386;20;2406
75;Nouvelle-Aquitaine;33;2;08;448;Saint-Médard-d'Eyrans;3156;40;3196
75;Nouvelle-Aquitaine;33;2;28;449;Saint-Médard-en-Jalles;32357;509;32866
75;Nouvelle-Aquitaine;33;3;29;450;Saint-Michel-de-Castelnau;245;3;248
75;Nouvelle-Aquitaine;33;5;16;451;Saint-Michel-de-Fronsac;528;4;532
75;Nouvelle-Aquitaine;33;3;15;452;Saint-Michel-de-Rieufret;864;14;878
75;Nouvelle-Aquitaine;33;3;27;453;Saint-Michel-de-Lapujade;217;4;221
75;Nouvelle-Aquitaine;33;2;08;454;Saint-Morillon;1755;43;1798
75;Nouvelle-Aquitaine;33;1;13;456;Saint-Palais;499;7;506
75;Nouvelle-Aquitaine;33;3;29;457;Saint-Pardon-de-Conques;610;9;619
75;Nouvelle-Aquitaine;33;1;13;458;Saint-Paul;996;20;1016
75;Nouvelle-Aquitaine;33;5;10;459;Saint-Pey-d'Armens;185;3;188
75;Nouvelle-Aquitaine;33;5;10;460;Saint-Pey-de-Castets;603;12;615
75;Nouvelle-Aquitaine;33;5;10;461;Saint-Philippe-d'Aiguille;376;5;381
75;Nouvelle-Aquitaine;33;5;27;462;Saint-Philippe-du-Seignal;502;9;511
75;Nouvelle-Aquitaine;33;3;12;463;Saint-Pierre-d'Aurillac;1312;20;1332
75;Nouvelle-Aquitaine;33;3;12;464;Saint-Pierre-de-Bat;288;7;295
75;Nouvelle-Aquitaine;33;3;29;465;Saint-Pierre-de-Mons;1236;21;1257
75;Nouvelle-Aquitaine;33;5;10;466;Saint-Quentin-de-Baron;2620;32;2652
75;Nouvelle-Aquitaine;33;5;27;467;Saint-Quentin-de-Caplong;235;4;239
75;Nouvelle-Aquitaine;33;5;10;468;Sainte-Radegonde;434;9;443
75;Nouvelle-Aquitaine;33;5;16;470;Saint-Romain-la-Virvée;897;15;912
75;Nouvelle-Aquitaine;33;4;22;471;Saint-Sauveur;1265;27;1292
75;Nouvelle-Aquitaine;33;5;21;472;Saint-Sauveur-de-Puynormand;366;6;372
75;Nouvelle-Aquitaine;33;1;20;473;Saint-Savin;3313;39;3352
75;Nouvelle-Aquitaine;33;2;08;474;Saint-Selve;3488;48;3536
75;Nouvelle-Aquitaine;33;1;13;475;Saint-Seurin-de-Bourg;408;6;414
75;Nouvelle-Aquitaine;33;4;22;476;Saint-Seurin-de-Cadourne;700;12;712
75;Nouvelle-Aquitaine;33;1;13;477;Saint-Seurin-de-Cursac;766;13;779
75;Nouvelle-Aquitaine;33;5;21;478;Saint-Seurin-sur-l'Isle;3134;21;3155
75;Nouvelle-Aquitaine;33;3;27;479;Saint-Sève;249;2;251
75;Nouvelle-Aquitaine;33;5;10;480;Saint-Sulpice-de-Faleyrens;1304;28;1332
75;Nouvelle-Aquitaine;33;3;27;481;Saint-Sulpice-de-Guilleragues;233;3;236
75;Nouvelle-Aquitaine;33;3;27;482;Saint-Sulpice-de-Pommiers;262;3;265
75;Nouvelle-Aquitaine;33;2;26;483;Saint-Sulpice-et-Cameyrac;4848;68;4916
75;Nouvelle-Aquitaine;33;3;15;484;Saint-Symphorien;1819;31;1850
75;Nouvelle-Aquitaine;33;5;10;485;Sainte-Terre;1904;31;1935
75;Nouvelle-Aquitaine;33;1;13;486;Saint-Trojan;364;8;372
75;Nouvelle-Aquitaine;33;2;26;487;Saint-Vincent-de-Paul;978;7;985
75;Nouvelle-Aquitaine;33;5;10;488;Saint-Vincent-de-Pertignas;342;12;354
75;Nouvelle-Aquitaine;33;1;20;489;Saint-Vivien-de-Blaye;363;5;368
75;Nouvelle-Aquitaine;33;4;22;490;Saint-Vivien-de-Médoc;1795;24;1819
75;Nouvelle-Aquitaine;33;3;27;491;Saint-Vivien-de-Monségur;395;5;400
75;Nouvelle-Aquitaine;33;1;20;492;Saint-Yzan-de-Soudiac;2478;30;2508
75;Nouvelle-Aquitaine;33;4;22;493;Saint-Yzans-de-Médoc;345;24;369
75;Nouvelle-Aquitaine;33;4;30;494;Salaunes;1211;11;1222
75;Nouvelle-Aquitaine;33;2;11;496;Sallebœuf;2710;41;2751
75;Nouvelle-Aquitaine;33;6;15;498;Salles;7646;118;7764
75;Nouvelle-Aquitaine;33;5;10;499;Les Salles-de-Castillon;327;8;335
75;Nouvelle-Aquitaine;33;1;13;500;Samonac;443;4;447
75;Nouvelle-Aquitaine;33;2;08;501;Saucats;3355;60;3415
75;Nouvelle-Aquitaine;33;1;20;502;Saugon;493;6;499
75;Nouvelle-Aquitaine;33;4;30;503;Saumos;531;8;539
75;Nouvelle-Aquitaine;33;3;29;504;Sauternes;824;10;834
75;Nouvelle-Aquitaine;33;2;12;505;La Sauve;1573;54;1627
75;Nouvelle-Aquitaine;33;3;27;506;Sauveterre-de-Guyenne;1858;19;1877
75;Nouvelle-Aquitaine;33;3;29;507;Sauviac;324;11;335
75;Nouvelle-Aquitaine;33;3;27;508;Savignac;630;13;643
75;Nouvelle-Aquitaine;33;5;21;509;Savignac-de-l'Isle;535;1;536
75;Nouvelle-Aquitaine;33;3;12;510;Semens;220;1;221
75;Nouvelle-Aquitaine;33;3;29;511;Sendets;342;6;348
75;Nouvelle-Aquitaine;33;3;27;512;Sigalens;353;8;361
75;Nouvelle-Aquitaine;33;3;29;513;Sillas;121;0;121
75;Nouvelle-Aquitaine;33;4;22;514;Soulac-sur-Mer;2833;27;2860
75;Nouvelle-Aquitaine;33;3;12;515;Soulignac;419;6;425
75;Nouvelle-Aquitaine;33;3;27;516;Soussac;193;4;197
75;Nouvelle-Aquitaine;33;4;30;517;Soussans;1673;23;1696
75;Nouvelle-Aquitaine;33;2;12;518;Tabanac;1082;23;1105
75;Nouvelle-Aquitaine;33;2;28;519;Le Taillan-Médoc;10416;147;10563
75;Nouvelle-Aquitaine;33;3;27;520;Taillecavat;277;3;280
75;Nouvelle-Aquitaine;33;4;22;521;Talais;761;10;771
75;Nouvelle-Aquitaine;33;2;31;522;Talence;44359;996;45355
75;Nouvelle-Aquitaine;33;3;12;523;Targon;2043;24;2067
75;Nouvelle-Aquitaine;33;5;16;524;Tarnès;324;3;327
75;Nouvelle-Aquitaine;33;1;13;525;Tauriac;1304;24;1328
75;Nouvelle-Aquitaine;33;5;21;526;Tayac;131;1;132
75;Nouvelle-Aquitaine;33;6;14;527;Le Teich;8794;186;8980
75;Nouvelle-Aquitaine;33;4;30;528;Le Temple;642;7;649
75;Nouvelle-Aquitaine;33;6;32;529;La Teste-de-Buch;26269;379;26648
75;Nouvelle-Aquitaine;33;1;13;530;Teuillac;877;9;886
75;Nouvelle-Aquitaine;33;5;10;531;Tizac-de-Curton;356;6;362
75;Nouvelle-Aquitaine;33;5;21;532;Tizac-de-Lapouyade;471;9;480
75;Nouvelle-Aquitaine;33;3;29;533;Toulenne;2779;26;2805
75;Nouvelle-Aquitaine;33;2;12;534;Le Tourne;813;11;824
75;Nouvelle-Aquitaine;33;2;11;535;Tresses;4981;56;5037
75;Nouvelle-Aquitaine;33;3;15;536;Le Tuzan;260;4;264
75;Nouvelle-Aquitaine;33;3;29;537;Uzeste;466;10;476
75;Nouvelle-Aquitaine;33;4;22;538;Valeyrac;540;10;550
75;Nouvelle-Aquitaine;33;5;16;539;Vayres;4177;54;4231
75;Nouvelle-Aquitaine;33;4;22;540;Vendays-Montalivet;2548;35;2583
75;Nouvelle-Aquitaine;33;4;22;541;Vensac;1043;18;1061
75;Nouvelle-Aquitaine;33;5;16;542;Vérac;954;14;968
75;Nouvelle-Aquitaine;33;3;12;543;Verdelais;1031;11;1042
75;Nouvelle-Aquitaine;33;4;22;544;Le Verdon-sur-Mer;1323;12;1335
75;Nouvelle-Aquitaine;33;4;22;545;Vertheuil;1308;22;1330
75;Nouvelle-Aquitaine;33;5;10;546;Vignonet;498;12;510
75;Nouvelle-Aquitaine;33;3;29;547;Villandraut;1125;25;1150
75;Nouvelle-Aquitaine;33;5;16;548;Villegouge;1287;25;1312
75;Nouvelle-Aquitaine;33;3;12;549;Villenave-de-Rions;363;6;369
75;Nouvelle-Aquitaine;33;2;33;550;Villenave-d'Ornon;38444;252;38696
75;Nouvelle-Aquitaine;33;1;13;551;Villeneuve;403;6;409
75;Nouvelle-Aquitaine;33;3;15;552;Virelade;1101;14;1115
75;Nouvelle-Aquitaine;33;1;20;553;Virsac;1262;6;1268
75;Nouvelle-Aquitaine;33;2;17;554;Yvrac;2860;34;2894
75;Nouvelle-Aquitaine;33;6;14;555;Marcheprime;5123;83;5206
76;Occitanie;34;1;21;001;Abeilhan;1805;24;1829
76;Occitanie;34;1;14;002;Adissan;1303;26;1329
76;Occitanie;34;1;01;003;Agde;29201;388;29589
76;Occitanie;34;1;24;004;Agel;244;4;248
76;Occitanie;34;2;11;005;Agonès;295;9;304
76;Occitanie;34;1;24;006;Aigne;272;7;279
76;Occitanie;34;1;24;007;Aigues-Vives;468;5;473
76;Occitanie;34;1;06;008;Les Aires;610;11;621
76;Occitanie;34;1;21;009;Alignan-du-Vent;1764;26;1790
76;Occitanie;34;2;09;010;Aniane;2939;38;2977
76;Occitanie;34;2;09;011;Arboras;108;4;112
76;Occitanie;34;2;09;012;Argelliers;970;25;995
76;Occitanie;34;2;06;013;Aspiran;1670;24;1694
76;Occitanie;34;2;23;014;Assas;1483;43;1526
76;Occitanie;34;1;24;015;Assignan;157;3;160
76;Occitanie;34;2;09;016;Aumelas;552;19;571
76;Occitanie;34;1;14;017;Aumes;499;16;515
76;Occitanie;34;1;05;018;Autignac;922;15;937
76;Occitanie;34;1;06;019;Avène;282;9;291
76;Occitanie;34;1;24;020;Azillanet;358;12;370
76;Occitanie;34;1;24;021;Babeau-Bouldoux;301;6;307
76;Occitanie;34;3;07;022;Baillargues;7600;102;7702
76;Occitanie;34;3;08;023;Balaruc-les-Bains;7115;92;7207
76;Occitanie;34;3;08;024;Balaruc-le-Vieux;2689;42;2731
76;Occitanie;34;1;04;025;Bassan;2221;31;2252
76;Occitanie;34;1;24;026;Beaufort;220;2;222
76;Occitanie;34;3;07;027;Beaulieu;2176;49;2225
76;Occitanie;34;1;06;028;Bédarieux;5736;216;5952
76;Occitanie;34;2;09;029;Bélarga;675;7;682
76;Occitanie;34;1;24;030;Berlou;215;0;215
76;Occitanie;34;1;01;031;Bessan;5365;80;5445
76;Occitanie;34;1;98;032;Béziers;78683;1190;79873
76;Occitanie;34;3;12;033;Boisseron;2113;43;2156
76;Occitanie;34;1;24;034;Boisset;39;1;40
76;Occitanie;34;2;09;035;La Boissière;1038;19;1057
76;Occitanie;34;2;11;036;Le Bosc;1371;24;1395
76;Occitanie;34;1;04;037;Boujan-sur-Libron;3369;57;3426
76;Occitanie;34;1;06;038;Le Bousquet-d'Orb;1584;24;1608
76;Occitanie;34;3;14;039;Bouzigues;1633;22;1655
76;Occitanie;34;1;06;040;Brenas;55;0;55
76;Occitanie;34;2;06;041;Brignac;961;17;978
76;Occitanie;34;2;11;042;Brissac;601;14;615
76;Occitanie;34;2;23;043;Buzignargues;363;5;368
76;Occitanie;34;1;05;044;Cabrerolles;339;10;349
76;Occitanie;34;2;14;045;Cabrières;549;18;567
76;Occitanie;34;1;24;046;Cambon-et-Salvergues;50;0;50
76;Occitanie;34;2;09;047;Campagnan;714;10;724
76;Occitanie;34;3;12;048;Campagne;303;5;308
76;Occitanie;34;1;06;049;Camplong;227;6;233
76;Occitanie;34;3;13;050;Candillargues;2003;26;2029
76;Occitanie;34;2;06;051;Canet;3540;74;3614
76;Occitanie;34;1;24;052;Capestang;3298;58;3356
76;Occitanie;34;1;06;053;Carlencas-et-Levas;126;0;126
76;Occitanie;34;1;24;054;Cassagnoles;110;1;111
76;Occitanie;34;1;24;055;Castanet-le-Haut;218;3;221
76;Occitanie;34;1;21;056;Castelnau-de-Guers;1231;14;1245
76;Occitanie;34;3;20;057;Castelnau-le-Lez;23469;406;23875
76;Occitanie;34;3;07;058;Castries;6423;106;6529
76;Occitanie;34;1;24;059;La Caunette;317;6;323
76;Occitanie;34;2;11;060;Causse-de-la-Selle;416;7;423
76;Occitanie;34;1;05;061;Causses-et-Veyran;627;10;637
76;Occitanie;34;1;05;062;Caussiniojouls;156;1;157
76;Occitanie;34;1;21;063;Caux;2589;35;2624
76;Occitanie;34;2;11;064;Le Caylar;465;15;480
76;Occitanie;34;1;24;065;Cazedarnes;619;11;630
76;Occitanie;34;2;23;066;Cazevieille;230;3;233
76;Occitanie;34;2;11;067;Cazilhac;1554;40;1594
76;Occitanie;34;1;14;068;Cazouls-d'Hérault;409;9;418
76;Occitanie;34;1;05;069;Cazouls-lès-Béziers;5124;96;5220
76;Occitanie;34;1;24;070;Cébazan;632;12;644
76;Occitanie;34;1;06;071;Ceilhes-et-Rocozels;302;6;308
76;Occitanie;34;2;11;072;Celles;30;1;31
76;Occitanie;34;1;04;073;Cers;2557;50;2607
76;Occitanie;34;1;24;074;Cessenon-sur-Orb;2358;50;2408
76;Occitanie;34;1;24;075;Cesseras;420;8;428
76;Occitanie;34;2;06;076;Ceyras;1378;26;1404
76;Occitanie;34;3;20;077;Clapiers;5613;88;5701
76;Occitanie;34;2;11;078;Claret;1692;38;1730
76;Occitanie;34;2;06;079;Clermont-l'Hérault;9126;159;9285
76;Occitanie;34;1;24;080;Colombières-sur-Orb;480;14;494
76;Occitanie;34;1;05;081;Colombiers;2680;44;2724
76;Occitanie;34;2;23;082;Combaillaux;1869;44;1913
76;Occitanie;34;1;06;083;Combes;322;3;325
76;Occitanie;34;1;03;084;Corneilhan;1694;28;1722
76;Occitanie;34;1;21;085;Coulobres;359;9;368
76;Occitanie;34;1;24;086;Courniou;619;13;632
76;Occitanie;34;3;22;087;Cournonsec;3517;32;3549
76;Occitanie;34;3;22;088;Cournonterral;6490;78;6568
76;Occitanie;34;1;24;089;Creissan;1345;27;1372
76;Occitanie;34;3;07;090;Le Crès;9305;135;9440
76;Occitanie;34;2;11;091;Le Cros;56;0;56
76;Occitanie;34;1;24;092;Cruzy;960;15;975
76;Occitanie;34;1;06;093;Dio-et-Valquières;147;3;150
76;Occitanie;34;1;04;094;Espondeilhan;1147;24;1171
76;Occitanie;34;3;22;095;Fabrègues;7194;83;7277
76;Occitanie;34;1;05;096;Faugères;550;8;558
76;Occitanie;34;1;24;097;Félines-Minervois;484;8;492
76;Occitanie;34;1;24;098;Ferrals-les-Montagnes;151;5;156
76;Occitanie;34;2;11;099;Ferrières-les-Verreries;47;1;48
76;Occitanie;34;1;24;100;Ferrières-Poussarou;52;4;56
76;Occitanie;34;1;21;101;Florensac;5035;81;5116
76;Occitanie;34;2;11;102;Fontanès;350;9;359
76;Occitanie;34;2;14;103;Fontès;1052;19;1071
76;Occitanie;34;1;05;104;Fos;128;1;129
76;Occitanie;34;1;05;105;Fouzilhon;251;7;258
76;Occitanie;34;2;11;106;Fozières;186;9;195
76;Occitanie;34;1;24;107;Fraisse-sur-Agout;338;3;341
76;Occitanie;34;3;08;108;Frontignan;23485;220;23705
76;Occitanie;34;1;05;109;Gabian;845;18;863
76;Occitanie;34;3;12;110;Galargues;743;27;770
76;Occitanie;34;2;11;111;Ganges;4114;102;4216
76;Occitanie;34;3;12;112;Garrigues;222;5;227
76;Occitanie;34;3;08;113;Gigean;6563;79;6642
76;Occitanie;34;2;09;114;Gignac;6609;116;6725
76;Occitanie;34;2;11;115;Gorniès;113;0;113
76;Occitanie;34;3;15;116;Grabels;8885;96;8981
76;Occitanie;34;1;06;117;Graissessac;585;10;595
76;Occitanie;34;2;23;118;Guzargues;498;12;510
76;Occitanie;34;1;06;119;Hérépian;1526;25;1551
76;Occitanie;34;3;20;120;Jacou;6794;102;6896
76;Occitanie;34;1;06;121;Joncels;271;14;285
76;Occitanie;34;2;09;122;Jonquières;554;7;561
76;Occitanie;34;3;10;123;Juvignac;12104;99;12203
76;Occitanie;34;2;06;124;Lacoste;306;10;316
76;Occitanie;34;2;09;125;Lagamas;111;4;115
76;Occitanie;34;1;06;126;Lamalou-les-Bains;2483;18;2501
76;Occitanie;34;3;13;127;Lansargues;3096;43;3139
76;Occitanie;34;2;11;128;Laroque;1640;32;1672
76;Occitanie;34;3;10;129;Lattes;17674;235;17909
76;Occitanie;34;1;05;130;Laurens;1776;29;1805
76;Occitanie;34;2;11;131;Lauret;632;20;652
76;Occitanie;34;2;11;132;Lauroux;204;2;206
76;Occitanie;34;2;11;133;Lavalette;54;0;54
76;Occitanie;34;3;10;134;Lavérune;3330;52;3382
76;Occitanie;34;1;02;135;Lespignan;3318;53;3371
76;Occitanie;34;1;14;136;Lézignan-la-Cèbe;1567;27;1594
76;Occitanie;34;2;06;137;Liausson;149;7;156
76;Occitanie;34;2;14;138;Lieuran-Cabrières;335;7;342
76;Occitanie;34;1;04;139;Lieuran-lès-Béziers;1380;39;1419
76;Occitanie;34;1;03;140;Lignan-sur-Orb;3221;54;3275
76;Occitanie;34;1;24;141;La Livinière;521;8;529
76;Occitanie;34;2;11;142;Lodève;7382;236;7618
76;Occitanie;34;3;14;143;Loupian;2206;39;2245
76;Occitanie;34;1;06;144;Lunas;668;21;689
76;Occitanie;34;3;12;145;Lunel;26356;270;26626
76;Occitanie;34;3;12;146;Lunel-Viel;4484;46;4530
76;Occitanie;34;1;05;147;Magalas;3424;66;3490
76;Occitanie;34;1;05;148;Maraussan;4650;77;4727
76;Occitanie;34;1;05;149;Margon;724;2;726
76;Occitanie;34;3;01;150;Marseillan;7692;105;7797
76;Occitanie;34;3;12;151;Marsillargues;6395;77;6472
76;Occitanie;34;2;11;152;Mas-de-Londres;672;10;682
76;Occitanie;34;2;23;153;Les Matelles;2026;50;2076
76;Occitanie;34;3;13;154;Mauguio;16714;198;16912
76;Occitanie;34;1;05;155;Maureilhan;2342;47;2389
76;Occitanie;34;2;06;156;Mérifons;47;3;50
76;Occitanie;34;3;14;157;Mèze;12385;164;12549
76;Occitanie;34;1;24;158;Minerve;101;1;102
76;Occitanie;34;3;08;159;Mireval;3304;51;3355
76;Occitanie;34;1;24;160;Mons;650;17;667
76;Occitanie;34;1;05;161;Montady;3990;73;4063
76;Occitanie;34;1;14;162;Montagnac;4318;60;4378
76;Occitanie;34;2;09;163;Montarnaud;4145;49;4194
76;Occitanie;34;3;07;164;Montaud;1039;12;1051
76;Occitanie;34;3;14;165;Montbazin;2933;59;2992
76;Occitanie;34;1;21;166;Montblanc;2868;51;2919
76;Occitanie;34;1;24;167;Montels;249;4;253
76;Occitanie;34;1;05;168;Montesquieu;75;0;75
76;Occitanie;34;3;20;169;Montferrier-sur-Lez;4014;164;4178
76;Occitanie;34;1;24;170;Montouliers;211;5;216
76;Occitanie;34;2;11;171;Montoulieu;173;4;177
76;Occitanie;34;3;99;172;Montpellier;299096;3329;302425
76;Occitanie;34;2;09;173;Montpeyroux;1374;24;1398
76;Occitanie;34;2;11;174;Moulès-et-Baucels;861;26;887
76;Occitanie;34;2;06;175;Mourèze;215;5;220
76;Occitanie;34;3;13;176;Mudaison;2825;31;2856
76;Occitanie;34;2;23;177;Murles;343;11;354
76;Occitanie;34;1;05;178;Murviel-lès-Béziers;3112;55;3167
76;Occitanie;34;3;22;179;Murviel-lès-Montpellier;1856;29;1885
76;Occitanie;34;2;06;180;Nébian;1451;24;1475
76;Occitanie;34;1;05;181;Neffiès;1030;25;1055
76;Occitanie;34;1;21;182;Nézignan-l'Évêque;1795;33;1828
76;Occitanie;34;1;02;183;Nissan-lez-Enserune;4020;74;4094
76;Occitanie;34;1;14;184;Nizas;669;15;684
76;Occitanie;34;2;11;185;Notre-Dame-de-Londres;522;12;534
76;Occitanie;34;2;06;186;Octon;520;12;532
76;Occitanie;34;1;24;187;Olargues;608;10;618
76;Occitanie;34;2;11;188;Olmet-et-Villecun;187;4;191
76;Occitanie;34;1;24;189;Olonzac;1684;19;1703
76;Occitanie;34;1;24;190;Oupia;250;7;257
76;Occitanie;34;1;05;191;Pailhès;571;12;583
76;Occitanie;34;3;13;192;Palavas-les-Flots;5748;37;5785
76;Occitanie;34;1;24;193;Pardailhan;174;6;180
76;Occitanie;34;2;06;194;Paulhan;4024;52;4076
76;Occitanie;34;2;11;195;Pégairolles-de-Buèges;56;1;57
76;Occitanie;34;2;11;196;Pégairolles-de-l'Escalette;156;4;160
76;Occitanie;34;2;14;197;Péret;1070;16;1086
76;Occitanie;34;3;10;198;Pérols;9438;124;9562
76;Occitanie;34;1;21;199;Pézenas;7857;253;8110
76;Occitanie;34;1;06;200;Pézènes-les-Mines;234;10;244
76;Occitanie;34;1;24;201;Pierrerue;292;7;299
76;Occitanie;34;3;22;202;Pignan;8218;115;8333
76;Occitanie;34;1;21;203;Pinet;1987;24;2011
76;Occitanie;34;2;09;204;Plaissan;1482;19;1501
76;Occitanie;34;2;11;205;Les Plans;293;7;300
76;Occitanie;34;1;24;206;Poilhes;537;11;548
76;Occitanie;34;1;21;207;Pomérols;2151;43;2194
76;Occitanie;34;2;09;208;Popian;356;15;371
76;Occitanie;34;1;01;209;Portiragnes;3090;64;3154
76;Occitanie;34;2;09;210;Le Pouget;2096;47;2143
76;Occitanie;34;1;06;211;Le Poujol-sur-Orb;970;33;1003
76;Occitanie;34;2;11;212;Poujols;181;5;186
76;Occitanie;34;3;14;213;Poussan;6008;79;6087
76;Occitanie;34;1;05;214;Pouzolles;1173;18;1191
76;Occitanie;34;2;09;215;Pouzols;958;13;971
76;Occitanie;34;1;06;216;Le Pradal;331;5;336
76;Occitanie;34;3;23;217;Prades-le-Lez;6007;104;6111
76;Occitanie;34;1;24;218;Prades-sur-Vernazobre;328;6;334
76;Occitanie;34;1;24;219;Prémian;499;9;508
76;Occitanie;34;2;11;220;Le Puech;255;5;260
76;Occitanie;34;2;09;221;Puéchabon;506;11;517
76;Occitanie;34;2;09;222;Puilacher;635;13;648
76;Occitanie;34;1;05;223;Puimisson;1174;19;1193
76;Occitanie;34;1;21;224;Puissalicon;1349;19;1368
76;Occitanie;34;1;24;225;Puisserguier;3026;47;3073
76;Occitanie;34;1;24;226;Quarante;1804;26;1830
76;Occitanie;34;3;07;227;Restinclières;2183;30;2213
76;Occitanie;34;1;24;228;Rieussec;82;5;87
76;Occitanie;34;1;24;229;Riols;725;25;750
76;Occitanie;34;2;11;230;Les Rives;147;4;151
76;Occitanie;34;2;11;231;Romiguières;21;2;23
76;Occitanie;34;1;24;232;Roquebrun;606;11;617
76;Occitanie;34;2;11;233;Roqueredonde;210;3;213
76;Occitanie;34;1;05;234;Roquessels;94;1;95
76;Occitanie;34;1;24;235;Rosis;269;6;275
76;Occitanie;34;2;11;236;Rouet;68;0;68
76;Occitanie;34;1;05;237;Roujan;2223;40;2263
76;Occitanie;34;2;11;238;Saint-André-de-Buèges;40;0;40
76;Occitanie;34;2;09;239;Saint-André-de-Sangonis;6334;107;6441
76;Occitanie;34;3;13;240;Saint-Aunès;4026;35;4061
76;Occitanie;34;2;09;241;Saint-Bauzille-de-la-Sylve;903;14;917
76;Occitanie;34;2;23;242;Saint-Bauzille-de-Montmel;1147;27;1174
76;Occitanie;34;2;11;243;Saint-Bauzille-de-Putois;2014;31;2045
76;Occitanie;34;3;07;244;Saint-Brès;3293;41;3334
76;Occitanie;34;1;24;245;Saint-Chinian;1704;34;1738
76;Occitanie;34;3;12;246;Entre-Vignes;2133;37;2170
76;Occitanie;34;2;23;247;Saint-Clément-de-Rivière;5048;246;5294
76;Occitanie;34;2;23;248;Sainte-Croix-de-Quintillargues;950;17;967
76;Occitanie;34;3;07;249;Saint-Drézéry;2839;62;2901
76;Occitanie;34;1;24;250;Saint-Étienne-d'Albagnan;299;7;306
76;Occitanie;34;2;11;251;Saint-Étienne-de-Gourgas;523;14;537
76;Occitanie;34;1;06;252;Saint-Étienne-Estréchoux;254;6;260
76;Occitanie;34;2;11;253;Saint-Félix-de-l'Héras;33;1;34
76;Occitanie;34;2;06;254;Saint-Félix-de-Lodez;1156;31;1187
76;Occitanie;34;2;23;255;Saint-Gély-du-Fesc;10397;273;10670
76;Occitanie;34;3;07;256;Saint-Geniès-des-Mourgues;2041;34;2075
76;Occitanie;34;1;06;257;Saint-Geniès-de-Varensal;216;2;218
76;Occitanie;34;1;05;258;Saint-Geniès-de-Fontedit;1676;28;1704
76;Occitanie;34;3;22;259;Saint-Georges-d'Orques;5628;69;5697
76;Occitanie;34;1;06;260;Saint-Gervais-sur-Mare;849;13;862
76;Occitanie;34;2;09;261;Saint-Guilhem-le-Désert;243;8;251
76;Occitanie;34;2;09;262;Saint-Guiraud;259;0;259
76;Occitanie;34;2;23;263;Saint-Hilaire-de-Beauvoir;439;3;442
76;Occitanie;34;2;11;264;Saint-Jean-de-Buèges;208;0;208
76;Occitanie;34;2;23;265;Saint-Jean-de-Cornies;780;15;795
76;Occitanie;34;2;23;266;Saint-Jean-de-Cuculles;514;7;521
76;Occitanie;34;2;09;267;Saint-Jean-de-Fos;1742;34;1776
76;Occitanie;34;2;11;268;Saint-Jean-de-la-Blaquière;654;18;672
76;Occitanie;34;1;24;269;Saint-Jean-de-Minervois;141;3;144
76;Occitanie;34;3;10;270;Saint-Jean-de-Védas;11843;141;11984
76;Occitanie;34;1;24;271;Saint-Julien;216;3;219
76;Occitanie;34;3;12;272;Saint-Just;3290;30;3320
76;Occitanie;34;1;24;273;Saint-Martin-de-l'Arçon;129;0;129
76;Occitanie;34;2;11;274;Saint-Martin-de-Londres;2791;26;2817
76;Occitanie;34;2;23;276;Saint-Mathieu-de-Tréviers;4893;96;4989
76;Occitanie;34;2;11;277;Saint-Maurice-Navacelles;184;6;190
76;Occitanie;34;2;11;278;Saint-Michel;57;0;57
76;Occitanie;34;1;05;279;Saint-Nazaire-de-Ladarez;322;3;325
76;Occitanie;34;3;12;280;Saint-Nazaire-de-Pézan;610;8;618
76;Occitanie;34;2;09;281;Saint-Pargoire;2356;37;2393
76;Occitanie;34;2;09;282;Saint-Paul-et-Valmalle;1310;20;1330
76;Occitanie;34;2;11;283;Saint-Pierre-de-la-Fage;131;2;133
76;Occitanie;34;1;24;284;Saint-Pons-de-Thomières;1749;190;1939
76;Occitanie;34;1;14;285;Saint-Pons-de-Mauchiens;638;11;649
76;Occitanie;34;2;11;286;Saint-Privat;418;14;432
76;Occitanie;34;2;09;287;Saint-Saturnin-de-Lucian;262;6;268
76;Occitanie;34;3;12;288;Saint-Sériès;973;22;995
76;Occitanie;34;1;21;289;Saint-Thibéry;2875;38;2913
76;Occitanie;34;2;23;290;Saint-Vincent-de-Barbeyrargues;742;11;753
76;Occitanie;34;1;24;291;Saint-Vincent-d'Olargues;358;5;363
76;Occitanie;34;2;06;292;Salasc;310;6;316
76;Occitanie;34;1;24;293;La Salvetat-sur-Agout;1128;20;1148
76;Occitanie;34;3;12;294;Saturargues;1022;20;1042
76;Occitanie;34;3;22;295;Saussan;1640;33;1673
76;Occitanie;34;3;12;296;Saussines;989;22;1011
76;Occitanie;34;2;11;297;Sauteyrargues;428;8;436
76;Occitanie;34;1;04;298;Sauvian;5483;97;5580
76;Occitanie;34;1;02;299;Sérignan;7809;176;7985
76;Occitanie;34;1;04;300;Servian;5301;94;5395
76;Occitanie;34;3;25;301;Sète;44576;599;45175
76;Occitanie;34;1;24;302;Siran;748;6;754
76;Occitanie;34;2;11;303;Sorbs;39;1;40
76;Occitanie;34;2;11;304;Soubès;932;29;961
76;Occitanie;34;1;24;305;Le Soulié;124;0;124
76;Occitanie;34;2;11;306;Soumont;200;0;200
76;Occitanie;34;3;07;307;Sussargues;2818;57;2875
76;Occitanie;34;1;06;308;Taussac-la-Billière;455;13;468
76;Occitanie;34;2;23;309;Teyran;4640;81;4721
76;Occitanie;34;1;05;310;Thézan-lès-Béziers;3040;76;3116
76;Occitanie;34;1;21;311;Tourbes;1782;158;1940
76;Occitanie;34;1;06;312;La Tour-sur-Orb;1301;24;1325
76;Occitanie;34;2;09;313;Tressan;685;24;709
76;Occitanie;34;2;23;314;Le Triadou;633;14;647
76;Occitanie;34;2;14;315;Usclas-d'Hérault;437;5;442
76;Occitanie;34;2;11;316;Usclas-du-Bosc;236;2;238
76;Occitanie;34;2;11;317;La Vacquerie-et-Saint-Martin-de-Castries;187;7;194
76;Occitanie;34;2;11;318;Vacquières;735;12;747
76;Occitanie;34;1;05;319;Vailhan;148;1;149
76;Occitanie;34;2;23;320;Vailhauquès;2609;54;2663
76;Occitanie;34;3;13;321;Valergues;2049;27;2076
76;Occitanie;34;2;11;322;Valflaunès;775;14;789
76;Occitanie;34;2;06;323;Valmascle;46;0;46
76;Occitanie;34;1;02;324;Valras-Plage;4188;63;4251
76;Occitanie;34;1;21;325;Valros;1643;32;1675
76;Occitanie;34;1;24;326;Vélieux;93;0;93
76;Occitanie;34;3;07;327;Vendargues;6771;86;6857
76;Occitanie;34;2;09;328;Vendémian;1154;25;1179
76;Occitanie;34;1;02;329;Vendres;2728;78;2806
76;Occitanie;34;1;24;331;Verreries-de-Moussans;95;2;97
76;Occitanie;34;1;01;332;Vias;5804;77;5881
76;Occitanie;34;3;08;333;Vic-la-Gardiole;3429;30;3459
76;Occitanie;34;1;24;334;Vieussan;270;0;270
76;Occitanie;34;1;06;335;Villemagne-l'Argentière;424;13;437
76;Occitanie;34;1;04;336;Villeneuve-lès-Béziers;4099;54;4153
76;Occitanie;34;3;22;337;Villeneuve-lès-Maguelone;10463;119;10582
76;Occitanie;34;2;06;338;Villeneuvette;68;3;71
76;Occitanie;34;1;24;339;Villespassans;178;5;183
76;Occitanie;34;3;12;340;Villetelle;1558;46;1604
76;Occitanie;34;3;14;341;Villeveyrac;3909;69;3978
76;Occitanie;34;2;11;342;Viols-en-Laval;212;4;216
76;Occitanie;34;2;11;343;Viols-le-Fort;1242;29;1271
76;Occitanie;34;3;13;344;La Grande-Motte;8638;83;8721
53;Bretagne;35;3;13;001;Acigné;6865;164;7029
53;Bretagne;35;1;12;002;Amanlis;1759;35;1794
53;Bretagne;35;3;01;003;Andouillé-Neuville;976;8;984
53;Bretagne;35;1;01;004;Val-Couesnon;4119;87;4206
53;Bretagne;35;1;10;005;Arbrissel;299;6;305
53;Bretagne;35;1;10;006;Argentré-du-Plessis;4533;129;4662
53;Bretagne;35;3;01;007;Aubigné;489;2;491
53;Bretagne;35;1;10;008;Availles-sur-Seiche;671;18;689
53;Bretagne;35;4;07;009;Baguer-Morvan;1702;26;1728
53;Bretagne;35;4;07;010;Baguer-Pican;1779;16;1795
53;Bretagne;35;2;02;012;Bain-de-Bretagne;7435;148;7583
53;Bretagne;35;2;17;013;Bains-sur-Oust;3500;162;3662
53;Bretagne;35;1;10;014;Bais;2466;32;2498
53;Bretagne;35;1;27;015;Balazé;2224;48;2272
53;Bretagne;35;2;11;016;Baulon;2191;60;2251
53;Bretagne;35;4;06;017;La Baussaine;675;9;684
53;Bretagne;35;1;09;018;La Bazouge-du-Désert;1067;21;1088
53;Bretagne;35;1;01;019;Bazouges-la-Pérouse;1860;32;1892
53;Bretagne;35;1;09;021;Beaucé;1355;35;1390
53;Bretagne;35;3;15;022;Bécherel;698;16;714
53;Bretagne;35;3;16;023;Bédée;4460;73;4533
53;Bretagne;35;3;03;024;Betton;12637;298;12935
53;Bretagne;35;1;08;025;Billé;1057;16;1073
53;Bretagne;35;3;15;026;Bléruais;101;6;107
53;Bretagne;35;3;15;027;Boisgervilly;1734;35;1769
53;Bretagne;35;1;05;028;Boistrudan;722;14;736
53;Bretagne;35;4;06;029;Bonnemain;1526;25;1551
53;Bretagne;35;2;02;030;La Bosse-de-Bretagne;690;17;707
53;Bretagne;35;3;13;031;La Bouëxière;4546;105;4651
53;Bretagne;35;3;12;032;Bourgbarré;4579;65;4644
53;Bretagne;35;2;11;033;Bourg-des-Comptes;3327;63;3390
53;Bretagne;35;4;07;034;La Boussac;1215;22;1237
53;Bretagne;35;2;11;035;Bovel;595;10;605
53;Bretagne;35;3;24;037;Bréal-sous-Montfort;6506;83;6589
53;Bretagne;35;1;27;038;Bréal-sous-Vitré;626;21;647
53;Bretagne;35;3;13;039;Brécé;2040;43;2083
53;Bretagne;35;3;16;040;Breteil;3632;79;3711
53;Bretagne;35;1;12;041;Brie;1010;20;1030
53;Bretagne;35;1;10;042;Brielles;666;30;696
53;Bretagne;35;4;07;044;Broualan;391;5;396
53;Bretagne;35;2;17;045;Bruc-sur-Aff;862;16;878
53;Bretagne;35;2;11;046;Les Brulais;534;8;542
53;Bretagne;35;3;04;047;Bruz;19090;471;19561
53;Bretagne;35;4;25;049;Cancale;5313;92;5405
53;Bretagne;35;4;06;050;Cardroc;602;9;611
53;Bretagne;35;3;03;051;Cesson-Sévigné;17316;483;17799
53;Bretagne;35;1;27;052;Champeaux;511;11;522
53;Bretagne;35;2;02;054;Chanteloup;1847;47;1894
53;Bretagne;35;3;20;055;Chantepie;10236;175;10411
53;Bretagne;35;4;06;056;La Chapelle-aux-Filtzméens;818;22;840
53;Bretagne;35;2;11;057;La Chapelle-Bouëxic;1505;25;1530
53;Bretagne;35;3;15;058;La Chapelle-Chaussée;1302;15;1317
53;Bretagne;35;3;03;059;La Chapelle-des-Fougeretz;4628;94;4722
53;Bretagne;35;3;15;060;La Chapelle du Lou du Lac;1017;19;1036
53;Bretagne;35;1;27;061;La Chapelle-Erbrée;722;16;738
53;Bretagne;35;1;09;062;La Chapelle-Janson;1483;27;1510
53;Bretagne;35;1;08;063;La Chapelle-Saint-Aubert;455;7;462
53;Bretagne;35;2;17;064;La Chapelle-de-Brain;1023;13;1036
53;Bretagne;35;3;24;065;La Chapelle-Thouarault;2244;43;2287
53;Bretagne;35;3;04;066;Chartres-de-Bretagne;8190;137;8327
53;Bretagne;35;3;13;067;Chasné-sur-Illet;1628;28;1656
53;Bretagne;35;1;05;068;Châteaubourg;7516;157;7673
53;Bretagne;35;3;05;069;Châteaugiron;10541;267;10808
53;Bretagne;35;4;07;070;Châteauneuf-d'Ille-et-Vilaine;1704;25;1729
53;Bretagne;35;1;01;071;Le Châtellier;433;10;443
53;Bretagne;35;1;27;072;Châtillon-en-Vendelais;1664;36;1700
53;Bretagne;35;1;01;075;Chauvigné;807;23;830
53;Bretagne;35;3;24;076;Chavagne;4268;82;4350
53;Bretagne;35;1;10;077;Chelun;346;10;356
53;Bretagne;35;4;07;078;Cherrueix;1089;22;1111
53;Bretagne;35;3;03;079;Chevaigné;2355;53;2408
53;Bretagne;35;3;24;080;Cintré;2476;64;2540
53;Bretagne;35;3;14;081;Clayes;910;30;940
53;Bretagne;35;1;10;082;Coësmes;1456;35;1491
53;Bretagne;35;2;11;084;Comblessac;689;10;699
53;Bretagne;35;4;06;085;Combourg;6082;124;6206
53;Bretagne;35;1;08;086;Combourtillé;612;9;621
53;Bretagne;35;1;27;087;Cornillé;969;32;1001
53;Bretagne;35;3;12;088;Corps-Nuds;3526;55;3581
53;Bretagne;35;2;02;089;La Couyère;453;11;464
53;Bretagne;35;2;02;090;Crevin;2838;53;2891
53;Bretagne;35;3;15;091;Le Crouais;595;7;602
53;Bretagne;35;4;06;092;Cuguen;832;14;846
53;Bretagne;35;4;26;093;Dinard;10235;520;10755
53;Bretagne;35;4;06;094;Dingé;1660;28;1688
53;Bretagne;35;4;07;095;Dol-de-Bretagne;5761;349;6110
53;Bretagne;35;1;05;096;Domagné;2422;55;2477
53;Bretagne;35;1;10;097;Domalain;2020;50;2070
53;Bretagne;35;2;02;098;La Dominelais;1397;30;1427
53;Bretagne;35;3;05;099;Domloup;3756;67;3823
53;Bretagne;35;3;13;101;Dourdain;1212;22;1234
53;Bretagne;35;1;10;102;Drouges;505;10;515
53;Bretagne;35;1;10;103;Eancé;428;10;438
53;Bretagne;35;4;07;104;Epiniac;1426;27;1453
53;Bretagne;35;1;27;105;Erbrée;1734;54;1788
53;Bretagne;35;2;02;106;Ercé-en-Lamée;1532;21;1553
53;Bretagne;35;3;13;107;Ercé-près-Liffré;1965;36;2001
53;Bretagne;35;1;10;108;Essé;1050;21;1071
53;Bretagne;35;1;10;109;Étrelles;2610;67;2677
53;Bretagne;35;3;01;110;Feins;1026;20;1046
53;Bretagne;35;1;09;111;Le Ferré;722;6;728
53;Bretagne;35;1;09;112;Fleurigné;927;26;953
53;Bretagne;35;1;10;114;Forges-la-Forêt;259;6;265
53;Bretagne;35;1;97;115;Fougères;20505;616;21121
53;Bretagne;35;4;07;116;La Fresnais;2546;51;2597
53;Bretagne;35;3;15;117;Gaël;1620;22;1642
53;Bretagne;35;3;01;118;Gahard;1524;35;1559
53;Bretagne;35;1;10;119;Gennes-sur-Seiche;943;20;963
53;Bretagne;35;3;14;120;Gévezé;5685;111;5796
53;Bretagne;35;3;08;121;Gosné;2025;36;2061
53;Bretagne;35;4;25;122;La Gouesnière;1968;47;2015
53;Bretagne;35;2;11;123;Goven;4323;87;4410
53;Bretagne;35;2;02;124;Grand-Fougeray;2455;38;2493
53;Bretagne;35;1;10;125;La Guerche-de-Bretagne;4245;147;4392
53;Bretagne;35;2;11;126;Guichen;8763;205;8968
53;Bretagne;35;2;11;127;Guignen;4027;93;4120
53;Bretagne;35;3;14;128;Guipel;1714;40;1754
53;Bretagne;35;4;14;130;Hédé-Bazouges;2283;52;2335
53;Bretagne;35;3;24;131;L'Hermitage;4647;79;4726
53;Bretagne;35;4;07;132;Hirel;1391;34;1425
53;Bretagne;35;3;16;133;Iffendic;4567;100;4667
53;Bretagne;35;4;06;134;Les Iffs;273;12;285
53;Bretagne;35;3;15;135;Irodouër;2263;37;2300
53;Bretagne;35;1;12;136;Janzé;8523;164;8687
53;Bretagne;35;1;08;137;Javené;2116;71;2187
53;Bretagne;35;1;09;138;Laignelet;1190;30;1220
53;Bretagne;35;3;04;139;Laillé;5162;149;5311
53;Bretagne;35;2;02;140;Lalleu;557;8;565
53;Bretagne;35;1;27;141;Landavran;691;21;712
53;Bretagne;35;1;09;142;Landéan;1176;22;1198
53;Bretagne;35;3;15;143;Landujan;924;29;953
53;Bretagne;35;3;15;144;Langan;1064;20;1084
53;Bretagne;35;2;17;145;Langon;1372;25;1397
53;Bretagne;35;3;14;146;Langouet;610;2;612
53;Bretagne;35;4;06;148;Lanrigan;159;0;159
53;Bretagne;35;2;11;149;Lassy;1772;40;1812
53;Bretagne;35;1;08;150;Lécousse;3279;99;3378
53;Bretagne;35;2;17;151;Lieuron;787;19;806
53;Bretagne;35;3;13;152;Liffré;8129;136;8265
53;Bretagne;35;4;07;153;Lillemer;370;11;381
53;Bretagne;35;3;08;154;Livré-sur-Changeon;1723;42;1765
53;Bretagne;35;2;17;155;Lohéac;665;11;676
53;Bretagne;35;4;06;156;Longaulnay;610;10;620
53;Bretagne;35;1;09;157;Le Loroux;635;22;657
53;Bretagne;35;4;06;159;Lourmais;324;3;327
53;Bretagne;35;2;11;160;Loutehel;243;5;248
53;Bretagne;35;1;05;161;Louvigné-de-Bais;1900;39;1939
53;Bretagne;35;1;09;162;Louvigné-du-Désert;3335;62;3397
53;Bretagne;35;1;09;163;Luitré-Dompierre;1818;30;1848
53;Bretagne;35;1;01;164;Marcillé-Raoul;735;14;749
53;Bretagne;35;1;10;165;Marcillé-Robert;947;23;970
53;Bretagne;35;1;27;166;Marpiré;1022;27;1049
53;Bretagne;35;1;10;167;Martigné-Ferchaud;2604;55;2659
53;Bretagne;35;2;11;168;Val d'Anast;3943;82;4025
53;Bretagne;35;3;16;169;Maxent;1467;17;1484
53;Bretagne;35;1;27;170;Mecé;606;14;620
53;Bretagne;35;3;15;171;Médréac;1822;48;1870
53;Bretagne;35;4;06;172;Meillac;1936;23;1959
53;Bretagne;35;3;14;173;Melesse;7111;107;7218
53;Bretagne;35;1;09;174;Mellé;649;12;661
53;Bretagne;35;2;11;175;Mernel;1006;15;1021
53;Bretagne;35;2;17;176;Guipry-Messac;7181;142;7323
53;Bretagne;35;3;14;177;La Mézière;4935;120;5055
53;Bretagne;35;3;08;178;Mézières-sur-Couesnon;1778;16;1794
53;Bretagne;35;4;07;179;Miniac-Morvan;4257;83;4340
53;Bretagne;35;3;15;180;Miniac-sous-Bécherel;795;17;812
53;Bretagne;35;4;26;181;Le Minihic-sur-Rance;1488;36;1524
53;Bretagne;35;1;27;183;Mondevert;817;21;838
53;Bretagne;35;3;15;184;Montauban-de-Bretagne;6246;241;6487
53;Bretagne;35;1;27;185;Montautour;267;0;267
53;Bretagne;35;4;07;186;Mont-Dol;1082;30;1112
53;Bretagne;35;3;16;187;Monterfil;1334;45;1379
53;Bretagne;35;3;16;188;Montfort-sur-Meu;6743;174;6917
53;Bretagne;35;3;03;189;Montgermont;3564;66;3630
53;Bretagne;35;1;09;190;Monthault;248;8;256
53;Bretagne;35;1;01;191;Les Portes du Coglais;2283;46;2329
53;Bretagne;35;1;27;192;Montreuil-des-Landes;233;5;238
53;Bretagne;35;3;14;193;Montreuil-le-Gast;1983;42;2025
53;Bretagne;35;1;27;194;Montreuil-sous-Pérouse;1018;46;1064
53;Bretagne;35;3;01;195;Montreuil-sur-Ille;2419;34;2453
53;Bretagne;35;3;24;196;Mordelles;7485;127;7612
53;Bretagne;35;3;01;197;Mouazé;1761;19;1780
53;Bretagne;35;1;10;198;Moulins;713;26;739
53;Bretagne;35;1;10;199;Moussé;344;9;353
53;Bretagne;35;1;10;200;Moutiers;914;29;943
53;Bretagne;35;3;15;201;Muel;884;7;891
53;Bretagne;35;2;02;202;La Noë-Blanche;1017;20;1037
53;Bretagne;35;3;16;203;La Nouaye;353;5;358
53;Bretagne;35;3;12;204;Nouvoitou;3378;62;3440
53;Bretagne;35;1;01;205;Noyal-sous-Bazouges;376;8;384
53;Bretagne;35;3;04;206;Noyal-Châtillon-sur-Seiche;7318;135;7453
53;Bretagne;35;3;05;207;Noyal-sur-Vilaine;6131;150;6281
53;Bretagne;35;3;12;208;Orgères;5341;130;5471
53;Bretagne;35;3;23;210;Pacé;12004;354;12358
53;Bretagne;35;3;16;211;Paimpont;1784;43;1827
53;Bretagne;35;2;02;212;Pancé;1196;31;1227
53;Bretagne;35;1;08;214;Parcé;650;5;655
53;Bretagne;35;1;09;215;Parigné;1328;43;1371
53;Bretagne;35;3;14;216;Parthenay-de-Bretagne;1794;27;1821
53;Bretagne;35;1;10;217;Le Pertre;1377;28;1405
53;Bretagne;35;2;02;218;Le Petit-Fougeray;885;18;903
53;Bretagne;35;2;17;219;Pipriac;3847;76;3923
53;Bretagne;35;3;05;220;Piré-Chancé;3096;56;3152
53;Bretagne;35;2;02;221;Pléchâtel;2780;53;2833
53;Bretagne;35;4;07;222;Pleine-Fougères;1971;30;2001
53;Bretagne;35;3;16;223;Plélan-le-Grand;4030;86;4116
53;Bretagne;35;4;07;224;Plerguer;2826;54;2880
53;Bretagne;35;4;06;225;Plesder;780;15;795
53;Bretagne;35;4;06;226;Pleugueneuc;1972;38;2010
53;Bretagne;35;3;16;227;Pleumeleuc;3499;63;3562
53;Bretagne;35;4;26;228;Pleurtuit;6959;126;7085
53;Bretagne;35;1;27;229;Pocé-les-Bois;1324;53;1377
53;Bretagne;35;1;09;230;Poilley;370;4;374
53;Bretagne;35;2;02;231;Poligné;1212;32;1244
53;Bretagne;35;1;27;232;Princé;397;6;403
53;Bretagne;35;4;06;233;Québriac;1581;38;1619
53;Bretagne;35;3;15;234;Quédillac;1218;25;1243
53;Bretagne;35;1;10;235;Rannée;1073;46;1119
53;Bretagne;35;2;17;236;Redon;9315;745;10060
53;Bretagne;35;2;17;237;Renac;1040;23;1063
53;Bretagne;35;3;98;238;Rennes;222485;4169;226654
53;Bretagne;35;1;10;239;Retiers;4503;96;4599
53;Bretagne;35;3;24;240;Le Rheu;9247;235;9482
53;Bretagne;35;4;26;241;La Richardais;2476;88;2564
53;Bretagne;35;1;01;242;Rimou;347;4;351
53;Bretagne;35;1;08;243;Romagné;2446;59;2505
53;Bretagne;35;1;01;244;Romazy;257;5;262
53;Bretagne;35;3;15;245;Romillé;4085;72;4157
53;Bretagne;35;4;07;246;Roz-Landrieux;1368;29;1397
53;Bretagne;35;4;07;247;Roz-sur-Couesnon;1000;12;1012
53;Bretagne;35;4;07;248;Sains;458;8;466
53;Bretagne;35;2;02;249;Sainte-Anne-sur-Vilaine;1034;17;1051
53;Bretagne;35;3;12;250;Saint-Armel;2219;40;2259
53;Bretagne;35;3;01;251;Saint-Aubin-d'Aubigné;4085;81;4166
53;Bretagne;35;1;27;252;Saint-Aubin-des-Landes;910;34;944
53;Bretagne;35;3;08;253;Saint-Aubin-du-Cormier;4052;188;4240
53;Bretagne;35;4;07;255;Saint-Benoît-des-Ondes;972;35;1007
53;Bretagne;35;4;26;256;Saint-Briac-sur-Mer;2205;64;2269
53;Bretagne;35;1;01;257;Maen Roch;5033;93;5126
53;Bretagne;35;4;06;258;Saint-Brieuc-des-Iffs;328;9;337
53;Bretagne;35;4;07;259;Saint-Broladre;1143;20;1163
53;Bretagne;35;1;27;260;Saint-Christophe-des-Bois;560;6;566
53;Bretagne;35;1;08;261;Saint-Christophe-de-Valains;235;2;237
53;Bretagne;35;1;10;262;Sainte-Colombe;356;5;361
53;Bretagne;35;4;25;263;Saint-Coulomb;2870;82;2952
53;Bretagne;35;1;05;264;Saint-Didier;2025;45;2070
53;Bretagne;35;4;06;265;Saint-Domineuc;2553;47;2600
53;Bretagne;35;3;12;266;Saint-Erblon;3428;76;3504
53;Bretagne;35;2;17;268;Saint-Ganton;424;11;435
53;Bretagne;35;4;07;270;Saint-Georges-de-Gréhaigne;371;5;376
53;Bretagne;35;1;09;271;Saint-Georges-de-Reintembault;1487;25;1512
53;Bretagne;35;1;10;272;Saint-Germain-du-Pinel;969;22;991
53;Bretagne;35;1;01;273;Saint-Germain-en-Coglès;2071;31;2102
53;Bretagne;35;3;14;274;Saint-Germain-sur-Ille;982;17;999
53;Bretagne;35;3;14;275;Saint-Gilles;5312;88;5400
53;Bretagne;35;3;14;276;Saint-Gondran;586;10;596
53;Bretagne;35;3;16;277;Saint-Gonlay;377;6;383
53;Bretagne;35;3;03;278;Saint-Grégoire;9881;371;10252
53;Bretagne;35;4;07;279;Saint-Guinoux;1206;27;1233
53;Bretagne;35;1;01;280;Saint-Hilaire-des-Landes;1030;21;1051
53;Bretagne;35;3;22;281;Saint-Jacques-de-la-Lande;13955;149;14104
53;Bretagne;35;1;08;282;Rives-du-Couesnon;2909;50;2959
53;Bretagne;35;1;05;283;Saint-Jean-sur-Vilaine;1368;24;1392
53;Bretagne;35;4;26;284;Saint-Jouan-des-Guérets;2759;72;2831
53;Bretagne;35;2;17;285;Saint-Just;1070;21;1091
53;Bretagne;35;4;06;286;Saint-Léger-des-Prés;289;10;299
53;Bretagne;35;4;26;287;Saint-Lunaire;2500;89;2589
53;Bretagne;35;4;99;288;Saint-Malo;46995;1333;48328
53;Bretagne;35;2;17;289;Saint-Malo-de-Phily;1072;18;1090
53;Bretagne;35;3;15;290;Saint-Malon-sur-Mel;589;9;598
53;Bretagne;35;4;07;291;Saint-Marcan;436;9;445
53;Bretagne;35;1;01;292;Saint-Marc-le-Blanc;1605;43;1648
53;Bretagne;35;2;17;294;Sainte-Marie;2273;65;2338
53;Bretagne;35;3;15;295;Saint-Maugan;533;11;544
53;Bretagne;35;3;14;296;Saint-Médard-sur-Ille;1312;23;1335
53;Bretagne;35;3;15;297;Saint-Méen-le-Grand;4576;156;4732
53;Bretagne;35;4;25;299;Saint-Méloir-des-Ondes;4444;111;4555
53;Bretagne;35;1;27;300;Saint-M'Hervé;1357;40;1397
53;Bretagne;35;3;15;302;Saint-Onen-la-Chapelle;1113;25;1138
53;Bretagne;35;1;08;304;Saint-Ouen-des-Alleux;1321;29;1350
53;Bretagne;35;3;16;305;Saint-Péran;418;8;426
53;Bretagne;35;4;07;306;Saint-Père-Marc-en-Poulet;2346;164;2510
53;Bretagne;35;3;15;307;Saint-Pern;1042;19;1061
53;Bretagne;35;4;06;308;Mesnil-Roc'h;4387;76;4463
53;Bretagne;35;1;01;309;Saint-Rémy-du-Plain;815;12;827
53;Bretagne;35;1;08;310;Saint-Sauveur-des-Landes;1543;27;1570
53;Bretagne;35;2;11;311;Saint-Séglin;587;3;590
53;Bretagne;35;2;11;312;Saint-Senoux;1824;49;1873
53;Bretagne;35;4;07;314;Saint-Suliac;961;51;1012
53;Bretagne;35;3;13;315;Saint-Sulpice-la-Forêt;1440;39;1479
53;Bretagne;35;2;02;316;Saint-Sulpice-des-Landes;842;7;849
53;Bretagne;35;3;14;317;Saint-Symphorien;587;61;648
53;Bretagne;35;4;06;318;Saint-Thual;973;23;996
53;Bretagne;35;3;16;319;Saint-Thurial;2128;42;2170
53;Bretagne;35;3;15;320;Saint-Uniac;531;9;540
53;Bretagne;35;2;02;321;Saulnières;791;9;800
53;Bretagne;35;2;02;322;Le Sel-de-Bretagne;1110;30;1140
53;Bretagne;35;1;09;324;La Selle-en-Luitré;617;16;633
53;Bretagne;35;1;10;325;La Selle-Guerchaise;152;6;158
53;Bretagne;35;3;01;326;Sens-de-Bretagne;2598;45;2643
53;Bretagne;35;3;05;327;Servon-sur-Vilaine;3823;86;3909
53;Bretagne;35;2;17;328;Sixt-sur-Aff;2144;44;2188
53;Bretagne;35;4;07;329;Sougeal;537;10;547
53;Bretagne;35;1;27;330;Taillis;1008;22;1030
53;Bretagne;35;3;16;331;Talensac;2503;65;2568
53;Bretagne;35;2;02;332;Teillay;1075;10;1085
53;Bretagne;35;1;10;333;Le Theil-de-Bretagne;1718;33;1751
53;Bretagne;35;3;13;334;Thorigné-Fouillard;8584;212;8796
53;Bretagne;35;1;10;335;Thourie;854;23;877
53;Bretagne;35;1;01;336;Le Tiercent;186;4;190
53;Bretagne;35;4;06;337;Tinténiac;3774;193;3967
53;Bretagne;35;1;10;338;Torcé;1241;29;1270
53;Bretagne;35;4;07;339;Trans-la-Forêt;606;11;617
53;Bretagne;35;3;16;340;Treffendel;1314;29;1343
53;Bretagne;35;4;06;342;Trémeheuc;346;12;358
53;Bretagne;35;2;02;343;Tresbœuf;1238;19;1257
53;Bretagne;35;4;06;345;Trévérien;903;13;916
53;Bretagne;35;4;06;346;Trimer;206;4;210
53;Bretagne;35;1;27;347;Val-d'Izé;2576;57;2633
53;Bretagne;35;1;10;350;Vergéal;805;18;823
53;Bretagne;35;3;24;351;Le Verger;1435;24;1459
53;Bretagne;35;3;12;352;Vern-sur-Seiche;8289;153;8442
53;Bretagne;35;3;24;353;Vezin-le-Coquet;6234;73;6307
53;Bretagne;35;4;07;354;Vieux-Viel;320;2;322
53;Bretagne;35;3;01;355;Vieux-Vy-sur-Couesnon;1267;9;1276
53;Bretagne;35;3;14;356;Vignoc;2115;34;2149
53;Bretagne;35;1;09;357;Villamée;300;6;306
53;Bretagne;35;4;07;358;La Ville-ès-Nonais;1221;31;1252
53;Bretagne;35;1;10;359;Visseiche;841;17;858
53;Bretagne;35;1;27;360;Vitré;18603;568;19171
53;Bretagne;35;4;07;361;Le Vivier-sur-Mer;1063;8;1071
53;Bretagne;35;4;07;362;Le Tronchet;1193;10;1203
53;Bretagne;35;3;04;363;Pont-Péan;4389;106;4495
24;Centre-Val de Loire;36;3;11;001;Aigurande;1390;22;1412
24;Centre-Val de Loire;36;4;10;002;Aize;116;2;118
24;Centre-Val de Loire;36;4;01;003;Ambrault;890;19;909
24;Centre-Val de Loire;36;4;13;004;Anjouin;318;9;327
24;Centre-Val de Loire;36;2;01;005;Ardentes;3825;80;3905
24;Centre-Val de Loire;36;2;02;006;Argenton-sur-Creuse;4865;212;5077
24;Centre-Val de Loire;36;2;04;007;Argy;604;9;613
24;Centre-Val de Loire;36;2;04;008;Arpheuilles;228;6;234
24;Centre-Val de Loire;36;2;01;009;Arthon;1221;42;1263
24;Centre-Val de Loire;36;1;03;010;Azay-le-Ferron;870;19;889
24;Centre-Val de Loire;36;4;13;011;Bagneux;174;2;176
24;Centre-Val de Loire;36;2;02;012;Baraize;366;0;366
24;Centre-Val de Loire;36;2;10;013;Baudres;419;8;427
24;Centre-Val de Loire;36;2;02;014;Bazaiges;198;6;204
24;Centre-Val de Loire;36;1;12;015;Beaulieu;53;1;54
24;Centre-Val de Loire;36;1;12;016;Bélâbre;934;19;953
24;Centre-Val de Loire;36;3;08;017;La Berthenoux;367;6;373
24;Centre-Val de Loire;36;1;03;018;Le Blanc;6229;220;6449
24;Centre-Val de Loire;36;4;08;019;Bommiers;312;5;317
24;Centre-Val de Loire;36;1;12;020;Bonneuil;74;0;74
24;Centre-Val de Loire;36;4;09;021;Les Bordes;888;20;908
24;Centre-Val de Loire;36;2;02;022;Bouesse;396;8;404
24;Centre-Val de Loire;36;2;10;023;Bouges-le-Château;261;5;266
24;Centre-Val de Loire;36;2;10;024;Bretagne;127;1;128
24;Centre-Val de Loire;36;3;08;025;Briantes;611;11;622
24;Centre-Val de Loire;36;2;10;026;Brion;604;10;614
24;Centre-Val de Loire;36;4;08;027;Brives;245;6;251
24;Centre-Val de Loire;36;3;11;028;La Buxerette;117;3;120
24;Centre-Val de Loire;36;4;10;029;Buxeuil;234;3;237
24;Centre-Val de Loire;36;3;11;030;Buxières-d'Aillac;242;2;244
24;Centre-Val de Loire;36;2;04;031;Buzançais;4507;72;4579
24;Centre-Val de Loire;36;2;02;032;Ceaulmont;707;18;725
24;Centre-Val de Loire;36;2;02;033;Celon;394;4;398
24;Centre-Val de Loire;36;4;13;034;Chabris;2762;44;2806
24;Centre-Val de Loire;36;1;12;035;Chaillac;1068;16;1084
24;Centre-Val de Loire;36;1;12;036;Chalais;153;1;154
24;Centre-Val de Loire;36;4;10;037;La Champenoise;291;6;297
24;Centre-Val de Loire;36;3;08;038;Champillet;133;2;135
24;Centre-Val de Loire;36;2;04;040;La Chapelle-Orthemale;98;0;98
24;Centre-Val de Loire;36;4;10;041;La Chapelle-Saint-Laurian;136;1;137
24;Centre-Val de Loire;36;2;02;042;Chasseneuil;701;10;711
24;Centre-Val de Loire;36;3;11;043;Chassignolles;561;16;577
24;Centre-Val de Loire;36;2;99;044;Châteauroux;43331;1559;44890
24;Centre-Val de Loire;36;2;04;045;Châtillon-sur-Indre;2326;33;2359
24;Centre-Val de Loire;36;3;08;046;La Châtre;4048;117;4165
24;Centre-Val de Loire;36;1;12;047;La Châtre-Langlin;501;8;509
24;Centre-Val de Loire;36;2;02;048;Chavin;269;9;278
24;Centre-Val de Loire;36;1;12;049;Chazelet;124;2;126
24;Centre-Val de Loire;36;2;04;050;Chezelles;448;10;458
24;Centre-Val de Loire;36;1;12;051;Chitray;181;2;183
24;Centre-Val de Loire;36;4;09;052;Chouday;155;2;157
24;Centre-Val de Loire;36;1;03;053;Ciron;528;12;540
24;Centre-Val de Loire;36;2;04;054;Cléré-du-Bois;233;8;241
24;Centre-Val de Loire;36;2;04;055;Clion;996;18;1014
24;Centre-Val de Loire;36;3;11;056;Cluis;981;17;998
24;Centre-Val de Loire;36;2;10;057;Coings;878;24;902
24;Centre-Val de Loire;36;1;03;058;Concremiers;628;16;644
24;Centre-Val de Loire;36;4;08;059;Condé;230;7;237
24;Centre-Val de Loire;36;3;11;060;Crevant;704;16;720
24;Centre-Val de Loire;36;3;11;061;Crozon-sur-Vauvre;330;9;339
24;Centre-Val de Loire;36;2;02;062;Cuzion;452;8;460
24;Centre-Val de Loire;36;2;05;063;Déols;7659;149;7808
24;Centre-Val de Loire;36;2;01;064;Diors;749;17;766
24;Centre-Val de Loire;36;4;10;065;Diou;260;5;265
24;Centre-Val de Loire;36;1;03;066;Douadic;452;13;465
24;Centre-Val de Loire;36;1;12;067;Dunet;103;3;106
24;Centre-Val de Loire;36;4;13;068;Dun-le-Poëlier;422;7;429
24;Centre-Val de Loire;36;2;13;069;Écueillé;1202;22;1224
24;Centre-Val de Loire;36;2;02;070;Éguzon-Chantôme;1325;37;1362
24;Centre-Val de Loire;36;2;01;071;Étrechet;1015;19;1034
24;Centre-Val de Loire;36;3;08;073;Feusines;211;5;216
24;Centre-Val de Loire;36;2;04;074;Fléré-la-Rivière;537;10;547
24;Centre-Val de Loire;36;4;10;075;Fontenay;90;1;91
24;Centre-Val de Loire;36;1;03;076;Fontgombault;250;3;253
24;Centre-Val de Loire;36;2;13;077;Fontguenand;248;3;251
24;Centre-Val de Loire;36;3;11;078;Fougerolles;355;10;365
24;Centre-Val de Loire;36;2;10;079;Francillon;77;1;78
24;Centre-Val de Loire;36;2;13;080;Frédille;73;0;73
24;Centre-Val de Loire;36;2;02;081;Gargilesse-Dampierre;276;8;284
24;Centre-Val de Loire;36;2;13;082;Gehée;250;4;254
24;Centre-Val de Loire;36;4;10;083;Giroux;118;3;121
24;Centre-Val de Loire;36;3;11;084;Gournay;284;2;286
24;Centre-Val de Loire;36;4;10;085;Guilly;249;7;256
24;Centre-Val de Loire;36;2;13;086;Heugnes;389;8;397
24;Centre-Val de Loire;36;1;03;087;Ingrandes;309;4;313
24;Centre-Val de Loire;36;4;09;088;Issoudun;11314;264;11578
24;Centre-Val de Loire;36;2;01;089;Jeu-les-Bois;408;6;414
24;Centre-Val de Loire;36;2;13;090;Jeu-Maloches;118;2;120
24;Centre-Val de Loire;36;3;08;091;Lacs;657;18;675
24;Centre-Val de Loire;36;2;13;092;Langé;266;7;273
24;Centre-Val de Loire;36;2;10;093;Levroux;2883;28;2911
24;Centre-Val de Loire;36;1;12;094;Lignac;452;15;467
24;Centre-Val de Loire;36;3;08;095;Lignerolles;108;2;110
24;Centre-Val de Loire;36;1;03;096;Lingé;206;3;209
24;Centre-Val de Loire;36;4;10;097;Liniez;323;8;331
24;Centre-Val de Loire;36;4;10;098;Lizeray;86;2;88
24;Centre-Val de Loire;36;3;11;099;Lourdoueix-Saint-Michel;299;5;304
24;Centre-Val de Loire;36;3;08;100;Lourouer-Saint-Laurent;257;7;264
24;Centre-Val de Loire;36;2;12;101;Luant;1544;41;1585
24;Centre-Val de Loire;36;4;10;102;Luçay-le-Libre;103;2;105
24;Centre-Val de Loire;36;2;13;103;Luçay-le-Mâle;1324;20;1344
24;Centre-Val de Loire;36;1;03;104;Lurais;226;2;228
24;Centre-Val de Loire;36;1;03;105;Lureuil;263;1;264
24;Centre-Val de Loire;36;1;12;106;Luzeret;155;1;156
24;Centre-Val de Loire;36;2;13;107;Lye;740;11;751
24;Centre-Val de Loire;36;3;11;108;Lys-Saint-Georges;210;2;212
24;Centre-Val de Loire;36;3;11;109;Le Magny;1038;20;1058
24;Centre-Val de Loire;36;3;11;110;Maillet;260;6;266
24;Centre-Val de Loire;36;3;11;111;Malicornay;193;3;196
24;Centre-Val de Loire;36;2;01;112;Mâron;743;19;762
24;Centre-Val de Loire;36;1;03;113;Martizay;935;20;955
24;Centre-Val de Loire;36;1;12;114;Mauvières;299;3;302
24;Centre-Val de Loire;36;4;13;115;Menetou-sur-Nahon;130;2;132
24;Centre-Val de Loire;36;4;10;116;Ménétréols-sous-Vatan;118;4;122
24;Centre-Val de Loire;36;2;02;117;Le Menoux;424;8;432
24;Centre-Val de Loire;36;2;12;118;Méobecq;380;3;383
24;Centre-Val de Loire;36;1;03;119;Mérigny;541;13;554
24;Centre-Val de Loire;36;3;11;120;Mers-sur-Indre;667;16;683
24;Centre-Val de Loire;36;4;08;121;Meunet-Planches;171;7;178
24;Centre-Val de Loire;36;4;10;122;Meunet-sur-Vatan;196;2;198
24;Centre-Val de Loire;36;1;03;123;Mézières-en-Brenne;985;21;1006
24;Centre-Val de Loire;36;1;12;124;Migné;259;5;264
24;Centre-Val de Loire;36;4;09;125;Migny;115;5;120
24;Centre-Val de Loire;36;3;11;126;Montchevrier;446;6;452
24;Centre-Val de Loire;36;3;11;127;Montgivray;1554;30;1584
24;Centre-Val de Loire;36;2;01;128;Montierchaume;1665;173;1838
24;Centre-Val de Loire;36;3;11;129;Montipouret;575;13;588
24;Centre-Val de Loire;36;3;08;130;Montlevicq;104;2;106
24;Centre-Val de Loire;36;2;02;131;Mosnay;470;7;477
24;Centre-Val de Loire;36;3;08;132;La Motte-Feuilly;69;3;72
24;Centre-Val de Loire;36;3;11;133;Mouhers;210;6;216
24;Centre-Val de Loire;36;1;12;134;Mouhet;396;11;407
24;Centre-Val de Loire;36;2;10;135;Moulins-sur-Céphons;289;4;293
24;Centre-Val de Loire;36;2;04;136;Murs;129;3;132
24;Centre-Val de Loire;36;1;03;137;Néons-sur-Creuse;362;16;378
24;Centre-Val de Loire;36;3;08;138;Néret;187;4;191
24;Centre-Val de Loire;36;2;12;139;Neuillay-les-Bois;659;17;676
24;Centre-Val de Loire;36;4;08;140;Neuvy-Pailloux;1167;18;1185
24;Centre-Val de Loire;36;3;11;141;Neuvy-Saint-Sépulchre;1651;37;1688
24;Centre-Val de Loire;36;2;04;142;Niherne;1529;33;1562
24;Centre-Val de Loire;36;3;08;143;Nohant-Vic;448;14;462
24;Centre-Val de Loire;36;1;12;144;Nuret-le-Ferron;291;7;298
24;Centre-Val de Loire;36;1;03;145;Obterre;193;4;197
24;Centre-Val de Loire;36;3;11;146;Orsennes;713;10;723
24;Centre-Val de Loire;36;4;13;147;Orville;138;3;141
24;Centre-Val de Loire;36;1;12;148;Oulches;410;3;413
24;Centre-Val de Loire;36;2;04;149;Palluau-sur-Indre;798;12;810
24;Centre-Val de Loire;36;1;12;150;Parnac;501;8;509
24;Centre-Val de Loire;36;4;10;152;Paudy;437;2;439
24;Centre-Val de Loire;36;1;03;153;Paulnay;347;8;355
24;Centre-Val de Loire;36;2;02;154;Le Pêchereau;1854;38;1892
24;Centre-Val de Loire;36;2;13;155;Pellevoisin;797;56;853
24;Centre-Val de Loire;36;3;08;156;Pérassay;385;3;388
24;Centre-Val de Loire;36;1;12;157;La Pérouille;451;13;464
24;Centre-Val de Loire;36;2;02;158;Badecon-le-Pin;771;8;779
24;Centre-Val de Loire;36;2;01;159;Le Poinçonnet;5836;177;6013
24;Centre-Val de Loire;36;2;02;160;Pommiers;210;5;215
24;Centre-Val de Loire;36;2;02;161;Le Pont-Chrétien-Chabenet;944;10;954
24;Centre-Val de Loire;36;4;13;162;Poulaines;817;19;836
24;Centre-Val de Loire;36;3;08;163;Pouligny-Notre-Dame;643;11;654
24;Centre-Val de Loire;36;3;08;164;Pouligny-Saint-Martin;227;3;230
24;Centre-Val de Loire;36;1;03;165;Pouligny-Saint-Pierre;1031;29;1060
24;Centre-Val de Loire;36;2;13;166;Préaux;168;6;174
24;Centre-Val de Loire;36;1;03;167;Preuilly-la-Ville;154;3;157
24;Centre-Val de Loire;36;1;12;168;Prissac;582;16;598
24;Centre-Val de Loire;36;4;08;169;Pruniers;506;11;517
24;Centre-Val de Loire;36;4;10;170;Reboursin;101;0;101
24;Centre-Val de Loire;36;4;10;171;Reuilly;2003;31;2034
24;Centre-Val de Loire;36;1;12;172;Rivarennes;509;11;520
24;Centre-Val de Loire;36;1;03;173;Rosnay;519;13;532
24;Centre-Val de Loire;36;1;12;174;Roussines;358;6;364
24;Centre-Val de Loire;36;2;10;175;Rouvres-les-Bois;273;1;274
24;Centre-Val de Loire;36;1;03;176;Ruffec;580;7;587
24;Centre-Val de Loire;36;1;12;177;Sacierges-Saint-Martin;319;6;325
24;Centre-Val de Loire;36;1;03;178;Saint-Aigny;274;12;286
24;Centre-Val de Loire;36;4;10;179;Saint-Aoustrille;234;1;235
24;Centre-Val de Loire;36;3;08;180;Saint-Août;821;18;839
24;Centre-Val de Loire;36;4;08;181;Saint-Aubin;161;3;164
24;Centre-Val de Loire;36;1;12;182;Saint-Benoît-du-Sault;554;7;561
24;Centre-Val de Loire;36;3;08;184;Saint-Chartier;485;5;490
24;Centre-Val de Loire;36;4;13;185;Saint-Christophe-en-Bazelle;357;3;360
24;Centre-Val de Loire;36;3;08;186;Saint-Christophe-en-Boucherie;249;2;251
24;Centre-Val de Loire;36;1;12;187;Saint-Civran;134;1;135
24;Centre-Val de Loire;36;2;04;188;Saint-Cyran-du-Jambot;171;144;315
24;Centre-Val de Loire;36;3;11;189;Saint-Denis-de-Jouhet;966;13;979
24;Centre-Val de Loire;36;4;01;190;Sainte-Fauste;266;2;268
24;Centre-Val de Loire;36;4;10;191;Saint-Florentin;529;8;537
24;Centre-Val de Loire;36;1;12;192;Saint-Gaultier;1734;21;1755
24;Centre-Val de Loire;36;1;03;193;Sainte-Gemme;254;7;261
24;Centre-Val de Loire;36;2;04;194;Saint-Genou;944;17;961
24;Centre-Val de Loire;36;4;09;195;Saint-Georges-sur-Arnon;572;13;585
24;Centre-Val de Loire;36;1;12;196;Saint-Gilles;95;3;98
24;Centre-Val de Loire;36;1;12;197;Saint-Hilaire-sur-Benaize;299;3;302
24;Centre-Val de Loire;36;2;04;198;Saint-Lactencin;403;15;418
24;Centre-Val de Loire;36;4;10;199;Sainte-Lizaigne;1132;23;1155
24;Centre-Val de Loire;36;2;02;200;Saint-Marcel;1505;24;1529
24;Centre-Val de Loire;36;2;89;202;Saint-Maur;3694;77;3771
24;Centre-Val de Loire;36;2;04;203;Saint-Médard;54;0;54
24;Centre-Val de Loire;36;1;03;204;Saint-Michel-en-Brenne;322;6;328
24;Centre-Val de Loire;36;4;10;205;Saint-Pierre-de-Jards;102;3;105
24;Centre-Val de Loire;36;3;11;207;Saint-Plantaire;606;13;619
24;Centre-Val de Loire;36;3;08;208;Sainte-Sévère-sur-Indre;774;5;779
24;Centre-Val de Loire;36;4;10;209;Saint-Valentin;263;12;275
24;Centre-Val de Loire;36;3;11;210;Sarzay;299;11;310
24;Centre-Val de Loire;36;2;01;211;Sassierges-Saint-Germain;454;8;462
24;Centre-Val de Loire;36;1;03;212;Saulnay;158;5;163
24;Centre-Val de Loire;36;1;03;213;Sauzelles;255;5;260
24;Centre-Val de Loire;36;3;08;214;Sazeray;300;10;310
24;Centre-Val de Loire;36;4;09;215;Ségry;492;12;504
24;Centre-Val de Loire;36;2;13;216;Selles-sur-Nahon;63;0;63
24;Centre-Val de Loire;36;4;13;217;Sembleçay;98;3;101
24;Centre-Val de Loire;36;2;04;218;Sougé;147;5;152
24;Centre-Val de Loire;36;2;02;219;Tendu;650;17;667
24;Centre-Val de Loire;36;1;12;220;Thenay;889;18;907
24;Centre-Val de Loire;36;3;08;221;Thevet-Saint-Julien;386;10;396
24;Centre-Val de Loire;36;4;08;222;Thizay;235;6;241
24;Centre-Val de Loire;36;1;12;223;Tilly;141;4;145
24;Centre-Val de Loire;36;1;03;224;Tournon-Saint-Martin;1127;25;1152
24;Centre-Val de Loire;36;2;04;225;Le Tranger;184;1;185
24;Centre-Val de Loire;36;3;11;226;Tranzault;351;11;362
24;Centre-Val de Loire;36;3;08;227;Urciers;246;3;249
24;Centre-Val de Loire;36;2;13;228;Valençay;2303;80;2383
24;Centre-Val de Loire;36;4;13;229;Val-Fouzon;951;16;967
24;Centre-Val de Loire;36;4;10;230;Vatan;1935;41;1976
24;Centre-Val de Loire;36;2;02;231;Velles;969;20;989
24;Centre-Val de Loire;36;2;12;232;Vendœuvres;1066;23;1089
24;Centre-Val de Loire;36;2;13;233;La Vernelle;760;11;771
24;Centre-Val de Loire;36;3;08;234;Verneuil-sur-Igneraie;335;6;341
24;Centre-Val de Loire;36;2;13;235;Veuil;377;8;385
24;Centre-Val de Loire;36;3;08;236;Vicq-Exemplet;315;5;320
24;Centre-Val de Loire;36;2;13;237;Vicq-sur-Nahon;704;20;724
24;Centre-Val de Loire;36;3;08;238;Vigoulant;99;1;100
24;Centre-Val de Loire;36;1;12;239;Vigoux;464;5;469
24;Centre-Val de Loire;36;3;08;240;Vijon;291;4;295
24;Centre-Val de Loire;36;2;04;241;Villedieu-sur-Indre;2679;46;2725
24;Centre-Val de Loire;36;2;10;242;Villegongis;106;1;107
24;Centre-Val de Loire;36;2;13;243;Villegouin;313;4;317
24;Centre-Val de Loire;36;2;13;244;Villentrois-Faverolles-en-Berry;873;6;879
24;Centre-Val de Loire;36;1;03;246;Villiers;168;2;170
24;Centre-Val de Loire;36;2;10;247;Vineuil;1234;27;1261
24;Centre-Val de Loire;36;4;01;248;Vouillon;229;3;232
24;Centre-Val de Loire;37;3;06;001;Abilly;1140;16;1156
24;Centre-Val de Loire;37;1;08;002;Ambillou;1753;28;1781
24;Centre-Val de Loire;37;3;01;003;Amboise;12569;367;12936
24;Centre-Val de Loire;37;1;13;004;Anché;426;11;437
24;Centre-Val de Loire;37;1;13;005;Antogny-le-Tillac;507;5;512
24;Centre-Val de Loire;37;2;11;006;Artannes-sur-Indre;2660;53;2713
24;Centre-Val de Loire;37;1;13;007;Assay;166;4;170
24;Centre-Val de Loire;37;3;03;008;Athée-sur-Cher;2760;34;2794
24;Centre-Val de Loire;37;3;04;009;Autrèche;430;10;440
24;Centre-Val de Loire;37;3;04;010;Auzouer-en-Touraine;2209;64;2273
24;Centre-Val de Loire;37;1;05;011;Avoine;1933;39;1972
24;Centre-Val de Loire;37;1;13;012;Avon-les-Roches;549;8;557
24;Centre-Val de Loire;37;1;08;013;Avrillé-les-Ponceaux;469;10;479
24;Centre-Val de Loire;37;2;05;014;Azay-le-Rideau;3468;106;3574
24;Centre-Val de Loire;37;2;03;015;Azay-sur-Cher;3089;69;3158
24;Centre-Val de Loire;37;3;09;016;Azay-sur-Indre;358;14;372
24;Centre-Val de Loire;37;2;02;018;Ballan-Miré;8083;142;8225
24;Centre-Val de Loire;37;3;06;019;Barrou;458;12;470
24;Centre-Val de Loire;37;3;09;020;Beaulieu-lès-Loches;1754;33;1787
24;Centre-Val de Loire;37;1;04;021;Beaumont-Louestault;1742;31;1773
24;Centre-Val de Loire;37;1;05;022;Beaumont-en-Véron;2685;85;2770
24;Centre-Val de Loire;37;3;09;023;Beaumont-Village;242;5;247
24;Centre-Val de Loire;37;1;08;024;Benais;917;17;934
24;Centre-Val de Loire;37;2;02;025;Berthenay;684;6;690
24;Centre-Val de Loire;37;3;06;026;Betz-le-Château;519;4;523
24;Centre-Val de Loire;37;3;03;027;Bléré;5264;65;5329
24;Centre-Val de Loire;37;3;06;028;Bossay-sur-Claise;733;23;756
24;Centre-Val de Loire;37;3;06;029;Bossée;327;5;332
24;Centre-Val de Loire;37;3;04;030;Le Boulay;796;8;804
24;Centre-Val de Loire;37;1;08;031;Bourgueil;3808;89;3897
24;Centre-Val de Loire;37;3;06;032;Bournan;274;7;281
24;Centre-Val de Loire;37;3;06;033;Boussay;204;4;208
24;Centre-Val de Loire;37;1;13;034;Braslou;306;9;315
24;Centre-Val de Loire;37;1;13;035;Braye-sous-Faye;287;10;297
24;Centre-Val de Loire;37;1;08;036;Braye-sur-Maulne;198;1;199
24;Centre-Val de Loire;37;1;08;037;Brèches;210;5;215
24;Centre-Val de Loire;37;2;05;038;Bréhémont;738;8;746
24;Centre-Val de Loire;37;3;09;039;Bridoré;484;13;497
24;Centre-Val de Loire;37;1;13;040;Brizay;256;9;265
24;Centre-Val de Loire;37;1;04;041;Bueil-en-Touraine;325;4;329
24;Centre-Val de Loire;37;1;05;042;Candes-Saint-Martin;185;3;188
24;Centre-Val de Loire;37;3;01;043;Cangey;1043;25;1068
24;Centre-Val de Loire;37;3;06;044;La Celle-Guenand;369;5;374
24;Centre-Val de Loire;37;3;06;045;La Celle-Saint-Avant;1050;14;1064
24;Centre-Val de Loire;37;3;03;046;Céré-la-Ronde;426;8;434
24;Centre-Val de Loire;37;1;04;047;Cerelles;1237;27;1264
24;Centre-Val de Loire;37;3;06;048;Chambon;322;6;328
24;Centre-Val de Loire;37;3;09;049;Chambourg-sur-Indre;1248;25;1273
24;Centre-Val de Loire;37;2;10;050;Chambray-lès-Tours;11956;265;12221
24;Centre-Val de Loire;37;1;13;051;Champigny-sur-Veude;818;8;826
24;Centre-Val de Loire;37;2;19;052;Chançay;1131;26;1157
24;Centre-Val de Loire;37;3;09;053;Chanceaux-près-Loches;117;7;124
24;Centre-Val de Loire;37;2;19;054;Chanceaux-sur-Choisille;3529;47;3576
24;Centre-Val de Loire;37;1;08;055;Channay-sur-Lathan;806;17;823
24;Centre-Val de Loire;37;2;05;056;La Chapelle-aux-Naux;567;11;578
24;Centre-Val de Loire;37;3;06;057;La Chapelle-Blanche-Saint-Martin;681;14;695
24;Centre-Val de Loire;37;1;08;058;La Chapelle-sur-Loire;1448;26;1474
24;Centre-Val de Loire;37;1;04;059;Charentilly;1318;31;1349
24;Centre-Val de Loire;37;3;01;060;Chargé;1330;19;1349
24;Centre-Val de Loire;37;3;06;061;Charnizay;490;15;505
24;Centre-Val de Loire;37;1;08;062;Château-la-Vallière;1720;18;1738
24;Centre-Val de Loire;37;3;04;063;Château-Renault;4895;82;4977
24;Centre-Val de Loire;37;3;06;064;Chaumussay;219;9;228
24;Centre-Val de Loire;37;1;13;065;Chaveignes;551;6;557
24;Centre-Val de Loire;37;3;09;066;Chédigny;559;5;564
24;Centre-Val de Loire;37;2;05;067;Cheillé;1812;22;1834
24;Centre-Val de Loire;37;1;04;068;Chemillé-sur-Dême;722;15;737
24;Centre-Val de Loire;37;3;09;069;Chemillé-sur-Indrois;232;8;240
24;Centre-Val de Loire;37;3;03;070;Chenonceaux;345;14;359
24;Centre-Val de Loire;37;1;13;071;Chezelles;131;1;132
24;Centre-Val de Loire;37;1;05;072;Chinon;8063;298;8361
24;Centre-Val de Loire;37;3;03;073;Chisseaux;580;14;594
24;Centre-Val de Loire;37;1;08;074;Chouzé-sur-Loire;2085;23;2108
24;Centre-Val de Loire;37;3;03;075;Cigogné;467;6;473
24;Centre-Val de Loire;37;1;05;076;Cinais;386;10;396
24;Centre-Val de Loire;37;1;08;077;Cinq-Mars-la-Pile;3822;52;3874
24;Centre-Val de Loire;37;3;06;078;Ciran;417;11;428
24;Centre-Val de Loire;37;3;03;079;Civray-de-Touraine;1782;57;1839
24;Centre-Val de Loire;37;3;06;080;Civray-sur-Esves;204;4;208
24;Centre-Val de Loire;37;1;08;081;Cléré-les-Pins;1398;20;1418
24;Centre-Val de Loire;37;1;08;082;Continvoir;458;3;461
24;Centre-Val de Loire;37;3;03;083;Cormery;1800;26;1826
24;Centre-Val de Loire;37;1;08;084;Couesmes;545;7;552
24;Centre-Val de Loire;37;3;03;085;Courçay;798;21;819
24;Centre-Val de Loire;37;1;08;086;Courcelles-de-Touraine;491;10;501
24;Centre-Val de Loire;37;1;13;087;Courcoué;244;9;253
24;Centre-Val de Loire;37;1;05;088;Couziers;108;1;109
24;Centre-Val de Loire;37;1;13;089;Cravant-les-Côteaux;642;18;660
24;Centre-Val de Loire;37;1;13;090;Crissay-sur-Manse;110;2;112
24;Centre-Val de Loire;37;3;03;091;La Croix-en-Touraine;2410;59;2469
24;Centre-Val de Loire;37;3;04;092;Crotelles;653;15;668
24;Centre-Val de Loire;37;1;13;093;Crouzilles;529;5;534
24;Centre-Val de Loire;37;3;06;094;Cussay;563;10;573
24;Centre-Val de Loire;37;3;04;095;Dame-Marie-les-Bois;345;7;352
24;Centre-Val de Loire;37;3;03;096;Dierre;628;10;638
24;Centre-Val de Loire;37;3;09;097;Dolus-le-Sec;670;23;693
24;Centre-Val de Loire;37;3;06;098;Draché;734;18;752
24;Centre-Val de Loire;37;2;02;099;Druye;967;12;979
24;Centre-Val de Loire;37;3;03;100;Épeigné-les-Bois;403;4;407
24;Centre-Val de Loire;37;1;04;101;Épeigné-sur-Dême;152;1;153
24;Centre-Val de Loire;37;3;06;103;Esves-le-Moutier;144;2;146
24;Centre-Val de Loire;37;2;11;104;Esvres;6161;110;6271
24;Centre-Val de Loire;37;1;13;105;Faye-la-Vineuse;259;6;265
24;Centre-Val de Loire;37;3;04;106;La Ferrière;323;4;327
24;Centre-Val de Loire;37;3;06;107;Ferrière-Larçon;234;5;239
24;Centre-Val de Loire;37;3;09;108;Ferrière-sur-Beaulieu;707;14;721
24;Centre-Val de Loire;37;2;12;109;Fondettes;10585;518;11103
24;Centre-Val de Loire;37;3;03;110;Francueil;1386;33;1419
24;Centre-Val de Loire;37;3;09;111;Genillé;1496;35;1531
24;Centre-Val de Loire;37;1;08;112;Gizeux;376;7;383
24;Centre-Val de Loire;37;3;06;113;Le Grand-Pressigny;871;20;891
24;Centre-Val de Loire;37;3;06;114;La Guerche;174;6;180
24;Centre-Val de Loire;37;3;06;115;Descartes;3331;55;3386
24;Centre-Val de Loire;37;3;04;116;Les Hermites;553;17;570
24;Centre-Val de Loire;37;1;08;117;Hommes;869;9;878
24;Centre-Val de Loire;37;1;05;118;Huismes;1411;35;1446
24;Centre-Val de Loire;37;1;13;119;L'Île-Bouchard;1517;39;1556
24;Centre-Val de Loire;37;1;13;121;Jaulnay;249;5;254
24;Centre-Val de Loire;37;2;07;122;Joué-lès-Tours;38750;393;39143
24;Centre-Val de Loire;37;1;08;123;Langeais;4349;62;4411
24;Centre-Val de Loire;37;2;10;124;Larçay;2501;40;2541
24;Centre-Val de Loire;37;1;13;125;Lémeré;492;6;498
24;Centre-Val de Loire;37;1;05;126;Lerné;340;8;348
24;Centre-Val de Loire;37;3;09;127;Le Liège;326;8;334
24;Centre-Val de Loire;37;2;05;128;Lignières-de-Touraine;1306;25;1331
24;Centre-Val de Loire;37;1;13;129;Ligré;1060;21;1081
24;Centre-Val de Loire;37;3;06;130;Ligueil;2115;32;2147
24;Centre-Val de Loire;37;3;01;131;Limeray;1263;22;1285
24;Centre-Val de Loire;37;3;09;132;Loches;6165;526;6691
24;Centre-Val de Loire;37;3;09;133;Loché-sur-Indrois;466;9;475
24;Centre-Val de Loire;37;3;06;134;Louans;678;14;692
24;Centre-Val de Loire;37;3;06;136;Le Louroux;527;3;530
24;Centre-Val de Loire;37;1;08;137;Lublé;138;3;141
24;Centre-Val de Loire;37;3;01;138;Lussault-sur-Loire;859;17;876
24;Centre-Val de Loire;37;2;12;139;Luynes;5093;143;5236
24;Centre-Val de Loire;37;1;13;140;Luzé;251;5;256
24;Centre-Val de Loire;37;3;03;141;Luzillé;957;18;975
24;Centre-Val de Loire;37;1;13;142;Maillé;563;6;569
24;Centre-Val de Loire;37;3;06;143;Manthelan;1358;26;1384
24;Centre-Val de Loire;37;1;05;144;Marçay;531;6;537
24;Centre-Val de Loire;37;3;06;145;Marcé-sur-Esves;241;2;243
24;Centre-Val de Loire;37;1;08;146;Marcilly-sur-Maulne;218;3;221
24;Centre-Val de Loire;37;1;13;147;Marcilly-sur-Vienne;563;13;576
24;Centre-Val de Loire;37;1;13;148;Marigny-Marmande;613;6;619
24;Centre-Val de Loire;37;1;04;149;Marray;479;8;487
24;Centre-Val de Loire;37;1;08;150;Mazières-de-Touraine;1416;13;1429
24;Centre-Val de Loire;37;2;12;151;La Membrolle-sur-Choisille;3294;62;3356
24;Centre-Val de Loire;37;2;19;152;Mettray;2057;66;2123
24;Centre-Val de Loire;37;2;19;153;Monnaie;4678;54;4732
24;Centre-Val de Loire;37;2;11;154;Montbazon;4602;92;4694
24;Centre-Val de Loire;37;3;04;155;Monthodon;642;8;650
24;Centre-Val de Loire;37;2;10;156;Montlouis-sur-Loire;10895;167;11062
24;Centre-Val de Loire;37;3;09;157;Montrésor;316;4;320
24;Centre-Val de Loire;37;3;01;158;Montreuil-en-Touraine;766;11;777
24;Centre-Val de Loire;37;2;11;159;Monts;7896;144;8040
24;Centre-Val de Loire;37;3;04;160;Morand;349;6;355
24;Centre-Val de Loire;37;3;01;161;Mosnes;809;16;825
24;Centre-Val de Loire;37;3;06;162;Mouzay;466;12;478
24;Centre-Val de Loire;37;3;01;163;Nazelles-Négron;3525;59;3584
24;Centre-Val de Loire;37;1;13;165;Neuil;436;5;441
24;Centre-Val de Loire;37;3;01;166;Neuillé-le-Lierre;784;7;791
24;Centre-Val de Loire;37;1;04;167;Neuillé-Pont-Pierre;2127;23;2150
24;Centre-Val de Loire;37;3;06;168;Neuilly-le-Brignon;287;9;296
24;Centre-Val de Loire;37;3;04;169;Neuville-sur-Brenne;927;28;955
24;Centre-Val de Loire;37;1;04;170;Neuvy-le-Roi;1077;68;1145
24;Centre-Val de Loire;37;3;01;171;Noizay;1131;22;1153
24;Centre-Val de Loire;37;2;19;172;Notre-Dame-d'Oé;4221;81;4302
24;Centre-Val de Loire;37;3;09;173;Nouans-les-Fontaines;714;9;723
24;Centre-Val de Loire;37;1;13;174;Nouâtre;809;16;825
24;Centre-Val de Loire;37;3;04;175;Nouzilly;1239;31;1270
24;Centre-Val de Loire;37;1;13;176;Noyant-de-Touraine;1179;49;1228
24;Centre-Val de Loire;37;3;09;177;Orbigny;712;16;728
24;Centre-Val de Loire;37;1;13;178;Panzoult;620;4;624
24;Centre-Val de Loire;37;2;19;179;Parçay-Meslay;2530;34;2564
24;Centre-Val de Loire;37;1;13;180;Parçay-sur-Vienne;632;6;638
24;Centre-Val de Loire;37;3;06;181;Paulmy;235;2;237
24;Centre-Val de Loire;37;1;04;182;Pernay;1451;15;1466
24;Centre-Val de Loire;37;3;09;183;Perrusson;1452;27;1479
24;Centre-Val de Loire;37;3;06;184;Le Petit-Pressigny;328;6;334
24;Centre-Val de Loire;37;3;01;185;Pocé-sur-Cisse;1692;73;1765
24;Centre-Val de Loire;37;2;11;186;Pont-de-Ruan;1215;13;1228
24;Centre-Val de Loire;37;1;13;187;Ports-sur-Vienne;359;7;366
24;Centre-Val de Loire;37;1;13;188;Pouzay;900;7;907
24;Centre-Val de Loire;37;3;06;189;Preuilly-sur-Claise;1008;19;1027
24;Centre-Val de Loire;37;1;13;190;Pussigny;164;2;166
24;Centre-Val de Loire;37;1;13;191;Razines;228;7;235
24;Centre-Val de Loire;37;3;09;192;Reignac-sur-Indre;1302;18;1320
24;Centre-Val de Loire;37;1;08;193;Restigné;1141;26;1167
24;Centre-Val de Loire;37;2;19;194;Reugny;1755;33;1788
24;Centre-Val de Loire;37;2;02;195;La Riche;10372;97;10469
24;Centre-Val de Loire;37;1;13;196;Richelieu;1653;18;1671
24;Centre-Val de Loire;37;2;05;197;Rigny-Ussé;511;13;524
24;Centre-Val de Loire;37;1;08;198;Rillé;315;2;317
24;Centre-Val de Loire;37;1;13;199;Rilly-sur-Vienne;462;8;470
24;Centre-Val de Loire;37;2;05;200;Rivarennes;984;16;1000
24;Centre-Val de Loire;37;1;05;201;Rivière;695;19;714
24;Centre-Val de Loire;37;1;05;202;La Roche-Clermault;530;11;541
24;Centre-Val de Loire;37;2;19;203;Rochecorbon;3162;93;3255
24;Centre-Val de Loire;37;1;04;204;Rouziers-de-Touraine;1343;24;1367
24;Centre-Val de Loire;37;2;05;205;Saché;1411;16;1427
24;Centre-Val de Loire;37;1;04;206;Saint-Antoine-du-Rocher;1766;37;1803
24;Centre-Val de Loire;37;1;04;207;Saint-Aubin-le-Dépeint;341;2;343
24;Centre-Val de Loire;37;2;14;208;Saint-Avertin;15075;334;15409
24;Centre-Val de Loire;37;1;05;210;Saint-Benoît-la-Forêt;847;17;864
24;Centre-Val de Loire;37;2;11;211;Saint-Branchs;2628;34;2662
24;Centre-Val de Loire;37;2;13;212;Sainte-Catherine-de-Fierbois;785;11;796
24;Centre-Val de Loire;37;1;04;213;Saint-Christophe-sur-le-Nais;1092;23;1115
24;Centre-Val de Loire;37;2;12;214;Saint-Cyr-sur-Loire;16884;402;17286
24;Centre-Val de Loire;37;1;13;216;Saint-Épain;1543;33;1576
24;Centre-Val de Loire;37;2;12;217;Saint-Étienne-de-Chigny;1634;23;1657
24;Centre-Val de Loire;37;3;06;218;Saint-Flovier;574;12;586
24;Centre-Val de Loire;37;2;02;219;Saint-Genouph;1029;15;1044
24;Centre-Val de Loire;37;1;05;220;Saint-Germain-sur-Vienne;360;4;364
24;Centre-Val de Loire;37;3;09;221;Saint-Hippolyte;618;7;625
24;Centre-Val de Loire;37;3;09;222;Saint-Jean-Saint-Germain;752;17;769
24;Centre-Val de Loire;37;1;08;223;Saint-Laurent-de-Lin;327;7;334
24;Centre-Val de Loire;37;3;04;224;Saint-Laurent-en-Gâtines;920;22;942
24;Centre-Val de Loire;37;3;03;225;Saint-Martin-le-Beau;3169;49;3218
24;Centre-Val de Loire;37;1;13;226;Sainte-Maure-de-Touraine;4147;52;4199
24;Centre-Val de Loire;37;1;08;228;Saint-Nicolas-de-Bourgueil;1101;24;1125
24;Centre-Val de Loire;37;3;04;229;Saint-Nicolas-des-Motets;243;8;251
24;Centre-Val de Loire;37;3;01;230;Saint-Ouen-les-Vignes;982;19;1001
24;Centre-Val de Loire;37;1;04;231;Saint-Paterne-Racan;1650;25;1675
24;Centre-Val de Loire;37;1;08;232;Coteaux-sur-Loire;1887;39;1926
24;Centre-Val de Loire;37;2;14;233;Saint-Pierre-des-Corps;15898;253;16151
24;Centre-Val de Loire;37;3;09;234;Saint-Quentin-sur-Indrois;491;15;506
24;Centre-Val de Loire;37;3;01;236;Saint-Règle;610;11;621
24;Centre-Val de Loire;37;1;04;237;Saint-Roch;1281;28;1309
24;Centre-Val de Loire;37;3;09;238;Saint-Senoch;526;8;534
24;Centre-Val de Loire;37;3;04;240;Saunay;687;12;699
24;Centre-Val de Loire;37;1;08;241;Savigné-sur-Lathan;1328;20;1348
24;Centre-Val de Loire;37;1;05;242;Savigny-en-Véron;1560;32;1592
24;Centre-Val de Loire;37;2;02;243;Savonnières;3252;77;3329
24;Centre-Val de Loire;37;1;13;244;Sazilly;256;4;260
24;Centre-Val de Loire;37;1;04;245;Semblançay;2162;44;2206
24;Centre-Val de Loire;37;3;09;246;Sennevières;207;5;212
24;Centre-Val de Loire;37;3;06;247;Sepmes;609;10;619
24;Centre-Val de Loire;37;1;05;248;Seuilly;378;22;400
24;Centre-Val de Loire;37;1;04;249;Sonzay;1409;24;1433
24;Centre-Val de Loire;37;2;11;250;Sorigny;2785;77;2862
24;Centre-Val de Loire;37;1;08;251;Souvigné;897;8;905
24;Centre-Val de Loire;37;3;01;252;Souvigny-de-Touraine;394;6;400
24;Centre-Val de Loire;37;3;03;253;Sublaines;180;6;186
24;Centre-Val de Loire;37;3;09;254;Tauxigny-Saint-Bauld;1703;36;1739
24;Centre-Val de Loire;37;1;13;255;Tavant;264;2;266
24;Centre-Val de Loire;37;1;13;256;Theneuil;290;3;293
24;Centre-Val de Loire;37;2;05;257;Thilouze;1786;24;1810
24;Centre-Val de Loire;37;1;05;258;Thizay;291;3;294
24;Centre-Val de Loire;37;3;06;259;Tournon-Saint-Pierre;459;10;469
24;Centre-Val de Loire;37;1;13;260;La Tour-Saint-Gelin;514;11;525
24;Centre-Val de Loire;37;2;99;261;Tours;137850;2624;140474
24;Centre-Val de Loire;37;1;13;262;Trogues;291;4;295
24;Centre-Val de Loire;37;2;11;263;Truyes;2443;35;2478
24;Centre-Val de Loire;37;2;05;264;Vallères;1318;20;1338
24;Centre-Val de Loire;37;3;06;265;Varennes;237;5;242
24;Centre-Val de Loire;37;2;11;266;Veigné;6511;122;6633
24;Centre-Val de Loire;37;2;10;267;Véretz;4590;81;4671
24;Centre-Val de Loire;37;1;13;268;Verneuil-le-Château;127;0;127
24;Centre-Val de Loire;37;3;09;269;Verneuil-sur-Indre;472;12;484
24;Centre-Val de Loire;37;2;19;270;Vernou-sur-Brenne;2769;52;2821
24;Centre-Val de Loire;37;2;05;271;Villaines-les-Rochers;1039;9;1048
24;Centre-Val de Loire;37;2;02;272;Villandry;1136;34;1170
24;Centre-Val de Loire;37;2;10;273;La Ville-aux-Dames;5593;77;5670
24;Centre-Val de Loire;37;1;04;274;Villebourg;306;4;310
24;Centre-Val de Loire;37;3;09;275;Villedômain;121;2;123
24;Centre-Val de Loire;37;3;04;276;Villedômer;1321;31;1352
24;Centre-Val de Loire;37;3;09;277;Villeloin-Coulangé;583;3;586
24;Centre-Val de Loire;37;2;11;278;Villeperdue;1077;7;1084
24;Centre-Val de Loire;37;1;08;279;Villiers-au-Bouin;752;7;759
24;Centre-Val de Loire;37;3;06;280;Vou;238;6;244
24;Centre-Val de Loire;37;2;19;281;Vouvray;3294;62;3356
24;Centre-Val de Loire;37;3;06;282;Yzeures-sur-Creuse;1337;25;1362
84;Auvergne-Rhône-Alpes;38;2;03;001;Les Abrets en Dauphiné;6439;105;6544
84;Auvergne-Rhône-Alpes;38;1;13;002;Les Adrets;1063;31;1094
84;Auvergne-Rhône-Alpes;38;3;21;003;Agnin;1170;22;1192
84;Auvergne-Rhône-Alpes;38;1;23;004;L'Albenc;1285;26;1311
84;Auvergne-Rhône-Alpes;38;1;19;005;Allemond;942;17;959
84;Auvergne-Rhône-Alpes;38;1;13;006;Allevard;3999;107;4106
84;Auvergne-Rhône-Alpes;38;1;15;008;Ambel;27;0;27
84;Auvergne-Rhône-Alpes;38;3;21;009;Anjou;1036;14;1050
84;Auvergne-Rhône-Alpes;38;2;04;010;Annoisin-Chatelans;710;18;728
84;Auvergne-Rhône-Alpes;38;2;04;011;Anthon;1130;14;1144
84;Auvergne-Rhône-Alpes;38;2;03;012;Aoste;2880;52;2932
84;Auvergne-Rhône-Alpes;38;2;08;013;Apprieu;3475;87;3562
84;Auvergne-Rhône-Alpes;38;3;26;015;Artas;1828;39;1867
84;Auvergne-Rhône-Alpes;38;3;28;017;Assieu;1643;36;1679
84;Auvergne-Rhône-Alpes;38;1;23;018;Auberives-en-Royans;367;11;378
84;Auvergne-Rhône-Alpes;38;3;28;019;Auberives-sur-Varèze;1476;28;1504
84;Auvergne-Rhône-Alpes;38;1;19;020;Auris;181;3;184
84;Auvergne-Rhône-Alpes;38;2;17;022;Les Avenières Veyrins-Thuellin;7777;161;7938
84;Auvergne-Rhône-Alpes;38;1;15;023;Avignonet;204;5;209
84;Auvergne-Rhône-Alpes;38;2;17;026;La Balme-les-Grottes;1119;18;1137
84;Auvergne-Rhône-Alpes;38;1;13;027;Barraux;1983;59;2042
84;Auvergne-Rhône-Alpes;38;2;24;029;La Bâtie-Montgascon;1969;46;2015
84;Auvergne-Rhône-Alpes;38;1;25;030;Beaucroissant;1871;29;1900
84;Auvergne-Rhône-Alpes;38;1;15;031;Beaufin;21;0;21
84;Auvergne-Rhône-Alpes;38;3;01;032;Beaufort;583;12;595
84;Auvergne-Rhône-Alpes;38;1;23;033;Beaulieu;633;18;651
84;Auvergne-Rhône-Alpes;38;3;21;034;Beaurepaire;5005;83;5088
84;Auvergne-Rhône-Alpes;38;3;01;035;Beauvoir-de-Marc;1111;15;1126
84;Auvergne-Rhône-Alpes;38;1;23;036;Beauvoir-en-Royans;96;1;97
84;Auvergne-Rhône-Alpes;38;3;21;037;Bellegarde-Poussieu;1000;14;1014
84;Auvergne-Rhône-Alpes;38;2;08;038;Belmont;599;14;613
84;Auvergne-Rhône-Alpes;38;1;18;039;Bernin;3022;105;3127
84;Auvergne-Rhône-Alpes;38;1;19;040;Besse;148;1;149
84;Auvergne-Rhône-Alpes;38;1;23;041;Bessins;104;3;107
84;Auvergne-Rhône-Alpes;38;2;08;042;Bévenais;1031;22;1053
84;Auvergne-Rhône-Alpes;38;2;08;043;Bilieu;1585;42;1627
84;Auvergne-Rhône-Alpes;38;2;08;044;Biol;1488;42;1530
84;Auvergne-Rhône-Alpes;38;1;16;045;Biviers;2304;90;2394
84;Auvergne-Rhône-Alpes;38;2;08;046;Bizonnes;1005;15;1020
84;Auvergne-Rhône-Alpes;38;2;08;047;Blandin;152;3;155
84;Auvergne-Rhône-Alpes;38;2;26;048;Bonnefamille;1102;19;1121
84;Auvergne-Rhône-Alpes;38;3;01;049;Bossieu;313;2;315
84;Auvergne-Rhône-Alpes;38;2;17;050;Le Bouchage;634;10;644
84;Auvergne-Rhône-Alpes;38;3;21;051;Bougé-Chambalud;1381;29;1410
84;Auvergne-Rhône-Alpes;38;1;19;052;Le Bourg-d'Oisans;3285;101;3386
84;Auvergne-Rhône-Alpes;38;2;02;053;Bourgoin-Jallieu;29389;622;30011
84;Auvergne-Rhône-Alpes;38;2;17;054;Bouvesse-Quirieu;1525;26;1551
84;Auvergne-Rhône-Alpes;38;2;17;055;Brangues;633;8;641
84;Auvergne-Rhône-Alpes;38;3;01;056;Bressieux;92;2;94
84;Auvergne-Rhône-Alpes;38;1;05;057;Bresson;664;12;676
84;Auvergne-Rhône-Alpes;38;3;01;058;Brézins;2212;39;2251
84;Auvergne-Rhône-Alpes;38;1;20;059;Brié-et-Angonnes;2533;46;2579
84;Auvergne-Rhône-Alpes;38;3;01;060;Brion;145;4;149
84;Auvergne-Rhône-Alpes;38;1;29;061;La Buisse;3323;77;3400
84;Auvergne-Rhône-Alpes;38;1;13;062;La Buissière;763;13;776
84;Auvergne-Rhône-Alpes;38;2;08;063;Burcin;446;12;458
84;Auvergne-Rhône-Alpes;38;2;24;064;Cessieu;3172;71;3243
84;Auvergne-Rhône-Alpes;38;2;08;065;Châbons;2157;51;2208
84;Auvergne-Rhône-Alpes;38;3;21;066;Chalon;173;4;177
84;Auvergne-Rhône-Alpes;38;2;26;067;Chamagnieu;1731;34;1765
84;Auvergne-Rhône-Alpes;38;1;20;068;Champagnier;1306;29;1335
84;Auvergne-Rhône-Alpes;38;3;01;069;Champier;1452;25;1477
84;Auvergne-Rhône-Alpes;38;1;13;070;Le Champ-près-Froges;1231;15;1246
84;Auvergne-Rhône-Alpes;38;1;20;071;Champ-sur-Drac;3255;33;3288
84;Auvergne-Rhône-Alpes;38;3;21;072;Chanas;2699;33;2732
84;Auvergne-Rhône-Alpes;38;1;15;073;Chantepérier;200;3;203
84;Auvergne-Rhône-Alpes;38;1;23;074;Chantesse;365;6;371
84;Auvergne-Rhône-Alpes;38;1;13;075;Chapareillan;2975;106;3081
84;Auvergne-Rhône-Alpes;38;2;24;076;La Chapelle-de-la-Tour;1905;66;1971
84;Auvergne-Rhône-Alpes;38;3;21;077;La Chapelle-de-Surieu;763;16;779
84;Auvergne-Rhône-Alpes;38;1;13;078;La Chapelle-du-Bard;568;14;582
84;Auvergne-Rhône-Alpes;38;2;03;080;Charancieu;769;20;789
84;Auvergne-Rhône-Alpes;38;3;26;081;Charantonnay;1990;47;2037
84;Auvergne-Rhône-Alpes;38;2;08;082;Charavines;1950;43;1993
84;Auvergne-Rhône-Alpes;38;2;17;083;Charette;444;16;460
84;Auvergne-Rhône-Alpes;38;1;25;084;Charnècles;1407;25;1432
84;Auvergne-Rhône-Alpes;38;2;04;085;Charvieu-Chavagneux;10194;84;10278
84;Auvergne-Rhône-Alpes;38;1;23;086;Chasselay;400;8;408
84;Auvergne-Rhône-Alpes;38;3;27;087;Chasse-sur-Rhône;6338;52;6390
84;Auvergne-Rhône-Alpes;38;2;08;089;Chassignieu;222;5;227
84;Auvergne-Rhône-Alpes;38;1;15;090;Château-Bernard;268;5;273
84;Auvergne-Rhône-Alpes;38;2;02;091;Châteauvilain;750;17;767
84;Auvergne-Rhône-Alpes;38;1;23;092;Châtelus;95;3;98
84;Auvergne-Rhône-Alpes;38;3;01;093;Châtenay;437;6;443
84;Auvergne-Rhône-Alpes;38;3;01;094;Châtonnay;2006;42;2048
84;Auvergne-Rhône-Alpes;38;1;23;095;Chatte;2461;144;2605
84;Auvergne-Rhône-Alpes;38;2;04;097;Chavanoz;4961;66;5027
84;Auvergne-Rhône-Alpes;38;2;08;098;Chélieu;729;17;746
84;Auvergne-Rhône-Alpes;38;1;23;099;Chevrières;735;22;757
84;Auvergne-Rhône-Alpes;38;1;13;100;Le Cheylas;2476;48;2524
84;Auvergne-Rhône-Alpes;38;3;28;101;Cheyssieu;1036;16;1052
84;Auvergne-Rhône-Alpes;38;2;14;102;Chèzeneuve;641;21;662
84;Auvergne-Rhône-Alpes;38;1;15;103;Chichilianne;304;2;306
84;Auvergne-Rhône-Alpes;38;2;03;104;Chimilin;1404;30;1434
84;Auvergne-Rhône-Alpes;38;1;08;105;Chirens;2428;50;2478
84;Auvergne-Rhône-Alpes;38;1;15;106;Cholonge;354;9;363
84;Auvergne-Rhône-Alpes;38;3;28;107;Chonas-l'Amballan;1687;51;1738
84;Auvergne-Rhône-Alpes;38;1;23;108;Choranche;126;0;126
84;Auvergne-Rhône-Alpes;38;2;04;109;Chozeau;1034;36;1070
84;Auvergne-Rhône-Alpes;38;3;27;110;Chuzelles;2300;45;2345
84;Auvergne-Rhône-Alpes;38;1;06;111;Claix;7927;215;8142
84;Auvergne-Rhône-Alpes;38;1;19;112;Clavans-en-Haut-Oisans;98;1;99
84;Auvergne-Rhône-Alpes;38;1;15;113;Clelles;535;6;541
84;Auvergne-Rhône-Alpes;38;3;28;114;Clonas-sur-Varèze;1496;37;1533
84;Auvergne-Rhône-Alpes;38;1;15;115;Saint-Martin-de-la-Cluze;736;19;755
84;Auvergne-Rhône-Alpes;38;1;15;116;Cognet;39;0;39
84;Auvergne-Rhône-Alpes;38;1;23;117;Cognin-les-Gorges;628;15;643
84;Auvergne-Rhône-Alpes;38;2;08;118;Colombe;1635;41;1676
84;Auvergne-Rhône-Alpes;38;1;18;120;La Combe-de-Lancey;710;17;727
84;Auvergne-Rhône-Alpes;38;2;17;124;Corbelin;2281;42;2323
84;Auvergne-Rhône-Alpes;38;1;16;126;Corenc;4101;131;4232
84;Auvergne-Rhône-Alpes;38;1;15;127;Cornillon-en-Trièves;162;5;167
84;Auvergne-Rhône-Alpes;38;1;15;128;Corps;431;5;436
84;Auvergne-Rhône-Alpes;38;1;07;129;Corrençon-en-Vercors;362;18;380
84;Auvergne-Rhône-Alpes;38;3;01;130;La Côte-Saint-André;4817;280;5097
84;Auvergne-Rhône-Alpes;38;3;28;131;Les Côtes-d'Arey;2023;76;2099
84;Auvergne-Rhône-Alpes;38;1;15;132;Les Côtes-de-Corps;72;0;72
84;Auvergne-Rhône-Alpes;38;1;29;133;Coublevie;5318;405;5723
84;Auvergne-Rhône-Alpes;38;3;21;134;Cour-et-Buis;927;20;947
84;Auvergne-Rhône-Alpes;38;2;17;135;Courtenay;1287;19;1306
84;Auvergne-Rhône-Alpes;38;2;14;136;Crachier;568;16;584
84;Auvergne-Rhône-Alpes;38;1;23;137;Cras;431;13;444
84;Auvergne-Rhône-Alpes;38;2;04;138;Crémieu;3437;62;3499
84;Auvergne-Rhône-Alpes;38;2;17;139;Creys-Mépieu;1501;20;1521
84;Auvergne-Rhône-Alpes;38;1;18;140;Crolles;8193;255;8448
84;Auvergne-Rhône-Alpes;38;3;14;141;Culin;761;14;775
84;Auvergne-Rhône-Alpes;38;3;26;144;Diémoz;2837;44;2881
84;Auvergne-Rhône-Alpes;38;2;04;146;Dizimieu;820;26;846
84;Auvergne-Rhône-Alpes;38;2;08;147;Doissin;881;26;907
84;Auvergne-Rhône-Alpes;38;2;24;148;Dolomieu;3218;74;3292
84;Auvergne-Rhône-Alpes;38;2;02;149;Domarin;1690;36;1726
84;Auvergne-Rhône-Alpes;38;1;16;150;Domène;6670;71;6741
84;Auvergne-Rhône-Alpes;38;1;05;151;Échirolles;36970;211;37181
84;Auvergne-Rhône-Alpes;38;2;02;152;Eclose-Badinières;1464;32;1496
84;Auvergne-Rhône-Alpes;38;1;07;153;Engins;441;21;462
84;Auvergne-Rhône-Alpes;38;1;15;154;Entraigues;223;3;226
84;Auvergne-Rhône-Alpes;38;1;03;155;Entre-deux-Guiers;1877;31;1908
84;Auvergne-Rhône-Alpes;38;2;02;156;Les Éparres;968;31;999
84;Auvergne-Rhône-Alpes;38;3;28;157;Estrablin;3620;74;3694
84;Auvergne-Rhône-Alpes;38;1;05;158;Eybens;10112;119;10231
84;Auvergne-Rhône-Alpes;38;2;08;159;Eydoche;540;8;548
84;Auvergne-Rhône-Alpes;38;3;28;160;Eyzin-Pinet;2337;116;2453
84;Auvergne-Rhône-Alpes;38;3;01;161;Faramans;1096;19;1115
84;Auvergne-Rhône-Alpes;38;2;24;162;Faverges-de-la-Tour;1471;39;1510
84;Auvergne-Rhône-Alpes;38;1;13;163;Le Haut-Bréda;411;9;420
84;Auvergne-Rhône-Alpes;38;1;13;166;La Flachère;454;10;464
84;Auvergne-Rhône-Alpes;38;2;08;167;Flachères;546;4;550
84;Auvergne-Rhône-Alpes;38;1;97;169;Fontaine;23049;246;23295
84;Auvergne-Rhône-Alpes;38;1;10;170;Fontanil-Cornillon;3404;35;3439
84;Auvergne-Rhône-Alpes;38;3;01;171;La Forteresse;332;4;336
84;Auvergne-Rhône-Alpes;38;2;14;172;Four;1641;34;1675
84;Auvergne-Rhône-Alpes;38;1;19;173;Le Freney-d'Oisans;245;7;252
84;Auvergne-Rhône-Alpes;38;3;01;174;La Frette;1093;24;1117
84;Auvergne-Rhône-Alpes;38;1;13;175;Froges;3360;58;3418
84;Auvergne-Rhône-Alpes;38;2;26;176;Frontonas;2120;55;2175
84;Auvergne-Rhône-Alpes;38;1;19;177;La Garde;101;0;101
84;Auvergne-Rhône-Alpes;38;1;22;179;Gières;7140;87;7227
84;Auvergne-Rhône-Alpes;38;3;01;180;Gillonnay;1013;38;1051
84;Auvergne-Rhône-Alpes;38;1;13;181;Goncelin;2488;34;2522
84;Auvergne-Rhône-Alpes;38;2;08;182;Le Grand-Lemps;3084;53;3137
84;Auvergne-Rhône-Alpes;38;2;03;183;Granieu;510;9;519
84;Auvergne-Rhône-Alpes;38;3;26;184;Grenay;1626;20;1646
84;Auvergne-Rhône-Alpes;38;1;98;185;Grenoble;158240;2243;160483
84;Auvergne-Rhône-Alpes;38;1;15;186;Gresse-en-Vercors;368;12;380
84;Auvergne-Rhône-Alpes;38;1;20;187;Le Gua;1794;25;1819
84;Auvergne-Rhône-Alpes;38;1;20;188;Herbeys;1370;23;1393
84;Auvergne-Rhône-Alpes;38;3;26;189;Heyrieux;4708;66;4774
84;Auvergne-Rhône-Alpes;38;2;04;190;Hières-sur-Amby;1161;26;1187
84;Auvergne-Rhône-Alpes;38;1;19;191;Huez;1298;32;1330
84;Auvergne-Rhône-Alpes;38;1;13;192;Hurtières;208;6;214
84;Auvergne-Rhône-Alpes;38;2;14;193;L'Isle-d'Abeau;16717;268;16985
84;Auvergne-Rhône-Alpes;38;1;08;194;Izeaux;2148;36;2184
84;Auvergne-Rhône-Alpes;38;1;23;195;Izeron;751;9;760
84;Auvergne-Rhône-Alpes;38;2;04;197;Janneyrias;1815;20;1835
84;Auvergne-Rhône-Alpes;38;3;21;198;Jarcieu;1086;23;1109
84;Auvergne-Rhône-Alpes;38;3;28;199;Jardin;2171;56;2227
84;Auvergne-Rhône-Alpes;38;1;20;200;Jarrie;3797;70;3867
84;Auvergne-Rhône-Alpes;38;1;15;203;Laffrey;467;8;475
84;Auvergne-Rhône-Alpes;38;1;15;204;Lalley;192;5;197
84;Auvergne-Rhône-Alpes;38;1;07;205;Lans-en-Vercors;2673;121;2794
84;Auvergne-Rhône-Alpes;38;1;18;206;Laval-en-Belledonne;989;37;1026
84;Auvergne-Rhône-Alpes;38;1;15;207;Lavaldens;152;3;155
84;Auvergne-Rhône-Alpes;38;1;15;208;Lavars;148;3;151
84;Auvergne-Rhône-Alpes;38;3;01;209;Lentiol;239;7;246
84;Auvergne-Rhône-Alpes;38;2;04;210;Leyrieu;898;15;913
84;Auvergne-Rhône-Alpes;38;3;01;211;Lieudieu;351;6;357
84;Auvergne-Rhône-Alpes;38;1;19;212;Livet-et-Gavet;1269;10;1279
84;Auvergne-Rhône-Alpes;38;3;08;213;Longechenal;592;11;603
84;Auvergne-Rhône-Alpes;38;1;18;214;Lumbin;2178;76;2254
84;Auvergne-Rhône-Alpes;38;3;27;215;Luzinay;2355;52;2407
84;Auvergne-Rhône-Alpes;38;1;23;216;Malleval-en-Vercors;55;2;57
84;Auvergne-Rhône-Alpes;38;1;15;217;Marcieu;71;2;73
84;Auvergne-Rhône-Alpes;38;3;01;218;Marcilloles;1175;21;1196
84;Auvergne-Rhône-Alpes;38;3;01;219;Marcollin;633;15;648
84;Auvergne-Rhône-Alpes;38;3;01;221;Marnans;138;4;142
84;Auvergne-Rhône-Alpes;38;2;08;222;Massieu;746;17;763
84;Auvergne-Rhône-Alpes;38;2;14;223;Maubec;1872;68;1940
84;Auvergne-Rhône-Alpes;38;1;15;224;Mayres-Savel;88;3;91
84;Auvergne-Rhône-Alpes;38;1;07;225;Autrans-Méaudre en Vercors;3068;104;3172
84;Auvergne-Rhône-Alpes;38;1;15;226;Mens;1406;66;1472
84;Auvergne-Rhône-Alpes;38;2;03;228;Merlas;476;18;494
84;Auvergne-Rhône-Alpes;38;1;16;229;Meylan;18221;357;18578
84;Auvergne-Rhône-Alpes;38;2;02;230;Meyrié;1047;31;1078
84;Auvergne-Rhône-Alpes;38;3;14;231;Meyrieu-les-Étangs;1027;28;1055
84;Auvergne-Rhône-Alpes;38;3;01;232;Meyssiez;639;12;651
84;Auvergne-Rhône-Alpes;38;1;15;235;Miribel-Lanchâtre;454;7;461
84;Auvergne-Rhône-Alpes;38;1;03;236;Miribel-les-Échelles;1743;40;1783
84;Auvergne-Rhône-Alpes;38;1;19;237;Mizoën;190;4;194
84;Auvergne-Rhône-Alpes;38;3;27;238;Moidieu-Détourbe;1968;43;2011
84;Auvergne-Rhône-Alpes;38;1;25;239;Moirans;7495;152;7647
84;Auvergne-Rhône-Alpes;38;3;21;240;Moissieu-sur-Dolon;737;15;752
84;Auvergne-Rhône-Alpes;38;1;15;241;Monestier-d'Ambel;15;0;15
84;Auvergne-Rhône-Alpes;38;1;15;242;Monestier-de-Clermont;1449;33;1482
84;Auvergne-Rhône-Alpes;38;1;15;243;Le Monestier-du-Percy;247;6;253
84;Auvergne-Rhône-Alpes;38;3;21;244;Monsteroux-Milieu;797;19;816
84;Auvergne-Rhône-Alpes;38;1;23;245;Montagne;272;4;276
84;Auvergne-Rhône-Alpes;38;2;24;246;Montagnieu;1155;18;1173
84;Auvergne-Rhône-Alpes;38;2;17;247;Montalieu-Vercieu;3516;54;3570
84;Auvergne-Rhône-Alpes;38;1;25;248;Montaud;520;21;541
84;Auvergne-Rhône-Alpes;38;1;16;249;Montbonnot-Saint-Martin;5457;561;6018
84;Auvergne-Rhône-Alpes;38;2;24;250;Montcarra;588;18;606
84;Auvergne-Rhône-Alpes;38;1;19;252;Montchaboud;337;9;346
84;Auvergne-Rhône-Alpes;38;1;19;253;Les Deux Alpes;1942;37;1979
84;Auvergne-Rhône-Alpes;38;1;15;254;Monteynard;496;13;509
84;Auvergne-Rhône-Alpes;38;3;01;255;Montfalcon;140;0;140
84;Auvergne-Rhône-Alpes;38;2;08;256;Montferrat;1843;24;1867
84;Auvergne-Rhône-Alpes;38;2;08;257;Montrevel;447;12;459
84;Auvergne-Rhône-Alpes;38;1;10;258;Mont-Saint-Martin;83;0;83
84;Auvergne-Rhône-Alpes;38;3;21;259;Montseveroux;999;17;1016
84;Auvergne-Rhône-Alpes;38;2;04;260;Moras;523;18;541
84;Auvergne-Rhône-Alpes;38;2;17;261;Morestel;4492;114;4606
84;Auvergne-Rhône-Alpes;38;1;23;263;Morette;373;5;378
84;Auvergne-Rhône-Alpes;38;1;19;264;La Morte;138;0;138
84;Auvergne-Rhône-Alpes;38;1;15;265;La Motte-d'Aveillans;1707;32;1739
84;Auvergne-Rhône-Alpes;38;1;15;266;La Motte-Saint-Martin;451;11;462
84;Auvergne-Rhône-Alpes;38;3;01;267;Mottier;790;15;805
84;Auvergne-Rhône-Alpes;38;1;13;268;Le Moutaret;261;6;267
84;Auvergne-Rhône-Alpes;38;1;15;269;La Mure;4899;210;5109
84;Auvergne-Rhône-Alpes;38;1;29;270;La Murette;1856;70;1926
84;Auvergne-Rhône-Alpes;38;1;16;271;Murianette;859;11;870
84;Auvergne-Rhône-Alpes;38;1;23;272;Murinais;403;4;407
84;Auvergne-Rhône-Alpes;38;1;15;273;Nantes-en-Ratier;465;19;484
84;Auvergne-Rhône-Alpes;38;1;23;275;Serre-Nerpol;310;41;351
84;Auvergne-Rhône-Alpes;38;2;02;276;Nivolas-Vermelle;2648;70;2718
84;Auvergne-Rhône-Alpes;38;1;20;277;Notre-Dame-de-Commiers;543;6;549
84;Auvergne-Rhône-Alpes;38;1;23;278;Notre-Dame-de-l'Osier;499;9;508
84;Auvergne-Rhône-Alpes;38;1;19;279;Notre-Dame-de-Mésage;1121;13;1134
84;Auvergne-Rhône-Alpes;38;1;15;280;Notre-Dame-de-Vaulx;524;21;545
84;Auvergne-Rhône-Alpes;38;1;07;281;Noyarey;2242;77;2319
84;Auvergne-Rhône-Alpes;38;2;17;282;Optevoz;884;27;911
84;Auvergne-Rhône-Alpes;38;1;15;283;Oris-en-Rattier;106;2;108
84;Auvergne-Rhône-Alpes;38;3;01;284;Ornacieux-Balbins;859;22;881
84;Auvergne-Rhône-Alpes;38;1;19;285;Ornon;160;4;164
84;Auvergne-Rhône-Alpes;38;1;19;286;Oulles;9;0;9
84;Auvergne-Rhône-Alpes;38;2;08;287;Oyeu;1063;19;1082
84;Auvergne-Rhône-Alpes;38;3;26;288;Oytier-Saint-Oblas;1684;32;1716
84;Auvergne-Rhône-Alpes;38;1;19;289;Oz;213;4;217
84;Auvergne-Rhône-Alpes;38;3;21;290;Pact;858;18;876
84;Auvergne-Rhône-Alpes;38;3;01;291;Pajay;1119;19;1138
84;Auvergne-Rhône-Alpes;38;2;08;292;Villages du Lac de Paladru;2526;58;2584
84;Auvergne-Rhône-Alpes;38;2;04;294;Panossas;653;17;670
84;Auvergne-Rhône-Alpes;38;2;17;295;Parmilieu;726;17;743
84;Auvergne-Rhône-Alpes;38;2;24;296;Le Passage;918;39;957
84;Auvergne-Rhône-Alpes;38;2;17;297;Arandon-Passins;1873;43;1916
84;Auvergne-Rhône-Alpes;38;3;21;298;Le Péage-de-Roussillon;6444;55;6499
84;Auvergne-Rhône-Alpes;38;1;15;299;Pellafol;136;3;139
84;Auvergne-Rhône-Alpes;38;3;01;300;Penol;368;8;376
84;Auvergne-Rhône-Alpes;38;1;15;301;Percy;172;1;173
84;Auvergne-Rhône-Alpes;38;1;13;303;La Pierre;584;5;589
84;Auvergne-Rhône-Alpes;38;1;15;304;Pierre-Châtel;1506;37;1543
84;Auvergne-Rhône-Alpes;38;3;21;307;Pisieu;523;9;532
84;Auvergne-Rhône-Alpes;38;3;01;308;Plan;279;2;281
84;Auvergne-Rhône-Alpes;38;1;22;309;Poisat;2120;27;2147
84;Auvergne-Rhône-Alpes;38;1;25;310;Poliénas;1180;25;1205
84;Auvergne-Rhône-Alpes;38;3;21;311;Pommier-de-Beaurepaire;717;21;738
84;Auvergne-Rhône-Alpes;38;1;15;313;Ponsonnas;294;8;302
84;Auvergne-Rhône-Alpes;38;1;13;314;Pontcharra;7349;170;7519
84;Auvergne-Rhône-Alpes;38;2;03;315;Le Pont-de-Beauvoisin;3546;143;3689
84;Auvergne-Rhône-Alpes;38;2;04;316;Pont-de-Chéruy;6028;42;6070
84;Auvergne-Rhône-Alpes;38;1;20;317;Le Pont-de-Claix;10879;69;10948
84;Auvergne-Rhône-Alpes;38;3;27;318;Pont-Évêque;5329;51;5380
84;Auvergne-Rhône-Alpes;38;1;23;319;Pont-en-Royans;795;28;823
84;Auvergne-Rhône-Alpes;38;2;17;320;Porcieu-Amblagnieu;1790;40;1830
84;Auvergne-Rhône-Alpes;38;1;15;321;Prébois;168;4;172
84;Auvergne-Rhône-Alpes;38;1;23;322;Presles;95;2;97
84;Auvergne-Rhône-Alpes;38;2;03;323;Pressins;1156;24;1180
84;Auvergne-Rhône-Alpes;38;3;21;324;Primarette;711;18;729
84;Auvergne-Rhône-Alpes;38;1;10;325;Proveysieux;513;9;522
84;Auvergne-Rhône-Alpes;38;1;15;326;Prunières;373;12;385
84;Auvergne-Rhône-Alpes;38;1;10;328;Quaix-en-Chartreuse;901;33;934
84;Auvergne-Rhône-Alpes;38;1;15;329;Quet-en-Beaumont;72;0;72
84;Auvergne-Rhône-Alpes;38;1;23;330;Quincieu;102;1;103
84;Auvergne-Rhône-Alpes;38;1;25;331;Réaumont;1008;31;1039
84;Auvergne-Rhône-Alpes;38;1;25;332;Renage;3388;49;3437
84;Auvergne-Rhône-Alpes;38;1;23;333;Rencurel;331;6;337
84;Auvergne-Rhône-Alpes;38;1;18;334;Revel;1314;43;1357
84;Auvergne-Rhône-Alpes;38;3;21;335;Revel-Tourdan;1050;26;1076
84;Auvergne-Rhône-Alpes;38;3;28;336;Reventin-Vaugris;2006;35;2041
84;Auvergne-Rhône-Alpes;38;1;25;337;Rives;6645;82;6727
84;Auvergne-Rhône-Alpes;38;1;23;338;La Rivière;734;9;743
84;Auvergne-Rhône-Alpes;38;2;26;339;Roche;2150;57;2207
84;Auvergne-Rhône-Alpes;38;3;28;340;Les Roches-de-Condrieu;1970;38;2008
84;Auvergne-Rhône-Alpes;38;2;24;341;Rochetoirin;1094;37;1131
84;Auvergne-Rhône-Alpes;38;1;15;342;Roissard;316;7;323
84;Auvergne-Rhône-Alpes;38;2;03;343;Romagnieu;1636;35;1671
84;Auvergne-Rhône-Alpes;38;3;21;344;Roussillon;8460;118;8578
84;Auvergne-Rhône-Alpes;38;1;23;345;Rovon;608;10;618
84;Auvergne-Rhône-Alpes;38;3;01;346;Royas;394;7;401
84;Auvergne-Rhône-Alpes;38;3;01;347;Roybon;1123;29;1152
84;Auvergne-Rhône-Alpes;38;2;02;348;Ruy-Montceau;4732;109;4841
84;Auvergne-Rhône-Alpes;38;3;21;349;Sablons;2274;42;2316
84;Auvergne-Rhône-Alpes;38;1;18;350;Sainte-Agnès;557;18;575
84;Auvergne-Rhône-Alpes;38;3;14;351;Saint-Agnin-sur-Bion;1110;21;1131
84;Auvergne-Rhône-Alpes;38;2;14;352;Saint-Alban-de-Roche;2131;60;2191
84;Auvergne-Rhône-Alpes;38;3;28;353;Saint-Alban-du-Rhône;880;9;889
84;Auvergne-Rhône-Alpes;38;2;03;354;Saint-Albin-de-Vaulserre;414;6;420
84;Auvergne-Rhône-Alpes;38;1;15;355;Saint-Andéol;123;6;129
84;Auvergne-Rhône-Alpes;38;1;23;356;Saint-André-en-Royans;321;6;327
84;Auvergne-Rhône-Alpes;38;2;24;357;Saint-André-le-Gaz;2761;141;2902
84;Auvergne-Rhône-Alpes;38;3;01;358;Sainte-Anne-sur-Gervonde;730;14;744
84;Auvergne-Rhône-Alpes;38;1;23;359;Saint Antoine l'Abbaye;1197;22;1219
84;Auvergne-Rhône-Alpes;38;1;23;360;Saint-Appolinard;418;8;426
84;Auvergne-Rhône-Alpes;38;1;15;361;Saint-Arey;77;2;79
84;Auvergne-Rhône-Alpes;38;1;29;362;Saint-Aupre;1173;52;1225
84;Auvergne-Rhône-Alpes;38;3;21;363;Saint-Barthélemy;920;55;975
84;Auvergne-Rhône-Alpes;38;1;19;364;Saint-Barthélemy-de-Séchilienne;428;6;434
84;Auvergne-Rhône-Alpes;38;2;04;365;Saint-Baudille-de-la-Tour;828;19;847
84;Auvergne-Rhône-Alpes;38;1;15;366;Saint-Baudille-et-Pipet;259;8;267
84;Auvergne-Rhône-Alpes;38;1;25;368;Saint-Blaise-du-Buis;1084;25;1109
84;Auvergne-Rhône-Alpes;38;2;24;369;Sainte-Blandine;983;38;1021
84;Auvergne-Rhône-Alpes;38;1;23;370;Saint-Bonnet-de-Chavagne;656;18;674
84;Auvergne-Rhône-Alpes;38;2;03;372;Saint-Bueil;718;8;726
84;Auvergne-Rhône-Alpes;38;1;29;373;Saint-Cassien;1143;42;1185
84;Auvergne-Rhône-Alpes;38;2;02;374;Saint-Chef;3731;93;3824
84;Auvergne-Rhône-Alpes;38;1;19;375;Saint-Christophe-en-Oisans;106;0;106
84;Auvergne-Rhône-Alpes;38;1;03;376;Saint-Christophe-sur-Guiers;813;9;822
84;Auvergne-Rhône-Alpes;38;2;24;377;Saint-Clair-de-la-Tour;3446;58;3504
84;Auvergne-Rhône-Alpes;38;3;28;378;Saint-Clair-du-Rhône;3680;85;3765
84;Auvergne-Rhône-Alpes;38;3;01;379;Saint-Clair-sur-Galaure;263;8;271
84;Auvergne-Rhône-Alpes;38;2;08;380;Saint-Didier-de-Bizonnes;311;5;316
84;Auvergne-Rhône-Alpes;38;2;24;381;Saint-Didier-de-la-Tour;2124;55;2179
84;Auvergne-Rhône-Alpes;38;1;10;382;Saint-Égrève;16015;206;16221
84;Auvergne-Rhône-Alpes;38;1;29;383;Saint-Étienne-de-Crossey;2572;109;2681
84;Auvergne-Rhône-Alpes;38;3;01;384;Saint-Étienne-de-Saint-Geoirs;3207;39;3246
84;Auvergne-Rhône-Alpes;38;2;03;386;Saint-Geoire-en-Valdaine;2390;41;2431
84;Auvergne-Rhône-Alpes;38;3;01;387;Saint-Geoirs;497;11;508
84;Auvergne-Rhône-Alpes;38;1;20;388;Saint-Georges-de-Commiers;2592;33;2625
84;Auvergne-Rhône-Alpes;38;3;26;389;Saint-Georges-d'Espéranche;3466;70;3536
84;Auvergne-Rhône-Alpes;38;1;23;390;Saint-Gervais;536;9;545
84;Auvergne-Rhône-Alpes;38;1;15;391;Saint-Guillaume;241;5;246
84;Auvergne-Rhône-Alpes;38;2;04;392;Saint-Hilaire-de-Brens;604;20;624
84;Auvergne-Rhône-Alpes;38;3;01;393;Saint-Hilaire-de-la-Côte;1575;34;1609
84;Auvergne-Rhône-Alpes;38;1;23;394;Saint-Hilaire-du-Rosier;1874;32;1906
84;Auvergne-Rhône-Alpes;38;1;18;395;Plateau-des-Petites-Roches;2397;73;2470
84;Auvergne-Rhône-Alpes;38;1;15;396;Saint-Honoré;812;25;837
84;Auvergne-Rhône-Alpes;38;1;18;397;Saint-Ismier;7046;314;7360
84;Auvergne-Rhône-Alpes;38;2;03;398;Saint-Jean-d'Avelanne;981;16;997
84;Auvergne-Rhône-Alpes;38;3;14;399;Saint-Jean-de-Bournay;4655;104;4759
84;Auvergne-Rhône-Alpes;38;1;25;400;Saint-Jean-de-Moirans;3563;78;3641
84;Auvergne-Rhône-Alpes;38;2;24;401;Saint-Jean-de-Soudain;1661;40;1701
84;Auvergne-Rhône-Alpes;38;1;15;402;Saint-Jean-de-Vaulx;530;19;549
84;Auvergne-Rhône-Alpes;38;1;15;403;Saint-Jean-d'Hérans;289;5;294
84;Auvergne-Rhône-Alpes;38;1;18;404;Saint-Jean-le-Vieux;292;9;301
84;Auvergne-Rhône-Alpes;38;1;03;405;Saint-Joseph-de-Rivière;1237;30;1267
84;Auvergne-Rhône-Alpes;38;3;21;406;Saint-Julien-de-l'Herms;156;2;158
84;Auvergne-Rhône-Alpes;38;1;29;407;La Sure en Chartreuse;988;29;1017
84;Auvergne-Rhône-Alpes;38;3;26;408;Saint-Just-Chaleyssin;2682;62;2744
84;Auvergne-Rhône-Alpes;38;1;23;409;Saint-Just-de-Claix;1361;34;1395
84;Auvergne-Rhône-Alpes;38;1;23;410;Saint-Lattier;1418;25;1443
84;Auvergne-Rhône-Alpes;38;1;03;412;Saint-Laurent-du-Pont;4499;102;4601
84;Auvergne-Rhône-Alpes;38;1;15;413;Saint-Laurent-en-Beaumont;425;9;434
84;Auvergne-Rhône-Alpes;38;1;15;414;Sainte-Luce;40;2;42
84;Auvergne-Rhône-Alpes;38;2;02;415;Saint-Marcel-Bel-Accueil;1437;39;1476
84;Auvergne-Rhône-Alpes;38;1;23;416;Saint-Marcellin;7731;183;7914
84;Auvergne-Rhône-Alpes;38;1;13;417;Sainte-Marie-d'Alloix;481;17;498
84;Auvergne-Rhône-Alpes;38;1;13;418;Sainte-Marie-du-Mont;235;2;237
84;Auvergne-Rhône-Alpes;38;1;15;419;Saint-Martin-de-Clelles;183;2;185
84;Auvergne-Rhône-Alpes;38;2;03;420;Saint-Martin-de-Vaulserre;247;5;252
84;Auvergne-Rhône-Alpes;38;1;22;421;Saint-Martin-d'Hères;38188;267;38455
84;Auvergne-Rhône-Alpes;38;1;19;422;Saint-Martin-d'Uriage;5529;178;5707
84;Auvergne-Rhône-Alpes;38;1;10;423;Saint-Martin-le-Vinoux;5851;63;5914
84;Auvergne-Rhône-Alpes;38;1;15;424;Saint-Maurice-en-Trièves;174;3;177
84;Auvergne-Rhône-Alpes;38;3;28;425;Saint-Maurice-l'Exil;6413;93;6506
84;Auvergne-Rhône-Alpes;38;1;13;426;Saint-Maximin;658;17;675
84;Auvergne-Rhône-Alpes;38;3;01;427;Saint-Michel-de-Saint-Geoirs;295;4;299
84;Auvergne-Rhône-Alpes;38;1;15;428;Saint-Michel-en-Beaumont;31;0;31
84;Auvergne-Rhône-Alpes;38;1;15;429;Saint-Michel-les-Portes;287;7;294
84;Auvergne-Rhône-Alpes;38;1;18;430;Saint-Mury-Monteymond;320;7;327
84;Auvergne-Rhône-Alpes;38;1;18;431;Saint-Nazaire-les-Eymes;2978;87;3065
84;Auvergne-Rhône-Alpes;38;1;29;432;Saint-Nicolas-de-Macherin;966;23;989
84;Auvergne-Rhône-Alpes;38;1;07;433;Saint-Nizier-du-Moucherotte;1103;32;1135
84;Auvergne-Rhône-Alpes;38;2;08;434;Saint-Ondras;650;6;656
84;Auvergne-Rhône-Alpes;38;1;20;436;Saint-Paul-de-Varces;2235;47;2282
84;Auvergne-Rhône-Alpes;38;3;01;437;Saint-Paul-d'Izeaux;295;4;299
84;Auvergne-Rhône-Alpes;38;1;15;438;Saint-Paul-lès-Monestier;274;1;275
84;Auvergne-Rhône-Alpes;38;1;13;439;Crêts en Belledonne;3380;57;3437
84;Auvergne-Rhône-Alpes;38;3;01;440;Saint-Pierre-de-Bressieux;763;16;779
84;Auvergne-Rhône-Alpes;38;1;03;442;Saint-Pierre-de-Chartreuse;950;26;976
84;Auvergne-Rhône-Alpes;38;1;23;443;Saint-Pierre-de-Chérennes;466;16;482
84;Auvergne-Rhône-Alpes;38;1;15;444;Saint-Pierre-de-Méaroz;112;5;117
84;Auvergne-Rhône-Alpes;38;1;19;445;Saint-Pierre-de-Mésage;784;6;790
84;Auvergne-Rhône-Alpes;38;1;03;446;Saint-Pierre-d'Entremont;567;14;581
84;Auvergne-Rhône-Alpes;38;3;28;448;Saint-Prim;1406;31;1437
84;Auvergne-Rhône-Alpes;38;2;26;449;Saint-Quentin-Fallavier;6076;46;6122
84;Auvergne-Rhône-Alpes;38;1;25;450;Saint-Quentin-sur-Isère;1483;21;1504
84;Auvergne-Rhône-Alpes;38;2;04;451;Saint-Romain-de-Jalionas;3403;42;3445
84;Auvergne-Rhône-Alpes;38;3;21;452;Saint-Romain-de-Surieu;401;4;405
84;Auvergne-Rhône-Alpes;38;1;23;453;Saint-Romans;1791;40;1831
84;Auvergne-Rhône-Alpes;38;1;23;454;Saint-Sauveur;2111;47;2158
84;Auvergne-Rhône-Alpes;38;2;02;455;Saint-Savin;4232;96;4328
84;Auvergne-Rhône-Alpes;38;1;15;456;Châtel-en-Trièves;491;10;501
84;Auvergne-Rhône-Alpes;38;3;01;457;Saint-Siméon-de-Bressieux;2952;64;3016
84;Auvergne-Rhône-Alpes;38;2;17;458;Saint-Sorlin-de-Morestel;610;16;626
84;Auvergne-Rhône-Alpes;38;3;28;459;Saint-Sorlin-de-Vienne;942;23;965
84;Auvergne-Rhône-Alpes;38;2;08;460;Saint-Sulpice-des-Rivoires;431;12;443
84;Auvergne-Rhône-Alpes;38;1;15;462;Saint-Théoffrey;563;12;575
84;Auvergne-Rhône-Alpes;38;1;23;463;Saint-Vérand;1717;39;1756
84;Auvergne-Rhône-Alpes;38;2;24;464;Saint-Victor-de-Cessieu;2224;41;2265
84;Auvergne-Rhône-Alpes;38;2;17;465;Saint-Victor-de-Morestel;1088;23;1111
84;Auvergne-Rhône-Alpes;38;1;13;466;Saint-Vincent-de-Mercuze;1495;48;1543
84;Auvergne-Rhône-Alpes;38;2;02;467;Salagnon;1463;38;1501
84;Auvergne-Rhône-Alpes;38;3;21;468;Salaise-sur-Sanne;4505;71;4576
84;Auvergne-Rhône-Alpes;38;1;15;469;La Salette-Fallavaux;73;0;73
84;Auvergne-Rhône-Alpes;38;1;15;470;La Salle-en-Beaumont;342;8;350
84;Auvergne-Rhône-Alpes;38;1;16;471;Le Sappey-en-Chartreuse;1133;30;1163
84;Auvergne-Rhône-Alpes;38;1;10;472;Sarcenas;227;4;231
84;Auvergne-Rhône-Alpes;38;3;01;473;Sardieu;1163;21;1184
84;Auvergne-Rhône-Alpes;38;1;07;474;Sassenage;11339;206;11545
84;Auvergne-Rhône-Alpes;38;2;26;475;Satolas-et-Bonce;2500;33;2533
84;Auvergne-Rhône-Alpes;38;3;01;476;Savas-Mépin;892;12;904
84;Auvergne-Rhône-Alpes;38;1;19;478;Séchilienne;1043;12;1055
84;Auvergne-Rhône-Alpes;38;3;01;479;Porte-des-Bonnevaux;2046;56;2102
84;Auvergne-Rhône-Alpes;38;3;27;480;Septème;2088;41;2129
84;Auvergne-Rhône-Alpes;38;2;02;481;Sérézin-de-la-Tour;1130;32;1162
84;Auvergne-Rhône-Alpes;38;2;17;483;Sermérieu;1654;51;1705
84;Auvergne-Rhône-Alpes;38;3;27;484;Serpaize;2116;31;2147
84;Auvergne-Rhône-Alpes;38;1;06;485;Seyssinet-Pariset;11792;131;11923
84;Auvergne-Rhône-Alpes;38;1;06;486;Seyssins;7907;116;8023
84;Auvergne-Rhône-Alpes;38;3;27;487;Seyssuel;2063;53;2116
84;Auvergne-Rhône-Alpes;38;2;04;488;Siccieu-Saint-Julien-et-Carisieu;586;17;603
84;Auvergne-Rhône-Alpes;38;1;15;489;Siévoz;132;1;133
84;Auvergne-Rhône-Alpes;38;3;01;490;Sillans;1934;46;1980
84;Auvergne-Rhône-Alpes;38;1;15;492;Sinard;711;20;731
84;Auvergne-Rhône-Alpes;38;2;17;494;Soleymieu;810;19;829
84;Auvergne-Rhône-Alpes;38;1;23;495;La Sône;594;4;598
84;Auvergne-Rhône-Alpes;38;3;21;496;Sonnay;1278;26;1304
84;Auvergne-Rhône-Alpes;38;1;15;497;Sousville;145;0;145
84;Auvergne-Rhône-Alpes;38;2;02;498;Succieu;748;11;759
84;Auvergne-Rhône-Alpes;38;1;15;499;Susville;1173;19;1192
84;Auvergne-Rhône-Alpes;38;1;23;500;Têche;582;11;593
84;Auvergne-Rhône-Alpes;38;1;13;501;Tencin;2153;25;2178
84;Auvergne-Rhône-Alpes;38;1;18;503;La Terrasse;2495;124;2619
84;Auvergne-Rhône-Alpes;38;1;13;504;Theys;2011;92;2103
84;Auvergne-Rhône-Alpes;38;3;01;505;Thodure;786;15;801
84;Auvergne-Rhône-Alpes;38;2;04;507;Tignieu-Jameyzieu;7685;121;7806
84;Auvergne-Rhône-Alpes;38;2;24;508;Torchefelon;821;25;846
84;Auvergne-Rhône-Alpes;38;2;24;509;La Tour-du-Pin;8148;205;8353
84;Auvergne-Rhône-Alpes;38;1;13;511;Le Touvet;3166;103;3269
84;Auvergne-Rhône-Alpes;38;3;14;512;Tramolé;786;25;811
84;Auvergne-Rhône-Alpes;38;1;15;513;Treffort;286;11;297
84;Auvergne-Rhône-Alpes;38;1;15;514;Tréminis;185;5;190
84;Auvergne-Rhône-Alpes;38;2;04;515;Trept;2174;46;2220
84;Auvergne-Rhône-Alpes;38;1;16;516;La Tronche;6559;141;6700
84;Auvergne-Rhône-Alpes;38;1;25;517;Tullins;7755;128;7883
84;Auvergne-Rhône-Alpes;38;1;15;518;Valbonnais;512;13;525
84;Auvergne-Rhône-Alpes;38;3;26;519;Valencin;2885;52;2937
84;Auvergne-Rhône-Alpes;38;2;08;520;Valencogne;692;9;701
84;Auvergne-Rhône-Alpes;38;1;15;521;La Valette;65;2;67
84;Auvergne-Rhône-Alpes;38;1;15;522;Valjouffrey;142;2;144
84;Auvergne-Rhône-Alpes;38;1;23;523;Varacieux;845;20;865
84;Auvergne-Rhône-Alpes;38;1;20;524;Varces-Allières-et-Risset;8329;154;8483
84;Auvergne-Rhône-Alpes;38;2;17;525;Vasselin;461;8;469
84;Auvergne-Rhône-Alpes;38;1;23;526;Vatilieu;358;11;369
84;Auvergne-Rhône-Alpes;38;1;19;527;Vaujany;346;4;350
84;Auvergne-Rhône-Alpes;38;1;19;528;Vaulnaveys-le-Bas;1341;30;1371
84;Auvergne-Rhône-Alpes;38;1;19;529;Vaulnaveys-le-Haut;3983;80;4063
84;Auvergne-Rhône-Alpes;38;2;14;530;Vaulx-Milieu;2528;50;2578
84;Auvergne-Rhône-Alpes;38;2;03;531;Velanne;562;8;570
84;Auvergne-Rhône-Alpes;38;2;04;532;Vénérieu;973;12;985
84;Auvergne-Rhône-Alpes;38;1;22;533;Venon;767;16;783
84;Auvergne-Rhône-Alpes;38;2;04;535;Vernas;263;7;270
84;Auvergne-Rhône-Alpes;38;3;28;536;Vernioz;1439;25;1464
84;Auvergne-Rhône-Alpes;38;2;26;537;La Verpillière;7354;87;7441
84;Auvergne-Rhône-Alpes;38;1;18;538;Le Versoud;4991;66;5057
84;Auvergne-Rhône-Alpes;38;2;17;539;Vertrieu;612;20;632
84;Auvergne-Rhône-Alpes;38;1;07;540;Veurey-Voroize;1420;27;1447
84;Auvergne-Rhône-Alpes;38;2;04;542;Veyssilieu;327;15;342
84;Auvergne-Rhône-Alpes;38;2;17;543;Vézeronce-Curtin;2170;36;2206
84;Auvergne-Rhône-Alpes;38;3;99;544;Vienne;30059;342;30401
84;Auvergne-Rhône-Alpes;38;1;20;545;Vif;8614;126;8740
84;Auvergne-Rhône-Alpes;38;2;17;546;Vignieu;959;27;986
84;Auvergne-Rhône-Alpes;38;1;18;547;Villard-Bonnot;7324;107;7431
84;Auvergne-Rhône-Alpes;38;1;07;548;Villard-de-Lans;4279;213;4492
84;Auvergne-Rhône-Alpes;38;1;19;549;Villard-Notre-Dame;28;3;31
84;Auvergne-Rhône-Alpes;38;1;19;550;Villard-Reculas;58;0;58
84;Auvergne-Rhône-Alpes;38;1;19;551;Villard-Reymond;39;1;40
84;Auvergne-Rhône-Alpes;38;1;15;552;Villard-Saint-Christophe;401;9;410
84;Auvergne-Rhône-Alpes;38;2;14;553;Villefontaine;18891;240;19131
84;Auvergne-Rhône-Alpes;38;2;04;554;Villemoirieu;1824;70;1894
84;Auvergne-Rhône-Alpes;38;3;01;555;Villeneuve-de-Marc;1166;30;1196
84;Auvergne-Rhône-Alpes;38;3;21;556;Ville-sous-Anjou;1182;19;1201
84;Auvergne-Rhône-Alpes;38;2;04;557;Villette-d'Anthon;5183;91;5274
84;Auvergne-Rhône-Alpes;38;3;27;558;Villette-de-Vienne;1926;31;1957
84;Auvergne-Rhône-Alpes;38;1;23;559;Vinay;4405;73;4478
84;Auvergne-Rhône-Alpes;38;2;08;560;Val-de-Virieu;1536;26;1562
84;Auvergne-Rhône-Alpes;38;3;01;561;Viriville;1681;35;1716
84;Auvergne-Rhône-Alpes;38;1;19;562;Vizille;7305;169;7474
84;Auvergne-Rhône-Alpes;38;1;29;563;Voiron;20332;521;20853
84;Auvergne-Rhône-Alpes;38;2;03;564;Voissant;238;10;248
84;Auvergne-Rhône-Alpes;38;1;29;565;Voreppe;9514;374;9888
84;Auvergne-Rhône-Alpes;38;1;25;566;Vourey;1697;49;1746
84;Auvergne-Rhône-Alpes;38;1;19;567;Chamrousse;411;5;416
27;Bourgogne-Franche-Comté;39;1;17;001;Abergement-la-Ronce;850;24;874
27;Bourgogne-Franche-Comté;39;1;01;002;Abergement-le-Grand;61;1;62
27;Bourgogne-Franche-Comté;39;1;03;003;Abergement-le-Petit;50;0;50
27;Bourgogne-Franche-Comté;39;1;01;004;Abergement-lès-Thésy;53;3;56
27;Bourgogne-Franche-Comté;39;1;01;006;Aiglepierre;441;16;457
27;Bourgogne-Franche-Comté;39;2;09;007;Alièze;151;5;156
27;Bourgogne-Franche-Comté;39;1;02;008;Amange;445;49;494
27;Bourgogne-Franche-Comté;39;2;04;009;Andelot-en-Montagne;530;15;545
27;Bourgogne-Franche-Comté;39;2;13;010;Andelot-Morval;92;2;94
27;Bourgogne-Franche-Comté;39;1;17;011;Annoire;417;7;424
27;Bourgogne-Franche-Comté;39;1;01;013;Arbois;3239;204;3443
27;Bourgogne-Franche-Comté;39;1;02;014;Archelange;215;7;222
27;Bourgogne-Franche-Comté;39;2;04;015;Ardon;115;2;117
27;Bourgogne-Franche-Comté;39;2;09;016;Arinthod;1112;30;1142
27;Bourgogne-Franche-Comté;39;2;03;017;Arlay;1196;37;1233
27;Bourgogne-Franche-Comté;39;2;09;018;Aromas;634;7;641
27;Bourgogne-Franche-Comté;39;1;01;019;Les Arsures;214;9;223
27;Bourgogne-Franche-Comté;39;2;15;020;Arsure-Arsurette;100;4;104
27;Bourgogne-Franche-Comté;39;2;13;021;La Chailleuse;595;14;609
27;Bourgogne-Franche-Comté;39;1;17;022;Asnans-Beauvoisin;746;11;757
27;Bourgogne-Franche-Comté;39;1;02;024;Audelange;267;6;273
27;Bourgogne-Franche-Comté;39;2;13;025;Augea;266;3;269
27;Bourgogne-Franche-Comté;39;1;10;026;Augerans;182;1;183
27;Bourgogne-Franche-Comté;39;2;13;027;Augisey;188;6;194
27;Bourgogne-Franche-Comté;39;1;03;028;Aumont;466;5;471
27;Bourgogne-Franche-Comté;39;1;17;029;Aumur;377;9;386
27;Bourgogne-Franche-Comté;39;1;02;030;Authume;832;20;852
27;Bourgogne-Franche-Comté;39;1;02;031;Auxange;201;2;203
27;Bourgogne-Franche-Comté;39;3;14;032;Avignon-lès-Saint-Claude;361;17;378
27;Bourgogne-Franche-Comté;39;1;17;034;Balaiseaux;319;9;328
27;Bourgogne-Franche-Comté;39;2;13;035;Balanod;354;9;363
27;Bourgogne-Franche-Comté;39;1;10;037;Bans;194;4;198
27;Bourgogne-Franche-Comté;39;2;15;038;Barésia-sur-l'Ain;144;2;146
27;Bourgogne-Franche-Comté;39;1;10;039;La Barre;243;5;248
27;Bourgogne-Franche-Comté;39;1;03;040;Barretaine;176;2;178
27;Bourgogne-Franche-Comté;39;2;12;041;Baume-les-Messieurs;158;6;164
27;Bourgogne-Franche-Comté;39;1;02;042;Baverans;492;22;514
27;Bourgogne-Franche-Comté;39;2;13;043;Beaufort-Orbagna;1422;22;1444
27;Bourgogne-Franche-Comté;39;2;09;045;Beffia;78;3;81
27;Bourgogne-Franche-Comté;39;3;16;046;Bellecombe;75;3;78
27;Bourgogne-Franche-Comté;39;3;11;047;Bellefontaine;516;11;527
27;Bourgogne-Franche-Comté;39;1;10;048;Belmont;251;8;259
27;Bourgogne-Franche-Comté;39;1;03;049;Bersaillin;406;13;419
27;Bourgogne-Franche-Comté;39;1;12;050;Besain;157;5;162
27;Bourgogne-Franche-Comté;39;1;02;051;Biarne;417;5;422
27;Bourgogne-Franche-Comté;39;2;15;052;Bief-des-Maisons;70;1;71
27;Bourgogne-Franche-Comté;39;2;15;053;Bief-du-Fourg;211;10;221
27;Bourgogne-Franche-Comté;39;1;03;054;Biefmorin;104;2;106
27;Bourgogne-Franche-Comté;39;2;15;055;Billecul;47;1;48
27;Bourgogne-Franche-Comté;39;2;03;056;Bletterans;1527;30;1557
27;Bourgogne-Franche-Comté;39;2;12;057;Blois-sur-Seille;99;1;100
27;Bourgogne-Franche-Comté;39;2;12;058;Blye;177;5;182
27;Bourgogne-Franche-Comté;39;3;11;059;Bois-d'Amont;1650;43;1693
27;Bourgogne-Franche-Comté;39;2;03;060;Bois-de-Gand;57;0;57
27;Bourgogne-Franche-Comté;39;2;15;061;Boissia;108;5;113
27;Bourgogne-Franche-Comté;39;2;09;062;La Boissière;69;0;69
27;Bourgogne-Franche-Comté;39;2;15;063;Bonlieu;250;4;254
27;Bourgogne-Franche-Comté;39;2;12;065;Bonnefontaine;116;0;116
27;Bourgogne-Franche-Comté;39;2;08;066;Bornay;179;6;185
27;Bourgogne-Franche-Comté;39;3;16;068;Les Bouchoux;310;9;319
27;Bourgogne-Franche-Comté;39;2;04;070;Bourg-de-Sirod;93;2;95
27;Bourgogne-Franche-Comté;39;1;01;072;Bracon;268;6;274
27;Bourgogne-Franche-Comté;39;1;03;073;Brainans;172;6;178
27;Bourgogne-Franche-Comté;39;1;02;074;Brans;205;8;213
27;Bourgogne-Franche-Comté;39;1;10;076;La Bretenière;223;2;225
27;Bourgogne-Franche-Comté;39;1;17;077;Bretenières;43;2;45
27;Bourgogne-Franche-Comté;39;1;02;078;Brevans;692;13;705
27;Bourgogne-Franche-Comté;39;2;12;079;Briod;202;9;211
27;Bourgogne-Franche-Comté;39;2;13;080;Broissia;60;2;62
27;Bourgogne-Franche-Comté;39;1;12;081;Buvilly;391;9;400
27;Bourgogne-Franche-Comté;39;2;15;083;Censeau;335;6;341
27;Bourgogne-Franche-Comté;39;1;01;084;Cernans;143;5;148
27;Bourgogne-Franche-Comté;39;2;15;085;Cerniébaud;89;1;90
27;Bourgogne-Franche-Comté;39;2;09;086;Cernon;234;2;236
27;Bourgogne-Franche-Comté;39;2;13;088;Cesancey;390;10;400
27;Bourgogne-Franche-Comté;39;1;17;090;Chaînée-des-Coupis;187;4;191
27;Bourgogne-Franche-Comté;39;2;15;091;Les Chalesmes;88;1;89
27;Bourgogne-Franche-Comté;39;2;09;092;Chambéria;189;0;189
27;Bourgogne-Franche-Comté;39;1;10;093;Chamblay;424;10;434
27;Bourgogne-Franche-Comté;39;1;12;094;Chamole;161;7;168
27;Bourgogne-Franche-Comté;39;1;10;095;Champagne-sur-Loue;122;5;127
27;Bourgogne-Franche-Comté;39;1;02;096;Champagney;465;9;474
27;Bourgogne-Franche-Comté;39;2;04;097;Champagnole;8040;426;8466
27;Bourgogne-Franche-Comté;39;1;17;099;Champdivers;442;6;448
27;Bourgogne-Franche-Comté;39;2;03;100;Champrougier;104;3;107
27;Bourgogne-Franche-Comté;39;1;05;101;Champvans;1456;34;1490
27;Bourgogne-Franche-Comté;39;3;09;102;Chancia;226;4;230
27;Bourgogne-Franche-Comté;39;1;01;103;La Chapelle-sur-Furieuse;306;1;307
27;Bourgogne-Franche-Comté;39;2;03;104;Chapelle-Voland;601;10;611
27;Bourgogne-Franche-Comté;39;2;04;105;Chapois;216;8;224
27;Bourgogne-Franche-Comté;39;3;09;106;Charchilla;288;5;293
27;Bourgogne-Franche-Comté;39;2;15;107;Charcier;142;3;145
27;Bourgogne-Franche-Comté;39;2;15;108;Charency;55;3;58
27;Bourgogne-Franche-Comté;39;2;15;109;Charézier;175;6;181
27;Bourgogne-Franche-Comté;39;2;03;110;La Charme;66;0;66
27;Bourgogne-Franche-Comté;39;2;09;111;Charnod;38;0;38
27;Bourgogne-Franche-Comté;39;2;03;112;La Chassagne;108;2;110
27;Bourgogne-Franche-Comté;39;2;12;114;Château-Chalon;140;6;146
27;Bourgogne-Franche-Comté;39;1;01;116;La Châtelaine;152;2;154
27;Bourgogne-Franche-Comté;39;1;10;117;Chatelay;106;0;106
27;Bourgogne-Franche-Comté;39;3;09;118;Châtel-de-Joux;52;0;52
27;Bourgogne-Franche-Comté;39;1;03;119;Le Chateley;86;3;89
27;Bourgogne-Franche-Comté;39;2;04;120;Châtelneuf;126;8;134
27;Bourgogne-Franche-Comté;39;1;02;121;Châtenois;413;7;420
27;Bourgogne-Franche-Comté;39;2;12;122;Châtillon;113;5;118
27;Bourgogne-Franche-Comté;39;2;03;124;Chaumergy;470;13;483
27;Bourgogne-Franche-Comté;39;3;15;126;La Chaumusse;393;11;404
27;Bourgogne-Franche-Comté;39;1;12;127;Chaussenans;109;1;110
27;Bourgogne-Franche-Comté;39;1;17;128;Chaussin;1563;25;1588
27;Bourgogne-Franche-Comté;39;2;15;129;Chaux-des-Crotenay;390;14;404
27;Bourgogne-Franche-Comté;39;3;14;130;Nanchez;789;40;829
27;Bourgogne-Franche-Comté;39;3;15;131;La Chaux-du-Dombief;565;13;578
27;Bourgogne-Franche-Comté;39;2;03;132;La Chaux-en-Bresse;32;0;32
27;Bourgogne-Franche-Comté;39;1;01;133;Chaux-Champagny;71;2;73
27;Bourgogne-Franche-Comté;39;2;09;134;Chavéria;226;8;234
27;Bourgogne-Franche-Comté;39;2;03;136;Chemenot;38;2;40
27;Bourgogne-Franche-Comté;39;2;09;137;Saint-Hymetière-sur-Valouse;432;13;445
27;Bourgogne-Franche-Comté;39;1;17;138;Chemin;334;7;341
27;Bourgogne-Franche-Comté;39;1;17;139;Chêne-Bernard;78;0;78
27;Bourgogne-Franche-Comté;39;2;03;140;Chêne-Sec;39;0;39
27;Bourgogne-Franche-Comté;39;1;02;141;Chevigny;281;6;287
27;Bourgogne-Franche-Comté;39;2;13;142;Chevreaux;128;2;130
27;Bourgogne-Franche-Comté;39;2;15;143;Chevrotaine;34;0;34
27;Bourgogne-Franche-Comté;39;2;07;145;Chille;296;19;315
27;Bourgogne-Franche-Comté;39;2;08;146;Chilly-le-Vignoble;607;24;631
27;Bourgogne-Franche-Comté;39;1;01;147;Chilly-sur-Salins;96;4;100
27;Bourgogne-Franche-Comté;39;1;10;149;Chissey-sur-Loue;314;5;319
27;Bourgogne-Franche-Comté;39;1;06;150;Choisey;1014;30;1044
27;Bourgogne-Franche-Comté;39;3;16;151;Choux;127;5;132
27;Bourgogne-Franche-Comté;39;2;04;153;Cize;803;30;833
27;Bourgogne-Franche-Comté;39;2;15;154;Clairvaux-les-Lacs;1427;40;1467
27;Bourgogne-Franche-Comté;39;1;01;155;Clucy;77;0;77
27;Bourgogne-Franche-Comté;39;2;15;156;Cogna;242;7;249
27;Bourgogne-Franche-Comté;39;3;16;157;Coiserette;54;3;57
27;Bourgogne-Franche-Comté;39;1;03;159;Colonne;262;2;264
27;Bourgogne-Franche-Comté;39;2;03;160;Commenailles;896;16;912
27;Bourgogne-Franche-Comté;39;2;07;162;Condamine;254;5;259
27;Bourgogne-Franche-Comté;39;2;09;163;Condes;116;1;117
27;Bourgogne-Franche-Comté;39;2;12;164;Conliège;661;28;689
27;Bourgogne-Franche-Comté;39;2;15;165;Conte;57;0;57
27;Bourgogne-Franche-Comté;39;2;09;166;Cornod;215;2;217
27;Bourgogne-Franche-Comté;39;2;03;167;Cosges;358;5;363
27;Bourgogne-Franche-Comté;39;2;09;168;Courbette;46;0;46
27;Bourgogne-Franche-Comté;39;2;08;169;Courbouzon;594;16;610
27;Bourgogne-Franche-Comté;39;2;07;170;Courlans;927;28;955
27;Bourgogne-Franche-Comté;39;2;07;171;Courlaoux;1143;31;1174
27;Bourgogne-Franche-Comté;39;1;10;172;Courtefontaine;255;4;259
27;Bourgogne-Franche-Comté;39;2;13;173;Cousance;1297;28;1325
27;Bourgogne-Franche-Comté;39;3;16;174;Coyrière;65;0;65
27;Bourgogne-Franche-Comté;39;3;09;175;Coyron;71;3;74
27;Bourgogne-Franche-Comté;39;1;10;176;Cramans;526;9;535
27;Bourgogne-Franche-Comté;39;2;12;177;Hauteroche;973;23;996
27;Bourgogne-Franche-Comté;39;2;15;178;Crans;77;2;79
27;Bourgogne-Franche-Comté;39;3;09;179;Crenans;235;7;242
27;Bourgogne-Franche-Comté;39;2;13;180;Cressia;256;120;376
27;Bourgogne-Franche-Comté;39;1;06;182;Crissey;679;27;706
27;Bourgogne-Franche-Comté;39;2;04;183;Crotenay;634;80;714
27;Bourgogne-Franche-Comté;39;3;09;184;Les Crozets;191;5;196
27;Bourgogne-Franche-Comté;39;2;13;185;Cuisia;390;13;403
27;Bourgogne-Franche-Comté;39;2;15;187;Cuvier;274;7;281
27;Bourgogne-Franche-Comté;39;1;02;188;Dammartin-Marpain;349;4;353
27;Bourgogne-Franche-Comté;39;1;06;189;Damparis;2621;76;2697
27;Bourgogne-Franche-Comté;39;1;10;190;Dampierre;1315;29;1344
27;Bourgogne-Franche-Comté;39;1;03;191;Darbonnay;82;5;87
27;Bourgogne-Franche-Comté;39;2;15;192;Denezières;72;1;73
27;Bourgogne-Franche-Comté;39;1;17;193;Le Deschaux;1008;19;1027
27;Bourgogne-Franche-Comté;39;2;03;194;Desnes;481;6;487
27;Bourgogne-Franche-Comté;39;2;03;196;Les Deux-Fays;118;2;120
27;Bourgogne-Franche-Comté;39;2;13;197;Digna;363;12;375
27;Bourgogne-Franche-Comté;39;1;98;198;Dole;23611;872;24483
27;Bourgogne-Franche-Comté;39;2;12;199;Domblans;1220;37;1257
27;Bourgogne-Franche-Comté;39;2;09;200;Dompierre-sur-Mont;214;6;220
27;Bourgogne-Franche-Comté;39;2;15;201;Doucier;280;39;319
27;Bourgogne-Franche-Comté;39;1;01;202;Dournon;139;1;140
27;Bourgogne-Franche-Comté;39;2;15;203;Doye;104;2;106
27;Bourgogne-Franche-Comté;39;2;09;204;Dramelay;29;1;30
27;Bourgogne-Franche-Comté;39;1;02;205;Éclans-Nenon;379;10;389
27;Bourgogne-Franche-Comté;39;1;10;206;Écleux;222;8;230
27;Bourgogne-Franche-Comté;39;2;09;207;Écrille;82;3;85
27;Bourgogne-Franche-Comté;39;2;15;208;Entre-deux-Monts;146;4;150
27;Bourgogne-Franche-Comté;39;2;13;209;Val-d'Épy;318;7;325
27;Bourgogne-Franche-Comté;39;2;04;210;Équevillon;583;13;596
27;Bourgogne-Franche-Comté;39;1;17;211;Les Essards-Taignevaux;251;3;254
27;Bourgogne-Franche-Comté;39;2;15;214;Esserval-Tartre;122;1;123
27;Bourgogne-Franche-Comté;39;3;09;216;Étival;307;12;319
27;Bourgogne-Franche-Comté;39;2;07;217;L'Étoile;568;16;584
27;Bourgogne-Franche-Comté;39;1;10;218;Étrepigney;432;9;441
27;Bourgogne-Franche-Comté;39;1;10;219;Évans;657;8;665
27;Bourgogne-Franche-Comté;39;1;02;220;Falletans;404;10;414
27;Bourgogne-Franche-Comté;39;2;15;221;La Favière;31;1;32
27;Bourgogne-Franche-Comté;39;1;12;222;Fay-en-Montagne;81;7;88
27;Bourgogne-Franche-Comté;39;1;01;223;La Ferté;197;5;202
27;Bourgogne-Franche-Comté;39;1;12;225;Le Fied;191;6;197
27;Bourgogne-Franche-Comté;39;2;15;227;Foncine-le-Bas;193;2;195
27;Bourgogne-Franche-Comté;39;2;15;228;Foncine-le-Haut;1099;29;1128
27;Bourgogne-Franche-Comté;39;2;03;229;Fontainebrux;205;10;215
27;Bourgogne-Franche-Comté;39;2;15;230;Fontenu;75;3;78
27;Bourgogne-Franche-Comté;39;3;15;232;Fort-du-Plasne;454;7;461
27;Bourgogne-Franche-Comté;39;1;05;233;Foucherans;2272;44;2316
27;Bourgogne-Franche-Comté;39;2;03;234;Foulenay;80;1;81
27;Bourgogne-Franche-Comté;39;1;10;235;Fraisans;1192;14;1206
27;Bourgogne-Franche-Comté;39;2;03;236;Francheville;52;0;52
27;Bourgogne-Franche-Comté;39;2;15;237;Fraroz;52;4;56
27;Bourgogne-Franche-Comté;39;1;02;238;Frasne-les-Meulières;109;7;116
27;Bourgogne-Franche-Comté;39;2;15;239;La Frasnée;39;2;41
27;Bourgogne-Franche-Comté;39;2;15;240;Le Frasnois;170;5;175
27;Bourgogne-Franche-Comté;39;2;08;241;Frébuans;380;8;388
27;Bourgogne-Franche-Comté;39;2;12;244;Frontenay;159;5;164
27;Bourgogne-Franche-Comté;39;1;17;245;Gatey;360;10;370
27;Bourgogne-Franche-Comté;39;1;02;246;Gendrey;431;13;444
27;Bourgogne-Franche-Comté;39;2;09;247;Genod;74;1;75
27;Bourgogne-Franche-Comté;39;1;01;248;Geraise;44;0;44
27;Bourgogne-Franche-Comté;39;1;10;249;Germigney;75;4;79
27;Bourgogne-Franche-Comté;39;2;08;250;Geruge;178;3;181
27;Bourgogne-Franche-Comté;39;2;08;251;Gevingey;449;95;544
27;Bourgogne-Franche-Comté;39;1;06;252;Gevry;714;11;725
27;Bourgogne-Franche-Comté;39;2;13;253;Gigny;271;8;279
27;Bourgogne-Franche-Comté;39;2;15;254;Gillois;137;6;143
27;Bourgogne-Franche-Comté;39;2;13;255;Gizia;230;5;235
27;Bourgogne-Franche-Comté;39;3;15;258;Grande-Rivière Château;632;14;646
27;Bourgogne-Franche-Comté;39;1;10;259;Grange-de-Vaivre;37;0;37
27;Bourgogne-Franche-Comté;39;2;13;261;Graye-et-Charnay;139;3;142
27;Bourgogne-Franche-Comté;39;1;02;262;Gredisans;132;1;133
27;Bourgogne-Franche-Comté;39;1;03;263;Grozon;389;13;402
27;Bourgogne-Franche-Comté;39;2;15;265;Hautecour;199;4;203
27;Bourgogne-Franche-Comté;39;1;17;266;Les Hays;349;2;351
27;Bourgogne-Franche-Comté;39;1;01;267;Ivory;98;4;102
27;Bourgogne-Franche-Comté;39;1;01;268;Ivrey;59;1;60
27;Bourgogne-Franche-Comté;39;3;09;269;Jeurre;258;5;263
27;Bourgogne-Franche-Comté;39;1;02;270;Jouhe;537;59;596
27;Bourgogne-Franche-Comté;39;3;15;271;Lac-des-Rouges-Truites;390;17;407
27;Bourgogne-Franche-Comté;39;2;12;272;Ladoye-sur-Seille;47;3;50
27;Bourgogne-Franche-Comté;39;2;13;273;Montlainsia;232;4;236
27;Bourgogne-Franche-Comté;39;3;16;274;Lajoux;286;12;298
27;Bourgogne-Franche-Comté;39;3;16;275;Lamoura;648;17;665
27;Bourgogne-Franche-Comté;39;2;04;277;Le Larderet;53;1;54
27;Bourgogne-Franche-Comté;39;2;15;278;Largillay-Marsonnay;138;2;140
27;Bourgogne-Franche-Comté;39;2;03;279;Larnaud;610;12;622
27;Bourgogne-Franche-Comté;39;3;16;280;Larrivoire;101;2;103
27;Bourgogne-Franche-Comté;39;2;04;281;Le Latet;87;2;89
27;Bourgogne-Franche-Comté;39;2;15;282;La Latette;79;2;81
27;Bourgogne-Franche-Comté;39;3;16;283;Lavancia-Epercy;621;18;639
27;Bourgogne-Franche-Comté;39;1;02;284;Lavangeot;143;1;144
27;Bourgogne-Franche-Comté;39;1;02;285;Lavans-lès-Dole;331;8;339
27;Bourgogne-Franche-Comté;39;3;16;286;Lavans-lès-Saint-Claude;2327;106;2433
27;Bourgogne-Franche-Comté;39;2;12;288;Lavigny;384;9;393
27;Bourgogne-Franche-Comté;39;3;09;289;Lect;348;7;355
27;Bourgogne-Franche-Comté;39;2;09;290;Valzin en Petite Montagne;466;12;478
27;Bourgogne-Franche-Comté;39;1;01;291;Lemuy;239;6;245
27;Bourgogne-Franche-Comté;39;2;04;292;Lent;156;4;160
27;Bourgogne-Franche-Comté;39;3;14;293;Leschères;206;4;210
27;Bourgogne-Franche-Comté;39;2;13;295;Loisia;160;1;161
27;Bourgogne-Franche-Comté;39;2;03;296;Lombard;214;5;219
27;Bourgogne-Franche-Comté;39;3;11;297;Longchaumois;1134;31;1165
27;Bourgogne-Franche-Comté;39;2;15;298;Longcochon;58;3;61
27;Bourgogne-Franche-Comté;39;1;17;299;Longwy-sur-le-Doubs;487;11;498
27;Bourgogne-Franche-Comté;39;2;99;300;Lons-le-Saunier;17092;829;17921
27;Bourgogne-Franche-Comté;39;2;04;301;Loulle;171;4;175
27;Bourgogne-Franche-Comté;39;1;02;302;Louvatange;95;4;99
27;Bourgogne-Franche-Comté;39;2;12;304;Le Louverot;228;9;237
27;Bourgogne-Franche-Comté;39;1;10;305;La Loye;574;10;584
27;Bourgogne-Franche-Comté;39;2;08;306;Macornay;979;29;1008
27;Bourgogne-Franche-Comté;39;3;09;307;Maisod;328;10;338
27;Bourgogne-Franche-Comté;39;1;02;308;Malange;317;6;323
27;Bourgogne-Franche-Comté;39;2;03;310;Mantry;479;14;493
27;Bourgogne-Franche-Comté;39;2;09;312;Marigna-sur-Valouse;110;1;111
27;Bourgogne-Franche-Comté;39;2;15;313;Marigny;215;1;216
27;Bourgogne-Franche-Comté;39;2;09;314;Marnézia;77;4;81
27;Bourgogne-Franche-Comté;39;1;01;315;Marnoz;394;21;415
27;Bourgogne-Franche-Comté;39;2;12;317;La Marre;355;15;370
27;Bourgogne-Franche-Comté;39;3;09;318;Martigna;190;13;203
27;Bourgogne-Franche-Comté;39;1;01;319;Mathenay;144;1;145
27;Bourgogne-Franche-Comté;39;2;13;320;Maynal;336;1;337
27;Bourgogne-Franche-Comté;39;2;12;321;Menétru-le-Vignoble;159;5;164
27;Bourgogne-Franche-Comté;39;2;15;322;Menétrux-en-Joux;60;0;60
27;Bourgogne-Franche-Comté;39;1;02;323;Menotey;316;12;328
27;Bourgogne-Franche-Comté;39;2;09;324;Mérona;7;0;7
27;Bourgogne-Franche-Comté;39;1;01;325;Mesnay;574;16;590
27;Bourgogne-Franche-Comté;39;2;15;326;Mesnois;175;4;179
27;Bourgogne-Franche-Comté;39;2;08;327;Messia-sur-Sorne;853;14;867
27;Bourgogne-Franche-Comté;39;3;09;328;Meussia;427;8;435
27;Bourgogne-Franche-Comté;39;2;15;329;Mièges;170;2;172
27;Bourgogne-Franche-Comté;39;1;03;330;Miéry;152;5;157
27;Bourgogne-Franche-Comté;39;2;15;331;Mignovillard;846;25;871
27;Bourgogne-Franche-Comté;39;3;09;333;Moirans-en-Montagne;2133;108;2241
27;Bourgogne-Franche-Comté;39;2;08;334;Moiron;128;5;133
27;Bourgogne-Franche-Comté;39;1;02;335;Moissey;569;13;582
27;Bourgogne-Franche-Comté;39;1;12;336;Molain;112;4;116
27;Bourgogne-Franche-Comté;39;1;01;337;Molamboz;88;1;89
27;Bourgogne-Franche-Comté;39;1;17;338;Molay;506;9;515
27;Bourgogne-Franche-Comté;39;3;16;339;Chassal-Molinges;1120;29;1149
27;Bourgogne-Franche-Comté;39;1;03;342;Monay;123;1;124
27;Bourgogne-Franche-Comté;39;2;13;343;Monnetay;16;0;16
27;Bourgogne-Franche-Comté;39;2;04;344;Monnet-la-Ville;333;14;347
27;Bourgogne-Franche-Comté;39;1;05;345;Monnières;397;17;414
27;Bourgogne-Franche-Comté;39;2;13;346;Montagna-le-Reconduit;111;5;116
27;Bourgogne-Franche-Comté;39;2;12;348;Montaigu;414;47;461
27;Bourgogne-Franche-Comté;39;2;12;349;Montain;490;24;514
27;Bourgogne-Franche-Comté;39;1;10;350;Montbarrey;306;6;312
27;Bourgogne-Franche-Comté;39;3;09;351;Montcusel;147;6;153
27;Bourgogne-Franche-Comté;39;1;10;352;Monteplain;137;3;140
27;Bourgogne-Franche-Comté;39;2;13;353;Montfleur;164;9;173
27;Bourgogne-Franche-Comté;39;1;03;354;Montholier;372;3;375
27;Bourgogne-Franche-Comté;39;1;01;355;Montigny-lès-Arsures;235;6;241
27;Bourgogne-Franche-Comté;39;2;04;356;Montigny-sur-l'Ain;207;8;215
27;Bourgogne-Franche-Comté;39;1;01;359;Montmarlon;32;0;32
27;Bourgogne-Franche-Comté;39;1;02;360;Montmirey-la-Ville;173;1;174
27;Bourgogne-Franche-Comté;39;1;02;361;Montmirey-le-Château;194;5;199
27;Bourgogne-Franche-Comté;39;2;07;362;Montmorot;3099;331;3430
27;Bourgogne-Franche-Comté;39;2;13;363;Montrevel;83;1;84
27;Bourgogne-Franche-Comté;39;2;04;364;Montrond;494;14;508
27;Bourgogne-Franche-Comté;39;1;10;365;Mont-sous-Vaudrey;1287;20;1307
27;Bourgogne-Franche-Comté;39;2;04;366;Mont-sur-Monnet;231;16;247
27;Bourgogne-Franche-Comté;39;3;11;367;Morbier;2274;84;2358
27;Bourgogne-Franche-Comté;39;3;11;368;Hauts de Bienne;5226;270;5496
27;Bourgogne-Franche-Comté;39;1;10;370;Mouchard;1062;315;1377
27;Bourgogne-Franche-Comté;39;2;15;372;Mournans-Charbonny;87;8;95
27;Bourgogne-Franche-Comté;39;3;16;373;Les Moussières;160;5;165
27;Bourgogne-Franche-Comté;39;2;09;375;Moutonne;129;0;129
27;Bourgogne-Franche-Comté;39;2;04;376;Moutoux;74;2;76
27;Bourgogne-Franche-Comté;39;1;02;377;Mutigney;174;8;182
27;Bourgogne-Franche-Comté;39;2;13;378;Les Trois-Châteaux;766;15;781
27;Bourgogne-Franche-Comté;39;2;03;379;Nance;526;11;537
27;Bourgogne-Franche-Comté;39;2;09;380;Nancuise;44;2;46
27;Bourgogne-Franche-Comté;39;2;04;381;Les Nans;98;3;101
27;Bourgogne-Franche-Comté;39;1;17;385;Neublans-Abergement;541;7;548
27;Bourgogne-Franche-Comté;39;1;03;386;Neuvilley;95;0;95
27;Bourgogne-Franche-Comté;39;1;10;387;Nevy-lès-Dole;294;6;300
27;Bourgogne-Franche-Comté;39;2;12;388;Nevy-sur-Seille;195;8;203
27;Bourgogne-Franche-Comté;39;2;04;389;Ney;595;14;609
27;Bourgogne-Franche-Comté;39;2;12;390;Nogna;297;12;309
27;Bourgogne-Franche-Comté;39;2;15;391;Nozeroy;394;12;406
27;Bourgogne-Franche-Comté;39;1;02;392;Offlanges;192;3;195
27;Bourgogne-Franche-Comté;39;2;15;393;Onglières;63;2;65
27;Bourgogne-Franche-Comté;39;2;09;394;Onoz;70;4;74
27;Bourgogne-Franche-Comté;39;1;10;396;Orchamps;1105;12;1117
27;Bourgogne-Franche-Comté;39;2;09;397;Orgelet;1604;47;1651
27;Bourgogne-Franche-Comté;39;1;02;398;Ougney;405;3;408
27;Bourgogne-Franche-Comté;39;1;10;399;Ounans;340;8;348
27;Bourgogne-Franche-Comté;39;1;10;400;Our;149;2;151
27;Bourgogne-Franche-Comté;39;1;03;401;Oussières;237;6;243
27;Bourgogne-Franche-Comté;39;1;02;402;Pagney;341;6;347
27;Bourgogne-Franche-Comté;39;1;10;403;Pagnoz;221;7;228
27;Bourgogne-Franche-Comté;39;2;12;404;Pannessières;474;11;485
27;Bourgogne-Franche-Comté;39;1;06;405;Parcey;1004;21;1025
27;Bourgogne-Franche-Comté;39;2;04;406;Le Pasquier;268;3;271
27;Bourgogne-Franche-Comté;39;2;03;407;Passenans;336;6;342
27;Bourgogne-Franche-Comté;39;2;15;408;Patornay;154;6;160
27;Bourgogne-Franche-Comté;39;1;02;409;Peintre;133;4;137
27;Bourgogne-Franche-Comté;39;2;12;411;Perrigny;1511;45;1556
27;Bourgogne-Franche-Comté;39;1;17;412;Peseux;312;7;319
27;Bourgogne-Franche-Comté;39;3;16;413;La Pesse;329;8;337
27;Bourgogne-Franche-Comté;39;1;17;415;Petit-Noir;1093;9;1102
27;Bourgogne-Franche-Comté;39;1;12;418;Picarreau;98;2;100
27;Bourgogne-Franche-Comté;39;2;04;419;Pillemoine;62;0;62
27;Bourgogne-Franche-Comté;39;2;09;420;Pimorin;208;3;211
27;Bourgogne-Franche-Comté;39;2;12;421;Le Pin;242;15;257
27;Bourgogne-Franche-Comté;39;2;12;422;Plainoiseau;522;11;533
27;Bourgogne-Franche-Comté;39;2;09;423;Plaisia;104;9;113
27;Bourgogne-Franche-Comté;39;2;15;424;Les Planches-en-Montagne;159;3;162
27;Bourgogne-Franche-Comté;39;1;01;425;Les Planches-près-Arbois;88;0;88
27;Bourgogne-Franche-Comté;39;1;03;426;Plasne;210;10;220
27;Bourgogne-Franche-Comté;39;2;15;427;Plénise;62;1;63
27;Bourgogne-Franche-Comté;39;2;15;428;Plénisette;22;3;25
27;Bourgogne-Franche-Comté;39;1;17;429;Pleure;439;7;446
27;Bourgogne-Franche-Comté;39;1;10;430;Plumont;105;1;106
27;Bourgogne-Franche-Comté;39;2;12;431;Poids-de-Fiole;334;4;338
27;Bourgogne-Franche-Comté;39;1;02;432;Pointre;126;2;128
27;Bourgogne-Franche-Comté;39;1;12;434;Poligny;4013;371;4384
27;Bourgogne-Franche-Comté;39;2;15;435;Pont-de-Poitte;631;22;653
27;Bourgogne-Franche-Comté;39;1;01;436;Pont-d'Héry;234;0;234
27;Bourgogne-Franche-Comté;39;2;04;437;Pont-du-Navoy;275;4;279
27;Bourgogne-Franche-Comté;39;1;10;439;Port-Lesney;529;11;540
27;Bourgogne-Franche-Comté;39;3;11;441;Prémanon;1201;32;1233
27;Bourgogne-Franche-Comté;39;2;09;443;Présilly;118;5;123
27;Bourgogne-Franche-Comté;39;1;01;444;Pretin;60;2;62
27;Bourgogne-Franche-Comté;39;2;12;445;Publy;282;15;297
27;Bourgogne-Franche-Comté;39;1;01;446;Pupillin;248;7;255
27;Bourgogne-Franche-Comté;39;2;03;447;Quintigny;268;11;279
27;Bourgogne-Franche-Comté;39;1;17;448;Rahon;461;15;476
27;Bourgogne-Franche-Comté;39;1;02;449;Rainans;264;10;274
27;Bourgogne-Franche-Comté;39;1;10;451;Ranchot;505;3;508
27;Bourgogne-Franche-Comté;39;1;10;452;Rans;527;7;534
27;Bourgogne-Franche-Comté;39;3;14;453;Ravilloles;448;12;460
27;Bourgogne-Franche-Comté;39;2;03;454;Recanoz;92;2;94
27;Bourgogne-Franche-Comté;39;2;09;455;Reithouse;53;1;54
27;Bourgogne-Franche-Comté;39;2;03;456;Relans;345;4;349
27;Bourgogne-Franche-Comté;39;2;03;457;Les Repôts;55;0;55
27;Bourgogne-Franche-Comté;39;2;12;458;Revigny;241;10;251
27;Bourgogne-Franche-Comté;39;3;14;460;La Rixouse;193;8;201
27;Bourgogne-Franche-Comté;39;2;15;461;Rix;84;0;84
27;Bourgogne-Franche-Comté;39;1;02;462;Rochefort-sur-Nenon;676;4;680
27;Bourgogne-Franche-Comté;39;3;16;463;Rogna;231;6;237
27;Bourgogne-Franche-Comté;39;1;02;464;Romain;212;6;218
27;Bourgogne-Franche-Comté;39;1;02;465;Romange;203;2;205
27;Bourgogne-Franche-Comté;39;2;13;466;Rosay;123;1;124
27;Bourgogne-Franche-Comté;39;2;13;467;Rotalier;153;6;159
27;Bourgogne-Franche-Comté;39;2;09;468;Rothonay;139;3;142
27;Bourgogne-Franche-Comté;39;1;02;469;Rouffange;116;0;116
27;Bourgogne-Franche-Comté;39;3;11;470;Les Rousses;3663;75;3738
27;Bourgogne-Franche-Comté;39;2;03;471;Ruffey-sur-Seille;758;17;775
27;Bourgogne-Franche-Comté;39;2;03;472;Rye;209;5;214
27;Bourgogne-Franche-Comté;39;2;15;473;Saffloz;89;2;91
27;Bourgogne-Franche-Comté;39;2;13;474;Sainte-Agnès;355;9;364
27;Bourgogne-Franche-Comté;39;2;13;475;Saint-Amour;2379;97;2476
27;Bourgogne-Franche-Comté;39;1;17;476;Saint-Aubin;1821;46;1867
27;Bourgogne-Franche-Comté;39;1;17;477;Saint-Baraing;260;5;265
27;Bourgogne-Franche-Comté;39;3;14;478;Saint-Claude;8895;244;9139
27;Bourgogne-Franche-Comté;39;1;01;479;Saint-Cyr-Montmalin;243;7;250
27;Bourgogne-Franche-Comté;39;2;07;480;Saint-Didier;266;9;275
27;Bourgogne-Franche-Comté;39;2;04;481;Saint-Germain-en-Montagne;383;9;392
27;Bourgogne-Franche-Comté;39;2;13;485;Val Suran;787;14;801
27;Bourgogne-Franche-Comté;39;2;03;486;Saint-Lamain;114;4;118
27;Bourgogne-Franche-Comté;39;3;15;487;Saint-Laurent-en-Grandvaux;1824;37;1861
27;Bourgogne-Franche-Comté;39;1;03;489;Saint-Lothain;456;11;467
27;Bourgogne-Franche-Comté;39;1;17;490;Saint-Loup;245;5;250
27;Bourgogne-Franche-Comté;39;3;16;491;Coteaux du Lizon;2191;91;2282
27;Bourgogne-Franche-Comté;39;2;12;492;Saint-Maur;229;6;235
27;Bourgogne-Franche-Comté;39;2;15;493;Saint-Maurice-Crillat;232;1;233
27;Bourgogne-Franche-Comté;39;3;15;494;Saint-Pierre;368;21;389
27;Bourgogne-Franche-Comté;39;1;01;495;Saint-Thiébaud;70;0;70
27;Bourgogne-Franche-Comté;39;1;01;497;Saizenay;94;2;96
27;Bourgogne-Franche-Comté;39;1;10;498;Salans;619;15;634
27;Bourgogne-Franche-Comté;39;1;02;499;Saligney;192;1;193
27;Bourgogne-Franche-Comté;39;1;01;500;Salins-les-Bains;2528;150;2678
27;Bourgogne-Franche-Comté;39;1;05;501;Sampans;1171;27;1198
27;Bourgogne-Franche-Comté;39;1;10;502;Santans;280;8;288
27;Bourgogne-Franche-Comté;39;2;04;503;Sapois;396;15;411
27;Bourgogne-Franche-Comté;39;2;09;504;Sarrogna;222;7;229
27;Bourgogne-Franche-Comté;39;2;15;505;Saugeot;58;3;61
27;Bourgogne-Franche-Comté;39;1;17;507;Séligney;79;1;80
27;Bourgogne-Franche-Comté;39;2;03;508;Sellières;725;9;734
27;Bourgogne-Franche-Comté;39;3;16;510;Septmoncel les Molunes;800;22;822
27;Bourgogne-Franche-Comté;39;2;03;511;Sergenaux;62;3;65
27;Bourgogne-Franche-Comté;39;2;03;512;Sergenon;52;2;54
27;Bourgogne-Franche-Comté;39;1;02;513;Sermange;231;1;232
27;Bourgogne-Franche-Comté;39;1;02;514;Serre-les-Moulières;188;8;196
27;Bourgogne-Franche-Comté;39;2;04;517;Sirod;527;14;541
27;Bourgogne-Franche-Comté;39;2;15;518;Songeson;71;2;73
27;Bourgogne-Franche-Comté;39;2;15;519;Soucia;175;5;180
27;Bourgogne-Franche-Comté;39;1;10;520;Souvans;492;9;501
27;Bourgogne-Franche-Comté;39;2;04;522;Supt;105;2;107
27;Bourgogne-Franche-Comté;39;2;04;523;Syam;191;9;200
27;Bourgogne-Franche-Comté;39;1;17;525;Tassenières;395;9;404
27;Bourgogne-Franche-Comté;39;1;17;526;Tavaux;3934;104;4038
27;Bourgogne-Franche-Comté;39;1;02;527;Taxenne;121;0;121
27;Bourgogne-Franche-Comté;39;1;02;528;Thervay;383;10;393
27;Bourgogne-Franche-Comté;39;1;01;529;Thésy;64;1;65
27;Bourgogne-Franche-Comté;39;2;09;530;Thoirette-Coisia;848;23;871
27;Bourgogne-Franche-Comté;39;2;15;531;Thoiria;184;5;189
27;Bourgogne-Franche-Comté;39;2;13;532;Thoissia;38;1;39
27;Bourgogne-Franche-Comté;39;2;03;533;Toulouse-le-Château;215;6;221
27;Bourgogne-Franche-Comté;39;2;09;534;La Tour-du-Meix;250;6;256
27;Bourgogne-Franche-Comté;39;1;03;535;Tourmont;456;14;470
27;Bourgogne-Franche-Comté;39;2;08;537;Trenal;461;10;471
27;Bourgogne-Franche-Comté;39;2;15;538;Uxelles;61;1;62
27;Bourgogne-Franche-Comté;39;1;01;539;Vadans;296;6;302
27;Bourgogne-Franche-Comté;39;2;04;540;Valempoulières;189;11;200
27;Bourgogne-Franche-Comté;39;2;04;543;Vannoz;219;9;228
27;Bourgogne-Franche-Comté;39;2;04;545;Le Vaudioux;170;5;175
27;Bourgogne-Franche-Comté;39;1;10;546;Vaudrey;355;13;368
27;Bourgogne-Franche-Comté;39;3;16;547;Vaux-lès-Saint-Claude;677;18;695
27;Bourgogne-Franche-Comté;39;1;12;548;Vaux-sur-Poligny;73;5;78
27;Bourgogne-Franche-Comté;39;2;12;550;Verges;193;5;198
27;Bourgogne-Franche-Comté;39;2;13;551;Véria;115;3;118
27;Bourgogne-Franche-Comté;39;2;08;552;Vernantois;297;10;307
27;Bourgogne-Franche-Comté;39;2;12;553;Le Vernois;289;10;299
27;Bourgogne-Franche-Comté;39;2;04;554;Vers-en-Montagne;227;6;233
27;Bourgogne-Franche-Comté;39;2;03;555;Vers-sous-Sellières;252;2;254
27;Bourgogne-Franche-Comté;39;2;15;556;Vertamboz;95;3;98
27;Bourgogne-Franche-Comté;39;2;09;557;Vescles;184;8;192
27;Bourgogne-Franche-Comté;39;2;12;558;Vevy;297;13;310
27;Bourgogne-Franche-Comté;39;1;10;559;La Vieille-Loye;392;4;396
27;Bourgogne-Franche-Comté;39;3;16;560;Villard-Saint-Sauveur;604;14;618
27;Bourgogne-Franche-Comté;39;3;09;561;Villards-d'Héria;385;6;391
27;Bourgogne-Franche-Comté;39;1;10;565;Villeneuve-d'Aval;89;1;90
27;Bourgogne-Franche-Comté;39;2;07;567;Villeneuve-sous-Pymont;298;10;308
27;Bourgogne-Franche-Comté;39;1;03;568;Villerserine;38;2;40
27;Bourgogne-Franche-Comté;39;1;10;569;Villers-Farlay;676;11;687
27;Bourgogne-Franche-Comté;39;1;03;570;Villers-les-Bois;222;1;223
27;Bourgogne-Franche-Comté;39;1;17;571;Villers-Robert;235;1;236
27;Bourgogne-Franche-Comté;39;1;01;572;Villette-lès-Arbois;390;8;398
27;Bourgogne-Franche-Comté;39;1;06;573;Villette-lès-Dole;781;16;797
27;Bourgogne-Franche-Comté;39;2;03;574;Villevieux;711;20;731
27;Bourgogne-Franche-Comté;39;2;03;575;Le Villey;89;2;91
27;Bourgogne-Franche-Comté;39;2;13;576;Val-Sonnette;936;26;962
27;Bourgogne-Franche-Comté;39;2;03;577;Vincent-Froideville;395;13;408
27;Bourgogne-Franche-Comté;39;3;16;579;Viry;890;41;931
27;Bourgogne-Franche-Comté;39;1;02;581;Vitreux;273;1;274
27;Bourgogne-Franche-Comté;39;2;12;582;Voiteur;785;23;808
27;Bourgogne-Franche-Comté;39;2;09;583;Vosbles-Valfin;184;5;189
27;Bourgogne-Franche-Comté;39;1;02;584;Vriange;162;1;163
27;Bourgogne-Franche-Comté;39;3;16;585;Vulvoz;20;0;20
27;Bourgogne-Franche-Comté;39;1;01;586;Aresches;28;0;28
75;Nouvelle-Aquitaine;40;2;01;001;Aire-sur-l'Adour;6197;556;6753
75;Nouvelle-Aquitaine;40;1;04;002;Amou;1565;23;1588
75;Nouvelle-Aquitaine;40;1;05;003;Angoumé;271;9;280
75;Nouvelle-Aquitaine;40;1;09;004;Angresse;2193;49;2242
75;Nouvelle-Aquitaine;40;2;02;005;Arboucave;202;3;205
75;Nouvelle-Aquitaine;40;2;13;006;Arengosse;706;7;713
75;Nouvelle-Aquitaine;40;1;04;007;Argelos;166;2;168
75;Nouvelle-Aquitaine;40;2;08;008;Argelouse;99;2;101
75;Nouvelle-Aquitaine;40;1;04;011;Arsague;329;3;332
75;Nouvelle-Aquitaine;40;2;01;012;Artassenx;263;4;267
75;Nouvelle-Aquitaine;40;2;01;013;Arthez-d'Armagnac;97;5;102
75;Nouvelle-Aquitaine;40;2;08;014;Arue;358;5;363
75;Nouvelle-Aquitaine;40;2;08;015;Arx;46;2;48
75;Nouvelle-Aquitaine;40;2;02;016;Aubagnan;260;2;262
75;Nouvelle-Aquitaine;40;2;02;017;Audignon;393;9;402
75;Nouvelle-Aquitaine;40;1;13;018;Audon;388;6;394
75;Nouvelle-Aquitaine;40;2;03;019;Aureilhan;1068;29;1097
75;Nouvelle-Aquitaine;40;2;02;020;Aurice;625;23;648
75;Nouvelle-Aquitaine;40;1;09;021;Azur;904;20;924
75;Nouvelle-Aquitaine;40;2;01;022;Bahus-Soubiran;395;13;408
75;Nouvelle-Aquitaine;40;1;04;023;Baigts;345;8;353
75;Nouvelle-Aquitaine;40;2;02;024;Banos;263;4;267
75;Nouvelle-Aquitaine;40;2;01;025;Bascons;843;22;865
75;Nouvelle-Aquitaine;40;2;02;026;Bas-Mauco;374;10;384
75;Nouvelle-Aquitaine;40;1;04;027;Bassercles;155;2;157
75;Nouvelle-Aquitaine;40;1;04;028;Bastennes;257;9;266
75;Nouvelle-Aquitaine;40;2;02;029;Bats;317;7;324
75;Nouvelle-Aquitaine;40;2;08;030;Baudignan;50;0;50
75;Nouvelle-Aquitaine;40;1;13;031;Bégaar;1198;12;1210
75;Nouvelle-Aquitaine;40;2;07;032;Belhade;211;2;213
75;Nouvelle-Aquitaine;40;2;08;033;Bélis;159;5;164
75;Nouvelle-Aquitaine;40;1;12;034;Bélus;605;25;630
75;Nouvelle-Aquitaine;40;1;06;035;Bénesse-lès-Dax;569;10;579
75;Nouvelle-Aquitaine;40;1;14;036;Bénesse-Maremne;3748;71;3819
75;Nouvelle-Aquitaine;40;2;11;037;Benquet;1878;46;1924
75;Nouvelle-Aquitaine;40;1;04;038;Bergouey;108;4;112
75;Nouvelle-Aquitaine;40;2;08;039;Betbezer-d'Armagnac;152;0;152
75;Nouvelle-Aquitaine;40;1;13;040;Beylongue;373;9;382
75;Nouvelle-Aquitaine;40;1;04;041;Beyries;128;2;130
75;Nouvelle-Aquitaine;40;1;15;042;Biarrotte;342;7;349
75;Nouvelle-Aquitaine;40;2;03;043;Bias;766;13;779
75;Nouvelle-Aquitaine;40;1;15;044;Biaudos;953;18;971
75;Nouvelle-Aquitaine;40;2;07;046;Biscarrosse;14034;359;14393
75;Nouvelle-Aquitaine;40;1;04;047;Bonnegarde;264;6;270
75;Nouvelle-Aquitaine;40;2;01;049;Bordères-et-Lamensans;397;6;403
75;Nouvelle-Aquitaine;40;2;10;050;Bostens;209;2;211
75;Nouvelle-Aquitaine;40;2;11;051;Bougue;842;27;869
75;Nouvelle-Aquitaine;40;2;01;052;Bourdalat;210;4;214
75;Nouvelle-Aquitaine;40;2;08;053;Bourriot-Bergonce;306;4;310
75;Nouvelle-Aquitaine;40;1;04;054;Brassempouy;263;6;269
75;Nouvelle-Aquitaine;40;2;11;055;Bretagne-de-Marsan;1643;29;1672
75;Nouvelle-Aquitaine;40;2;08;056;Brocas;763;20;783
75;Nouvelle-Aquitaine;40;2;01;057;Buanes;248;6;254
75;Nouvelle-Aquitaine;40;2;08;058;Cachen;227;11;238
75;Nouvelle-Aquitaine;40;1;12;059;Cagnotte;765;20;785
75;Nouvelle-Aquitaine;40;2;08;060;Callen;139;4;143
75;Nouvelle-Aquitaine;40;2;11;061;Campagne;994;26;1020
75;Nouvelle-Aquitaine;40;2;10;062;Campet-et-Lamolère;523;7;530
75;Nouvelle-Aquitaine;40;1;06;063;Candresse;831;17;848
75;Nouvelle-Aquitaine;40;2;08;064;Canenx-et-Réaut;170;3;173
75;Nouvelle-Aquitaine;40;1;14;065;Capbreton;9181;313;9494
75;Nouvelle-Aquitaine;40;1;13;066;Carcarès-Sainte-Croix;538;4;542
75;Nouvelle-Aquitaine;40;1;13;067;Carcen-Ponson;636;6;642
75;Nouvelle-Aquitaine;40;1;04;068;Cassen;584;18;602
75;Nouvelle-Aquitaine;40;1;04;069;Castaignos-Souslens;416;5;421
75;Nouvelle-Aquitaine;40;2;01;070;Castandet;406;13;419
75;Nouvelle-Aquitaine;40;1;04;071;Castelnau-Chalosse;605;43;648
75;Nouvelle-Aquitaine;40;2;02;072;Castelnau-Tursan;186;6;192
75;Nouvelle-Aquitaine;40;2;02;073;Castelner;119;2;121
75;Nouvelle-Aquitaine;40;1;04;074;Castel-Sarrazin;558;19;577
75;Nouvelle-Aquitaine;40;1;03;075;Castets;2497;28;2525
75;Nouvelle-Aquitaine;40;2;02;076;Cauna;436;8;444
75;Nouvelle-Aquitaine;40;1;12;077;Cauneille;799;17;816
75;Nouvelle-Aquitaine;40;1;04;078;Caupenne;395;7;402
75;Nouvelle-Aquitaine;40;2;02;079;Cazalis;135;5;140
75;Nouvelle-Aquitaine;40;2;01;080;Cazères-sur-l'Adour;1128;33;1161
75;Nouvelle-Aquitaine;40;2;08;081;Cère;408;6;414
75;Nouvelle-Aquitaine;40;2;01;082;Classun;252;7;259
75;Nouvelle-Aquitaine;40;2;02;083;Clèdes;120;7;127
75;Nouvelle-Aquitaine;40;1;04;084;Clermont;745;34;779
75;Nouvelle-Aquitaine;40;2;08;085;Commensacq;429;12;441
75;Nouvelle-Aquitaine;40;2;02;086;Coudures;536;8;544
75;Nouvelle-Aquitaine;40;2;08;087;Créon-d'Armagnac;353;5;358
75;Nouvelle-Aquitaine;40;1;98;088;Dax;21044;813;21857
75;Nouvelle-Aquitaine;40;1;04;089;Doazit;856;26;882
75;Nouvelle-Aquitaine;40;1;04;090;Donzacq;462;10;472
75;Nouvelle-Aquitaine;40;2;01;091;Duhort-Bachen;646;18;664
75;Nouvelle-Aquitaine;40;2;02;092;Dumes;221;5;226
75;Nouvelle-Aquitaine;40;2;08;093;Escalans;253;3;256
75;Nouvelle-Aquitaine;40;2;08;094;Escource;751;13;764
75;Nouvelle-Aquitaine;40;1;12;095;Estibeaux;703;20;723
75;Nouvelle-Aquitaine;40;2;08;096;Estigarde;103;2;105
75;Nouvelle-Aquitaine;40;2;01;097;Eugénie-les-Bains;460;10;470
75;Nouvelle-Aquitaine;40;2;02;098;Eyres-Moncube;353;12;365
75;Nouvelle-Aquitaine;40;2;02;099;Fargues;323;3;326
75;Nouvelle-Aquitaine;40;2;01;100;Le Frêche;409;2;411
75;Nouvelle-Aquitaine;40;1;12;101;Gaas;474;14;488
75;Nouvelle-Aquitaine;40;2;08;102;Gabarret;1277;229;1506
75;Nouvelle-Aquitaine;40;2;10;103;Gaillères;634;12;646
75;Nouvelle-Aquitaine;40;1;04;104;Gamarde-les-Bains;1460;34;1494
75;Nouvelle-Aquitaine;40;2;08;105;Garein;433;13;446
75;Nouvelle-Aquitaine;40;1;04;106;Garrey;216;6;222
75;Nouvelle-Aquitaine;40;2;07;108;Gastes;869;17;886
75;Nouvelle-Aquitaine;40;1;04;109;Gaujacq;433;9;442
75;Nouvelle-Aquitaine;40;2;02;110;Geaune;750;15;765
75;Nouvelle-Aquitaine;40;2;10;111;Geloux;702;16;718
75;Nouvelle-Aquitaine;40;1;04;112;Gibret;100;1;101
75;Nouvelle-Aquitaine;40;1;04;113;Goos;528;9;537
75;Nouvelle-Aquitaine;40;1;05;114;Gourbera;359;13;372
75;Nouvelle-Aquitaine;40;1;04;115;Gousse;287;10;297
75;Nouvelle-Aquitaine;40;1;13;116;Gouts;274;3;277
75;Nouvelle-Aquitaine;40;2;01;117;Grenade-sur-l'Adour;2443;80;2523
75;Nouvelle-Aquitaine;40;1;12;118;Habas;1470;29;1499
75;Nouvelle-Aquitaine;40;2;02;119;Hagetmau;4631;108;4739
75;Nouvelle-Aquitaine;40;1;12;120;Hastingues;598;17;615
75;Nouvelle-Aquitaine;40;1;04;121;Hauriet;276;5;281
75;Nouvelle-Aquitaine;40;2;02;122;Haut-Mauco;981;28;1009
75;Nouvelle-Aquitaine;40;1;05;123;Herm;1158;33;1191
75;Nouvelle-Aquitaine;40;2;08;124;Herré;140;2;142
75;Nouvelle-Aquitaine;40;1;06;125;Heugas;1371;38;1409
75;Nouvelle-Aquitaine;40;1;04;126;Hinx;1881;43;1924
75;Nouvelle-Aquitaine;40;2;01;127;Hontanx;616;8;624
75;Nouvelle-Aquitaine;40;2;02;128;Horsarrieu;698;19;717
75;Nouvelle-Aquitaine;40;1;14;129;Josse;914;19;933
75;Nouvelle-Aquitaine;40;2;02;130;Labastide-Chalosse;160;0;160
75;Nouvelle-Aquitaine;40;2;08;131;Labastide-d'Armagnac;689;5;694
75;Nouvelle-Aquitaine;40;1;12;132;Labatut;1417;26;1443
75;Nouvelle-Aquitaine;40;1;14;133;Labenne;6934;116;7050
75;Nouvelle-Aquitaine;40;2;08;134;Labouheyre;2795;36;2831
75;Nouvelle-Aquitaine;40;2;08;135;Labrit;863;8;871
75;Nouvelle-Aquitaine;40;2;02;136;Lacajunte;156;3;159
75;Nouvelle-Aquitaine;40;2;01;137;Lacquy;285;10;295
75;Nouvelle-Aquitaine;40;2;02;138;Lacrabe;283;6;289
75;Nouvelle-Aquitaine;40;2;11;139;Laglorieuse;555;15;570
75;Nouvelle-Aquitaine;40;2;08;140;Lagrange;191;3;194
75;Nouvelle-Aquitaine;40;1;04;141;Lahosse;291;4;295
75;Nouvelle-Aquitaine;40;1;13;142;Laluque;1054;20;1074
75;Nouvelle-Aquitaine;40;1;13;143;Lamothe;302;4;306
75;Nouvelle-Aquitaine;40;1;04;144;Larbey;245;9;254
75;Nouvelle-Aquitaine;40;2;01;145;Larrivière-Saint-Savin;594;22;616
75;Nouvelle-Aquitaine;40;2;01;146;Latrille;165;3;168
75;Nouvelle-Aquitaine;40;1;04;147;Laurède;370;3;373
75;Nouvelle-Aquitaine;40;2;02;148;Lauret;82;3;85
75;Nouvelle-Aquitaine;40;2;08;149;Lencouacq;373;5;378
75;Nouvelle-Aquitaine;40;1;03;150;Léon;1932;53;1985
75;Nouvelle-Aquitaine;40;1;13;151;Lesgor;432;12;444
75;Nouvelle-Aquitaine;40;2;13;152;Lesperon;1026;25;1051
75;Nouvelle-Aquitaine;40;1;13;153;Le Leuy;231;6;237
75;Nouvelle-Aquitaine;40;1;03;154;Lévignacq;312;6;318
75;Nouvelle-Aquitaine;40;1;03;155;Linxe;1513;39;1552
75;Nouvelle-Aquitaine;40;2;07;156;Liposthey;566;5;571
75;Nouvelle-Aquitaine;40;1;03;157;Lit-et-Mixe;1682;39;1721
75;Nouvelle-Aquitaine;40;2;08;158;Losse;274;3;277
75;Nouvelle-Aquitaine;40;1;04;159;Louer;320;4;324
75;Nouvelle-Aquitaine;40;1;04;160;Lourquen;180;7;187
75;Nouvelle-Aquitaine;40;2;08;161;Lubbon;84;1;85
75;Nouvelle-Aquitaine;40;2;10;162;Lucbardez-et-Bargues;575;10;585
75;Nouvelle-Aquitaine;40;2;07;163;Lüe;581;8;589
75;Nouvelle-Aquitaine;40;2;08;164;Retjons;362;1;363
75;Nouvelle-Aquitaine;40;2;08;165;Luglon;380;11;391
75;Nouvelle-Aquitaine;40;2;01;166;Lussagnet;75;1;76
75;Nouvelle-Aquitaine;40;2;08;167;Luxey;654;10;664
75;Nouvelle-Aquitaine;40;1;09;168;Magescq;2450;37;2487
75;Nouvelle-Aquitaine;40;2;08;169;Maillas;126;3;129
75;Nouvelle-Aquitaine;40;2;08;170;Maillères;231;3;234
75;Nouvelle-Aquitaine;40;2;07;171;Mano;120;3;123
75;Nouvelle-Aquitaine;40;2;02;172;Mant;267;7;274
75;Nouvelle-Aquitaine;40;1;04;173;Marpaps;139;5;144
75;Nouvelle-Aquitaine;40;2;02;174;Mauries;85;4;89
75;Nouvelle-Aquitaine;40;2;01;175;Maurrin;444;6;450
75;Nouvelle-Aquitaine;40;2;08;176;Mauvezin-d'Armagnac;86;1;87
75;Nouvelle-Aquitaine;40;1;04;177;Maylis;311;17;328
75;Nouvelle-Aquitaine;40;2;11;178;Mazerolles;642;27;669
75;Nouvelle-Aquitaine;40;1;05;179;Mées;1841;47;1888
75;Nouvelle-Aquitaine;40;1;13;180;Meilhan;1158;30;1188
75;Nouvelle-Aquitaine;40;1;09;181;Messanges;986;33;1019
75;Nouvelle-Aquitaine;40;2;03;182;Mézos;831;11;842
75;Nouvelle-Aquitaine;40;1;12;183;Mimbaste;965;30;995
75;Nouvelle-Aquitaine;40;2;03;184;Mimizan;7321;168;7489
75;Nouvelle-Aquitaine;40;2;02;185;Miramont-Sensacq;354;8;362
75;Nouvelle-Aquitaine;40;1;12;186;Misson;822;18;840
75;Nouvelle-Aquitaine;40;1;09;187;Moliets-et-Maa;1225;19;1244
75;Nouvelle-Aquitaine;40;2;02;188;Momuy;475;12;487
75;Nouvelle-Aquitaine;40;2;02;189;Monget;82;3;85
75;Nouvelle-Aquitaine;40;2;02;190;Monségur;390;11;401
75;Nouvelle-Aquitaine;40;2;02;191;Montaut;616;12;628
75;Nouvelle-Aquitaine;40;2;99;192;Mont-de-Marsan;29953;1413;31366
75;Nouvelle-Aquitaine;40;2;01;193;Montégut;76;2;78
75;Nouvelle-Aquitaine;40;1;04;194;Montfort-en-Chalosse;1193;31;1224
75;Nouvelle-Aquitaine;40;2;02;195;Montgaillard;611;13;624
75;Nouvelle-Aquitaine;40;2;02;196;Montsoué;565;13;578
75;Nouvelle-Aquitaine;40;2;13;197;Morcenx-la-Nouvelle;4976;132;5108
75;Nouvelle-Aquitaine;40;2;02;198;Morganx;173;7;180
75;Nouvelle-Aquitaine;40;1;12;199;Mouscardès;269;4;273
75;Nouvelle-Aquitaine;40;2;07;200;Moustey;669;10;679
75;Nouvelle-Aquitaine;40;1;04;201;Mugron;1329;103;1432
75;Nouvelle-Aquitaine;40;1;06;202;Narrosse;3259;76;3335
75;Nouvelle-Aquitaine;40;1;04;203;Nassiet;320;13;333
75;Nouvelle-Aquitaine;40;1;04;204;Nerbis;267;4;271
75;Nouvelle-Aquitaine;40;1;04;205;Nousse;247;8;255
75;Nouvelle-Aquitaine;40;1;12;206;Oeyregave;317;13;330
75;Nouvelle-Aquitaine;40;1;06;207;Oeyreluy;1507;208;1715
75;Nouvelle-Aquitaine;40;1;04;208;Onard;365;6;371
75;Nouvelle-Aquitaine;40;1;15;209;Ondres;5519;120;5639
75;Nouvelle-Aquitaine;40;2;13;210;Onesse-Laharie;1032;19;1051
75;Nouvelle-Aquitaine;40;1;12;211;Orist;762;18;780
75;Nouvelle-Aquitaine;40;1;12;212;Orthevielle;1028;17;1045
75;Nouvelle-Aquitaine;40;1;14;213;Orx;640;13;653
75;Nouvelle-Aquitaine;40;1;12;214;Ossages;499;6;505
75;Nouvelle-Aquitaine;40;2;13;215;Ousse-Suzan;286;8;294
75;Nouvelle-Aquitaine;40;1;04;216;Ozourt;197;2;199
75;Nouvelle-Aquitaine;40;2;07;217;Parentis-en-Born;6928;195;7123
75;Nouvelle-Aquitaine;40;2;08;218;Parleboscq;488;13;501
75;Nouvelle-Aquitaine;40;2;02;219;Payros-Cazautets;107;2;109
75;Nouvelle-Aquitaine;40;2;02;220;Pécorade;138;2;140
75;Nouvelle-Aquitaine;40;2;01;221;Perquie;339;4;343
75;Nouvelle-Aquitaine;40;1;12;222;Pey;744;14;758
75;Nouvelle-Aquitaine;40;2;02;223;Peyre;230;7;237
75;Nouvelle-Aquitaine;40;1;12;224;Peyrehorade;3637;184;3821
75;Nouvelle-Aquitaine;40;2;02;225;Philondenx;196;2;198
75;Nouvelle-Aquitaine;40;2;02;226;Pimbo;203;3;206
75;Nouvelle-Aquitaine;40;2;07;227;Pissos;1453;20;1473
75;Nouvelle-Aquitaine;40;1;04;228;Pomarez;1579;29;1608
75;Nouvelle-Aquitaine;40;2;03;229;Pontenx-les-Forges;1673;33;1706
75;Nouvelle-Aquitaine;40;1;13;230;Pontonx-sur-l'Adour;2899;98;2997
75;Nouvelle-Aquitaine;40;1;12;231;Port-de-Lanne;1195;33;1228
75;Nouvelle-Aquitaine;40;2;02;232;Poudenx;220;10;230
75;Nouvelle-Aquitaine;40;1;12;233;Pouillon;3105;64;3169
75;Nouvelle-Aquitaine;40;2;10;234;Pouydesseaux;899;28;927
75;Nouvelle-Aquitaine;40;1;04;235;Poyanne;693;19;712
75;Nouvelle-Aquitaine;40;1;04;236;Poyartin;781;19;800
75;Nouvelle-Aquitaine;40;1;04;237;Préchacq-les-Bains;776;6;782
75;Nouvelle-Aquitaine;40;2;01;238;Pujo-le-Plan;623;18;641
75;Nouvelle-Aquitaine;40;2;02;239;Puyol-Cazalet;104;3;107
75;Nouvelle-Aquitaine;40;2;01;240;Renung;507;18;525
75;Nouvelle-Aquitaine;40;2;08;242;Rimbez-et-Baudiets;104;0;104
75;Nouvelle-Aquitaine;40;1;13;243;Rion-des-Landes;3065;41;3106
75;Nouvelle-Aquitaine;40;1;05;244;Rivière-Saas-et-Gourby;1324;30;1354
75;Nouvelle-Aquitaine;40;2;08;245;Roquefort;1927;35;1962
75;Nouvelle-Aquitaine;40;2;08;246;Sabres;1163;149;1312
75;Nouvelle-Aquitaine;40;2;01;247;Saint-Agnet;179;6;185
75;Nouvelle-Aquitaine;40;1;15;248;Saint-André-de-Seignanx;1890;28;1918
75;Nouvelle-Aquitaine;40;1;04;249;Saint-Aubin;501;12;513
75;Nouvelle-Aquitaine;40;2;10;250;Saint-Avit;703;22;725
75;Nouvelle-Aquitaine;40;1;15;251;Saint-Barthélemy;420;14;434
75;Nouvelle-Aquitaine;40;2;02;252;Sainte-Colombe;630;15;645
75;Nouvelle-Aquitaine;40;2;02;253;Saint-Cricq-Chalosse;647;11;658
75;Nouvelle-Aquitaine;40;1;12;254;Saint-Cricq-du-Gave;431;12;443
75;Nouvelle-Aquitaine;40;2;01;255;Saint-Cricq-Villeneuve;469;11;480
75;Nouvelle-Aquitaine;40;1;12;256;Saint-Étienne-d'Orthe;713;16;729
75;Nouvelle-Aquitaine;40;2;07;257;Sainte-Eulalie-en-Born;1340;31;1371
75;Nouvelle-Aquitaine;40;2;01;258;Sainte-Foy;252;3;255
75;Nouvelle-Aquitaine;40;2;01;259;Saint-Gein;428;14;442
75;Nouvelle-Aquitaine;40;1;04;260;Saint-Geours-d'Auribat;417;7;424
75;Nouvelle-Aquitaine;40;1;09;261;Saint-Geours-de-Maremne;2812;50;2862
75;Nouvelle-Aquitaine;40;2;08;262;Saint-Gor;317;6;323
75;Nouvelle-Aquitaine;40;1;04;263;Saint-Jean-de-Lier;411;7;418
75;Nouvelle-Aquitaine;40;1;14;264;Saint-Jean-de-Marsacq;1755;25;1780
75;Nouvelle-Aquitaine;40;2;08;265;Saint-Julien-d'Armagnac;111;0;111
75;Nouvelle-Aquitaine;40;1;03;266;Saint-Julien-en-Born;1687;35;1722
75;Nouvelle-Aquitaine;40;2;08;267;Saint-Justin;1008;13;1021
75;Nouvelle-Aquitaine;40;1;15;268;Saint-Laurent-de-Gosse;699;22;721
75;Nouvelle-Aquitaine;40;1;12;269;Saint-Lon-les-Mines;1233;38;1271
75;Nouvelle-Aquitaine;40;2;01;270;Saint-Loubouer;442;13;455
75;Nouvelle-Aquitaine;40;1;14;271;Sainte-Marie-de-Gosse;1201;25;1226
75;Nouvelle-Aquitaine;40;1;14;272;Saint-Martin-de-Hinx;1659;41;1700
75;Nouvelle-Aquitaine;40;1;15;273;Saint-Martin-de-Seignanx;6033;137;6170
75;Nouvelle-Aquitaine;40;2;10;274;Saint-Martin-d'Oney;1370;40;1410
75;Nouvelle-Aquitaine;40;2;01;275;Saint-Maurice-sur-Adour;617;19;636
75;Nouvelle-Aquitaine;40;1;03;276;Saint-Michel-Escalus;316;8;324
75;Nouvelle-Aquitaine;40;1;06;277;Saint-Pandelon;713;50;763
75;Nouvelle-Aquitaine;40;2;03;278;Saint-Paul-en-Born;977;16;993
75;Nouvelle-Aquitaine;40;1;05;279;Saint-Paul-lès-Dax;14126;483;14609
75;Nouvelle-Aquitaine;40;2;11;280;Saint-Perdon;1722;32;1754
75;Nouvelle-Aquitaine;40;2;11;281;Saint-Pierre-du-Mont;9726;361;10087
75;Nouvelle-Aquitaine;40;2;02;282;Saint-Sever;4927;119;5046
75;Nouvelle-Aquitaine;40;1;05;283;Saint-Vincent-de-Paul;3337;187;3524
75;Nouvelle-Aquitaine;40;1;14;284;Saint-Vincent-de-Tyrosse;7798;248;8046
75;Nouvelle-Aquitaine;40;1;13;285;Saint-Yaguen;625;14;639
75;Nouvelle-Aquitaine;40;2;02;286;Samadet;1131;24;1155
75;Nouvelle-Aquitaine;40;2;07;287;Sanguinet;4487;66;4553
75;Nouvelle-Aquitaine;40;2;08;288;Sarbazan;1153;23;1176
75;Nouvelle-Aquitaine;40;2;02;289;Sarraziet;254;1;255
75;Nouvelle-Aquitaine;40;2;01;290;Sarron;107;3;110
75;Nouvelle-Aquitaine;40;1;14;291;Saubion;1780;33;1813
75;Nouvelle-Aquitaine;40;1;14;292;Saubrigues;1543;73;1616
75;Nouvelle-Aquitaine;40;1;09;293;Saubusse;1100;22;1122
75;Nouvelle-Aquitaine;40;1;06;294;Saugnac-et-Cambran;1569;33;1602
75;Nouvelle-Aquitaine;40;2;07;295;Saugnac-et-Muret;1130;19;1149
75;Nouvelle-Aquitaine;40;1;09;296;Seignosse;3890;96;3986
75;Nouvelle-Aquitaine;40;2;08;297;Le Sen;233;3;236
75;Nouvelle-Aquitaine;40;2;02;298;Serres-Gaston;398;12;410
75;Nouvelle-Aquitaine;40;2;02;299;Serreslous-et-Arribans;189;11;200
75;Nouvelle-Aquitaine;40;1;06;300;Seyresse;996;35;1031
75;Nouvelle-Aquitaine;40;1;05;301;Siest;138;5;143
75;Nouvelle-Aquitaine;40;2;08;303;Solférino;335;2;337
75;Nouvelle-Aquitaine;40;1;09;304;Soorts-Hossegor;3497;87;3584
75;Nouvelle-Aquitaine;40;2;02;305;Sorbets;191;8;199
75;Nouvelle-Aquitaine;40;1;12;306;Sorde-l'Abbaye;619;13;632
75;Nouvelle-Aquitaine;40;2;08;307;Sore;1156;23;1179
75;Nouvelle-Aquitaine;40;1;04;308;Sort-en-Chalosse;889;26;915
75;Nouvelle-Aquitaine;40;1;13;309;Souprosse;1134;19;1153
75;Nouvelle-Aquitaine;40;1;09;310;Soustons;8318;204;8522
75;Nouvelle-Aquitaine;40;1;03;311;Taller;655;14;669
75;Nouvelle-Aquitaine;40;1;15;312;Tarnos;12914;320;13234
75;Nouvelle-Aquitaine;40;1;13;313;Tartas;3209;46;3255
75;Nouvelle-Aquitaine;40;1;05;314;Tercis-les-Bains;1283;25;1308
75;Nouvelle-Aquitaine;40;1;05;315;Téthieu;777;11;788
75;Nouvelle-Aquitaine;40;1;12;316;Tilh;836;19;855
75;Nouvelle-Aquitaine;40;1;09;317;Tosse;3308;82;3390
75;Nouvelle-Aquitaine;40;1;04;318;Toulouzette;323;6;329
75;Nouvelle-Aquitaine;40;2;08;319;Trensacq;255;7;262
75;Nouvelle-Aquitaine;40;2;10;320;Uchacq-et-Parentis;602;14;616
75;Nouvelle-Aquitaine;40;2;02;321;Urgons;243;9;252
75;Nouvelle-Aquitaine;40;1;03;322;Uza;203;2;205
75;Nouvelle-Aquitaine;40;2;08;323;Vert;246;5;251
75;Nouvelle-Aquitaine;40;1;04;324;Vicq-d'Auribat;258;10;268
75;Nouvelle-Aquitaine;40;2;01;325;Vielle-Tursan;278;11;289
75;Nouvelle-Aquitaine;40;1;03;326;Vielle-Saint-Girons;1438;34;1472
75;Nouvelle-Aquitaine;40;2;08;327;Vielle-Soubiran;224;5;229
75;Nouvelle-Aquitaine;40;1;09;328;Vieux-Boucau-les-Bains;1637;33;1670
75;Nouvelle-Aquitaine;40;2;01;329;Le Vignau;479;6;485
75;Nouvelle-Aquitaine;40;1;13;330;Villenave;311;8;319
75;Nouvelle-Aquitaine;40;2;01;331;Villeneuve-de-Marsan;2445;47;2492
75;Nouvelle-Aquitaine;40;2;07;332;Ychoux;2323;56;2379
75;Nouvelle-Aquitaine;40;2;13;333;Ygos-Saint-Saturnin;1344;26;1370
75;Nouvelle-Aquitaine;40;1;06;334;Yzosse;377;13;390
24;Centre-Val de Loire;41;2;06;001;Ambloy;190;5;195
24;Centre-Val de Loire;41;3;11;002;Angé;812;21;833
24;Centre-Val de Loire;41;2;14;003;Areines;590;198;788
24;Centre-Val de Loire;41;2;06;004;Artins;264;5;269
24;Centre-Val de Loire;41;1;01;006;Autainville;444;8;452
24;Centre-Val de Loire;41;2;06;007;Authon;742;13;755
24;Centre-Val de Loire;41;1;01;008;Avaray;718;20;738
24;Centre-Val de Loire;41;1;08;009;Averdon;683;17;700
24;Centre-Val de Loire;41;2;14;010;Azé;1005;29;1034
24;Centre-Val de Loire;41;2;09;012;Baillou;204;12;216
24;Centre-Val de Loire;41;1;05;013;Bauzy;273;4;277
24;Centre-Val de Loire;41;2;09;014;Beauchêne;160;2;162
24;Centre-Val de Loire;41;3;12;016;Billy;1056;15;1071
24;Centre-Val de Loire;41;1;01;017;Binas;653;19;672
24;Centre-Val de Loire;41;1;99;018;Blois;46660;1467;48127
24;Centre-Val de Loire;41;1;01;019;Boisseau;93;2;95
24;Centre-Val de Loire;41;2;09;020;Bonneveau;458;5;463
24;Centre-Val de Loire;41;2;09;022;Bouffry;132;2;134
24;Centre-Val de Loire;41;2;09;024;Boursay;180;7;187
24;Centre-Val de Loire;41;1;05;025;Bracieux;1321;17;1338
24;Centre-Val de Loire;41;2;09;026;Brévainville;170;3;173
24;Centre-Val de Loire;41;1;01;027;Briou;143;2;145
24;Centre-Val de Loire;41;2;09;028;Busloup;482;9;491
24;Centre-Val de Loire;41;1;04;029;Candé-sur-Beuvron;1504;25;1529
24;Centre-Val de Loire;41;2;09;030;Cellé;226;4;230
24;Centre-Val de Loire;41;1;15;031;Cellettes;2671;71;2742
24;Centre-Val de Loire;41;1;04;032;Chailles;2683;79;2762
24;Centre-Val de Loire;41;1;05;034;Chambord;92;1;93
24;Centre-Val de Loire;41;1;08;035;Champigny-en-Beauce;619;13;632
24;Centre-Val de Loire;41;3;13;036;Chaon;450;8;458
24;Centre-Val de Loire;41;2;09;037;La Chapelle-Enchérie;210;4;214
24;Centre-Val de Loire;41;3;12;038;La Chapelle-Montmartin;411;12;423
24;Centre-Val de Loire;41;1;01;039;La Chapelle-Saint-Martin-en-Plaine;684;19;703
24;Centre-Val de Loire;41;1;08;040;La Chapelle-Vendômoise;800;27;827
24;Centre-Val de Loire;41;2;09;041;La Chapelle-Vicomtesse;158;3;161
24;Centre-Val de Loire;41;3;11;042;Châteauvieux;534;4;538
24;Centre-Val de Loire;41;3;11;043;Châtillon-sur-Cher;1679;34;1713
24;Centre-Val de Loire;41;3;12;044;Châtres-sur-Cher;1110;14;1124
24;Centre-Val de Loire;41;1;04;045;Chaumont-sur-Loire;1082;22;1104
24;Centre-Val de Loire;41;3;13;046;Chaumont-sur-Tharonne;1064;22;1086
24;Centre-Val de Loire;41;1;03;047;La Chaussée-Saint-Victor;4519;113;4632
24;Centre-Val de Loire;41;2;09;048;Chauvigny-du-Perche;229;4;233
24;Centre-Val de Loire;41;3;11;049;Chémery;935;13;948
24;Centre-Val de Loire;41;1;15;050;Cheverny;918;39;957
24;Centre-Val de Loire;41;3;07;051;Chissay-en-Touraine;1075;26;1101
24;Centre-Val de Loire;41;1;15;052;Chitenay;1112;33;1145
24;Centre-Val de Loire;41;2;09;053;Choue;527;10;537
24;Centre-Val de Loire;41;3;07;054;Choussy;342;5;347
24;Centre-Val de Loire;41;1;08;055;Valloire-sur-Cisse;2401;54;2455
24;Centre-Val de Loire;41;1;01;057;Conan;167;6;173
24;Centre-Val de Loire;41;1;01;058;Concriers;188;5;193
24;Centre-Val de Loire;41;3;89;059;Le Controis-en-Sologne;6663;154;6817
24;Centre-Val de Loire;41;2;09;060;Cormenon;711;10;721
24;Centre-Val de Loire;41;1;15;061;Cormeray;1553;26;1579
24;Centre-Val de Loire;41;3;07;062;Couddes;545;12;557
24;Centre-Val de Loire;41;3;11;063;Couffy;494;8;502
24;Centre-Val de Loire;41;2;06;065;Coulommiers-la-Tour;574;17;591
24;Centre-Val de Loire;41;1;01;066;Courbouzon;431;15;446
24;Centre-Val de Loire;41;1;15;067;Cour-Cheverny;2781;77;2858
24;Centre-Val de Loire;41;3;05;068;Courmemin;498;9;507
24;Centre-Val de Loire;41;1;01;069;Cour-sur-Loire;249;6;255
24;Centre-Val de Loire;41;2;06;070;Vallée-de-Ronsard;518;11;529
24;Centre-Val de Loire;41;1;05;071;Crouy-sur-Cosson;548;12;560
24;Centre-Val de Loire;41;2;06;072;Crucheray;407;16;423
24;Centre-Val de Loire;41;2;09;073;Danzé;677;17;694
24;Centre-Val de Loire;41;3;05;074;Dhuizon;1214;14;1228
24;Centre-Val de Loire;41;2;09;075;Droué;1013;8;1021
24;Centre-Val de Loire;41;1;01;077;Épiais;127;6;133
24;Centre-Val de Loire;41;2;09;078;Épuisay;823;18;841
24;Centre-Val de Loire;41;2;06;079;Les Essarts;101;0;101
24;Centre-Val de Loire;41;3;07;080;Faverolles-sur-Cher;1397;28;1425
24;Centre-Val de Loire;41;2;06;081;Faye;225;5;230
24;Centre-Val de Loire;41;3;05;083;La Ferté-Beauharnais;560;4;564
24;Centre-Val de Loire;41;3;13;084;La Ferté-Imbault;962;25;987
24;Centre-Val de Loire;41;1;05;085;La Ferté-Saint-Cyr;1056;13;1069
24;Centre-Val de Loire;41;1;05;086;Fontaines-en-Sologne;648;8;656
24;Centre-Val de Loire;41;2;09;087;Fontaine-les-Coteaux;328;5;333
24;Centre-Val de Loire;41;2;09;088;Fontaine-Raoul;235;4;239
24;Centre-Val de Loire;41;2;09;089;La Fontenelle;206;2;208
24;Centre-Val de Loire;41;2;09;090;Fortan;254;6;260
24;Centre-Val de Loire;41;1;08;091;Fossé;1307;19;1326
24;Centre-Val de Loire;41;1;08;093;Françay;272;8;280
24;Centre-Val de Loire;41;3;07;094;Fresnes;1173;31;1204
24;Centre-Val de Loire;41;2;09;095;Fréteval;1053;16;1069
24;Centre-Val de Loire;41;2;09;096;Le Gault-du-Perche;335;2;337
24;Centre-Val de Loire;41;3;12;097;Gièvres;2367;31;2398
24;Centre-Val de Loire;41;2;06;098;Gombergean;170;4;174
24;Centre-Val de Loire;41;3;12;099;Gy-en-Sologne;495;12;507
24;Centre-Val de Loire;41;2;06;100;Les Hayes;169;7;176
24;Centre-Val de Loire;41;1;08;101;Herbault;1156;32;1188
24;Centre-Val de Loire;41;2;06;102;Houssay;384;4;388
24;Centre-Val de Loire;41;2;06;103;Huisseau-en-Beauce;413;11;424
24;Centre-Val de Loire;41;1;05;104;Huisseau-sur-Cosson;2322;54;2376
24;Centre-Val de Loire;41;1;01;105;Josnes;856;16;872
24;Centre-Val de Loire;41;3;13;106;Lamotte-Beuvron;4611;55;4666
24;Centre-Val de Loire;41;2;06;107;Lancé;476;6;482
24;Centre-Val de Loire;41;1;08;108;Lancôme;122;1;123
24;Centre-Val de Loire;41;1;08;109;Landes-le-Gaulois;740;19;759
24;Centre-Val de Loire;41;3;12;110;Langon-sur-Cher;830;19;849
24;Centre-Val de Loire;41;3;12;112;Lassay-sur-Croisne;242;9;251
24;Centre-Val de Loire;41;2;06;113;Lavardin;178;8;186
24;Centre-Val de Loire;41;1;01;114;Lestiou;282;6;288
24;Centre-Val de Loire;41;2;09;115;Lignières;398;6;404
24;Centre-Val de Loire;41;2;09;116;Lisle;198;3;201
24;Centre-Val de Loire;41;3;10;118;Loreux;196;4;200
24;Centre-Val de Loire;41;1;01;119;Lorges;342;5;347
24;Centre-Val de Loire;41;2;06;120;Lunay;1250;35;1285
24;Centre-Val de Loire;41;1;01;121;La Madeleine-Villefrouin;32;0;32
24;Centre-Val de Loire;41;3;12;122;Maray;236;5;241
24;Centre-Val de Loire;41;1;01;123;Marchenoir;679;12;691
24;Centre-Val de Loire;41;2;06;124;Marcilly-en-Beauce;332;19;351
24;Centre-Val de Loire;41;3;13;125;Marcilly-en-Gault;717;17;734
24;Centre-Val de Loire;41;3;11;126;Mareuil-sur-Cher;1159;21;1180
24;Centre-Val de Loire;41;3;05;127;La Marolle-en-Sologne;336;4;340
24;Centre-Val de Loire;41;1;08;128;Marolles;717;19;736
24;Centre-Val de Loire;41;1;05;129;Maslives;698;12;710
24;Centre-Val de Loire;41;1;01;130;Maves;669;13;682
24;Centre-Val de Loire;41;2;14;131;Mazangé;819;27;846
24;Centre-Val de Loire;41;3;11;132;Méhers;317;6;323
24;Centre-Val de Loire;41;1;03;134;Menars;630;21;651
24;Centre-Val de Loire;41;3;12;135;Mennetou-sur-Cher;877;12;889
24;Centre-Val de Loire;41;1;01;136;Mer;6211;105;6316
24;Centre-Val de Loire;41;1;08;137;Mesland;570;24;594
24;Centre-Val de Loire;41;2;14;138;Meslay;313;9;322
24;Centre-Val de Loire;41;3;11;139;Meusnes;1093;13;1106
24;Centre-Val de Loire;41;3;10;140;Millançay;718;17;735
24;Centre-Val de Loire;41;2;09;141;Moisy;363;9;372
24;Centre-Val de Loire;41;1;08;142;Valencisse;2331;95;2426
24;Centre-Val de Loire;41;2;09;143;Mondoubleau;1310;47;1357
24;Centre-Val de Loire;41;1;08;144;Monteaux;727;22;749
24;Centre-Val de Loire;41;1;04;145;Monthou-sur-Bièvre;794;20;814
24;Centre-Val de Loire;41;3;07;146;Monthou-sur-Cher;958;14;972
24;Centre-Val de Loire;41;1;04;147;Les Montils;1914;42;1956
24;Centre-Val de Loire;41;1;05;148;Montlivault;1305;33;1338
24;Centre-Val de Loire;41;2;06;149;Montoire-sur-le-Loir;3698;195;3893
24;Centre-Val de Loire;41;1;05;150;Mont-près-Chambord;3309;91;3400
24;Centre-Val de Loire;41;3;07;151;Montrichard Val de Cher;3675;41;3716
24;Centre-Val de Loire;41;3;05;152;Montrieux-en-Sologne;633;12;645
24;Centre-Val de Loire;41;2;06;153;Montrouveau;149;2;151
24;Centre-Val de Loire;41;2;09;154;Morée;1084;27;1111
24;Centre-Val de Loire;41;1;01;155;Muides-sur-Loire;1234;32;1266
24;Centre-Val de Loire;41;1;01;156;Mulsans;527;14;541
24;Centre-Val de Loire;41;3;12;157;Mur-de-Sologne;1517;16;1533
24;Centre-Val de Loire;41;2;06;158;Naveil;2423;59;2482
24;Centre-Val de Loire;41;3;05;159;Neung-sur-Beuvron;1243;16;1259
24;Centre-Val de Loire;41;1;05;160;Neuvy;321;4;325
24;Centre-Val de Loire;41;3;13;161;Nouan-le-Fuzelier;2321;48;2369
24;Centre-Val de Loire;41;2;06;163;Nourray;121;2;123
24;Centre-Val de Loire;41;3;11;164;Noyers-sur-Cher;2708;30;2738
24;Centre-Val de Loire;41;3;07;166;Oisly;385;4;389
24;Centre-Val de Loire;41;1;08;167;Veuzain-sur-Loire;3401;87;3488
24;Centre-Val de Loire;41;3;12;168;Orçay;235;4;239
24;Centre-Val de Loire;41;1;01;171;Oucques La Nouvelle;1702;29;1731
24;Centre-Val de Loire;41;2;09;172;Ouzouer-le-Doyen;224;2;226
24;Centre-Val de Loire;41;1;01;173;Beauce la Romaine;3436;60;3496
24;Centre-Val de Loire;41;2;06;174;Périgny;174;6;180
24;Centre-Val de Loire;41;2;09;175;Pezou;1113;20;1133
24;Centre-Val de Loire;41;3;13;176;Pierrefitte-sur-Sauldre;739;13;752
24;Centre-Val de Loire;41;2;09;177;Le Plessis-Dorin;158;0;158
24;Centre-Val de Loire;41;1;01;178;Le Plessis-l'Échelle;61;2;63
24;Centre-Val de Loire;41;2;09;179;Le Poislay;189;1;190
24;Centre-Val de Loire;41;3;07;180;Pontlevoy;1518;177;1695
24;Centre-Val de Loire;41;3;11;181;Pouillé;801;21;822
24;Centre-Val de Loire;41;2;06;182;Pray;282;11;293
24;Centre-Val de Loire;41;2;06;184;Prunay-Cassereau;601;7;608
24;Centre-Val de Loire;41;3;12;185;Pruniers-en-Sologne;2304;55;2359
24;Centre-Val de Loire;41;2;09;186;Rahart;301;5;306
24;Centre-Val de Loire;41;2;09;187;Renay;176;4;180
24;Centre-Val de Loire;41;1;01;188;Rhodon;117;3;120
24;Centre-Val de Loire;41;1;04;189;Rilly-sur-Loire;474;6;480
24;Centre-Val de Loire;41;2;06;190;Rocé;220;6;226
24;Centre-Val de Loire;41;1;01;191;Roches;67;3;70
24;Centre-Val de Loire;41;2;06;192;Les Roches-l'Évêque;266;3;269
24;Centre-Val de Loire;41;2;09;193;Romilly;140;2;142
24;Centre-Val de Loire;41;3;10;194;Romorantin-Lanthenay;18206;479;18685
24;Centre-Val de Loire;41;3;11;195;Rougeou;148;2;150
24;Centre-Val de Loire;41;2;09;196;Ruan-sur-Egvonne;80;3;83
24;Centre-Val de Loire;41;3;11;198;Saint-Aignan;2839;91;2930
24;Centre-Val de Loire;41;2;06;199;Saint-Amand-Longpré;1205;28;1233
24;Centre-Val de Loire;41;2;14;200;Sainte-Anne;477;29;506
24;Centre-Val de Loire;41;2;06;201;Saint-Arnoult;320;3;323
24;Centre-Val de Loire;41;1;08;203;Saint-Bohaire;492;8;500
24;Centre-Val de Loire;41;1;05;204;Saint-Claude-de-Diray;1789;42;1831
24;Centre-Val de Loire;41;1;08;205;Saint-Cyr-du-Gault;175;2;177
24;Centre-Val de Loire;41;1;03;206;Saint-Denis-sur-Loire;876;26;902
24;Centre-Val de Loire;41;1;05;207;Saint-Dyé-sur-Loire;1141;21;1162
24;Centre-Val de Loire;41;1;08;208;Saint-Étienne-des-Guérets;114;4;118
24;Centre-Val de Loire;41;2;09;209;Saint-Firmin-des-Prés;793;42;835
24;Centre-Val de Loire;41;3;07;211;Saint-Georges-sur-Cher;2735;54;2789
24;Centre-Val de Loire;41;1;15;212;Saint-Gervais-la-Forêt;3166;96;3262
24;Centre-Val de Loire;41;2;06;213;Saint-Gourgon;100;5;105
24;Centre-Val de Loire;41;2;09;214;Saint-Hilaire-la-Gravelle;669;12;681
24;Centre-Val de Loire;41;2;06;215;Saint-Jacques-des-Guérets;96;2;98
24;Centre-Val de Loire;41;2;09;216;Saint-Jean-Froidmentel;543;9;552
24;Centre-Val de Loire;41;3;07;217;Saint-Julien-de-Chédon;751;14;765
24;Centre-Val de Loire;41;3;12;218;Saint-Julien-sur-Cher;764;13;777
24;Centre-Val de Loire;41;1;01;219;Saint-Laurent-des-Bois;322;3;325
24;Centre-Val de Loire;41;1;05;220;Saint-Laurent-Nouan;4299;82;4381
24;Centre-Val de Loire;41;1;01;221;Saint-Léonard-en-Beauce;646;17;663
24;Centre-Val de Loire;41;3;12;222;Saint-Loup;370;6;376
24;Centre-Val de Loire;41;1;08;223;Saint-Lubin-en-Vergonnois;781;10;791
24;Centre-Val de Loire;41;2;09;224;Saint-Marc-du-Cor;178;1;179
24;Centre-Val de Loire;41;2;06;225;Saint-Martin-des-Bois;574;11;585
24;Centre-Val de Loire;41;2;14;226;Saint-Ouen;3056;92;3148
24;Centre-Val de Loire;41;2;06;228;Saint-Rimay;294;3;297
24;Centre-Val de Loire;41;3;11;229;Saint-Romain-sur-Cher;1458;33;1491
24;Centre-Val de Loire;41;1;08;230;Saint-Sulpice-de-Pommeray;1833;56;1889
24;Centre-Val de Loire;41;3;13;231;Saint-Viâtre;1181;27;1208
24;Centre-Val de Loire;41;3;13;232;Salbris;4925;98;5023
24;Centre-Val de Loire;41;1;04;233;Sambin;880;15;895
24;Centre-Val de Loire;41;1;08;234;Santenay;289;9;298
24;Centre-Val de Loire;41;2;09;235;Sargé-sur-Braye;1010;19;1029
24;Centre-Val de Loire;41;2;06;236;Sasnières;90;3;93
24;Centre-Val de Loire;41;3;07;237;Sassay;1055;18;1073
24;Centre-Val de Loire;41;2;09;238;Savigny-sur-Braye;1968;27;1995
24;Centre-Val de Loire;41;3;11;239;Seigy;1002;22;1024
24;Centre-Val de Loire;41;3;13;241;Selles-Saint-Denis;1342;23;1365
24;Centre-Val de Loire;41;3;12;242;Selles-sur-Cher;4459;63;4522
24;Centre-Val de Loire;41;2;06;243;Selommes;808;20;828
24;Centre-Val de Loire;41;1;01;245;Séris;381;5;386
24;Centre-Val de Loire;41;1;04;246;Seur;481;18;499
24;Centre-Val de Loire;41;3;11;247;Soings-en-Sologne;1618;24;1642
24;Centre-Val de Loire;41;2;09;248;Couëtron-au-Perche;1031;22;1053
24;Centre-Val de Loire;41;3;13;249;Souesmes;1042;14;1056
24;Centre-Val de Loire;41;2;09;250;Sougé;481;8;489
24;Centre-Val de Loire;41;3;13;251;Souvigny-en-Sologne;538;9;547
24;Centre-Val de Loire;41;1;01;252;Suèvres;1548;36;1584
24;Centre-Val de Loire;41;1;01;253;Talcy;268;5;273
24;Centre-Val de Loire;41;2;09;254;Le Temple;182;4;186
24;Centre-Val de Loire;41;2;06;255;Ternay;330;6;336
24;Centre-Val de Loire;41;3;12;256;Theillay;1244;16;1260
24;Centre-Val de Loire;41;3;11;258;Thésée;1153;23;1176
24;Centre-Val de Loire;41;2;06;259;Thoré-la-Rochette;824;35;859
24;Centre-Val de Loire;41;1;05;260;Thoury;418;6;424
24;Centre-Val de Loire;41;2;06;261;Tourailles;132;3;135
24;Centre-Val de Loire;41;1;05;262;Tour-en-Sologne;1119;15;1134
24;Centre-Val de Loire;41;2;06;265;Troo;281;11;292
24;Centre-Val de Loire;41;1;04;266;Valaire;83;3;86
24;Centre-Val de Loire;41;3;07;267;Vallières-les-Grandes;941;16;957
24;Centre-Val de Loire;41;3;10;268;Veilleins;157;2;159
24;Centre-Val de Loire;41;2;14;269;Vendôme;15680;627;16307
24;Centre-Val de Loire;41;3;10;271;Vernou-en-Sologne;606;14;620
24;Centre-Val de Loire;41;1;01;273;Vievy-le-Rayé;457;8;465
24;Centre-Val de Loire;41;2;06;274;Villavard;126;0;126
24;Centre-Val de Loire;41;2;09;275;La Ville-aux-Clercs;1253;25;1278
24;Centre-Val de Loire;41;1;03;276;Villebarou;2490;81;2571
24;Centre-Val de Loire;41;2;09;277;Villebout;118;0;118
24;Centre-Val de Loire;41;2;06;278;Villechauve;258;7;265
24;Centre-Val de Loire;41;2;06;279;Villedieu-le-Château;390;6;396
24;Centre-Val de Loire;41;3;12;280;Villefranche-sur-Cher;2647;66;2713
24;Centre-Val de Loire;41;1;08;281;Villefrancœur;422;9;431
24;Centre-Val de Loire;41;3;10;282;Villeherviers;428;11;439
24;Centre-Val de Loire;41;2;06;283;Villemardy;272;4;276
24;Centre-Val de Loire;41;1;01;284;Villeneuve-Frouville;64;2;66
24;Centre-Val de Loire;41;3;05;285;Villeny;487;4;491
24;Centre-Val de Loire;41;2;06;286;Villeporcher;149;5;154
24;Centre-Val de Loire;41;2;06;287;Villerable;498;13;511
24;Centre-Val de Loire;41;1;03;288;Villerbon;810;16;826
24;Centre-Val de Loire;41;1;01;289;Villermain;388;9;397
24;Centre-Val de Loire;41;2;06;290;Villeromain;234;0;234
24;Centre-Val de Loire;41;2;06;291;Villetrun;318;4;322
24;Centre-Val de Loire;41;1;01;292;Villexanton;200;1;201
24;Centre-Val de Loire;41;2;06;293;Villiersfaux;247;5;252
24;Centre-Val de Loire;41;2;14;294;Villiers-sur-Loir;1117;59;1176
24;Centre-Val de Loire;41;1;15;295;Vineuil;8084;202;8286
24;Centre-Val de Loire;41;3;13;296;Vouzon;1453;32;1485
24;Centre-Val de Loire;41;3;13;297;Yvoy-le-Marron;780;6;786
84;Auvergne-Rhône-Alpes;42;1;20;001;Aboën;462;6;468
84;Auvergne-Rhône-Alpes;42;1;02;002;Ailleux;178;2;180
84;Auvergne-Rhône-Alpes;42;2;09;003;Ambierle;1898;46;1944
84;Auvergne-Rhône-Alpes;42;3;01;005;Andrézieux-Bouthéon;10108;151;10259
84;Auvergne-Rhône-Alpes;42;1;20;006;Apinac;397;9;406
84;Auvergne-Rhône-Alpes;42;2;03;007;Arcinges;216;5;221
84;Auvergne-Rhône-Alpes;42;2;09;008;Arcon;111;1;112
84;Auvergne-Rhône-Alpes;42;1;02;009;Arthun;525;5;530
84;Auvergne-Rhône-Alpes;42;1;01;010;Aveizieux;1678;24;1702
84;Auvergne-Rhône-Alpes;42;2;04;011;Balbigny;2837;55;2892
84;Auvergne-Rhône-Alpes;42;1;07;012;Bard;682;23;705
84;Auvergne-Rhône-Alpes;42;1;01;013;Bellegarde-en-Forez;1987;49;2036
84;Auvergne-Rhône-Alpes;42;2;03;014;Belleroche;314;8;322
84;Auvergne-Rhône-Alpes;42;2;03;015;Belmont-de-la-Loire;1467;23;1490
84;Auvergne-Rhône-Alpes;42;2;03;016;La Bénisson-Dieu;423;9;432
84;Auvergne-Rhône-Alpes;42;3;08;017;Le Bessat;479;7;486
84;Auvergne-Rhône-Alpes;42;3;08;018;Bessey;460;11;471
84;Auvergne-Rhône-Alpes;42;1;02;019;Boën-sur-Lignon;3025;67;3092
84;Auvergne-Rhône-Alpes;42;1;01;020;Boisset-lès-Montrond;1185;24;1209
84;Auvergne-Rhône-Alpes;42;1;07;021;Boisset-Saint-Priest;1259;10;1269
84;Auvergne-Rhône-Alpes;42;1;20;022;Bonson;4215;57;4272
84;Auvergne-Rhône-Alpes;42;3;08;023;Bourg-Argental;2950;60;3010
84;Auvergne-Rhône-Alpes;42;2;03;025;Boyer;197;4;201
84;Auvergne-Rhône-Alpes;42;2;03;026;Briennon;1719;35;1754
84;Auvergne-Rhône-Alpes;42;2;02;027;Bully;398;8;406
84;Auvergne-Rhône-Alpes;42;3;08;028;Burdignes;384;9;393
84;Auvergne-Rhône-Alpes;42;2;04;029;Bussières;1512;47;1559
84;Auvergne-Rhône-Alpes;42;1;02;030;Bussy-Albieux;537;3;540
84;Auvergne-Rhône-Alpes;42;3;06;031;Caloire;306;7;313
84;Auvergne-Rhône-Alpes;42;3;21;032;Cellieu;1701;23;1724
84;Auvergne-Rhône-Alpes;42;2;03;033;Le Cergne;624;25;649
84;Auvergne-Rhône-Alpes;42;1;02;034;Cervières;105;7;112
84;Auvergne-Rhône-Alpes;42;1;02;035;Cezay;209;9;218
84;Auvergne-Rhône-Alpes;42;3;21;036;Chagnon;505;15;520
84;Auvergne-Rhône-Alpes;42;1;07;037;Chalain-d'Uzore;610;24;634
84;Auvergne-Rhône-Alpes;42;1;07;038;Chalain-le-Comtal;721;11;732
84;Auvergne-Rhône-Alpes;42;1;02;039;Chalmazel-Jeansagnière;453;5;458
84;Auvergne-Rhône-Alpes;42;1;02;040;La Chamba;46;2;48
84;Auvergne-Rhône-Alpes;42;1;05;041;Chambéon;639;6;645
84;Auvergne-Rhône-Alpes;42;1;20;042;Chambles;1054;20;1074
84;Auvergne-Rhône-Alpes;42;1;01;043;Chambœuf;1812;36;1848
84;Auvergne-Rhône-Alpes;42;3;15;044;Le Chambon-Feugerolles;11857;87;11944
84;Auvergne-Rhône-Alpes;42;1;02;045;La Chambonie;39;1;40
84;Auvergne-Rhône-Alpes;42;1;02;046;Champdieu;1978;45;2023
84;Auvergne-Rhône-Alpes;42;2;09;047;Champoly;324;2;326
84;Auvergne-Rhône-Alpes;42;2;03;048;Chandon;1475;30;1505
84;Auvergne-Rhône-Alpes;42;2;09;049;Changy;662;21;683
84;Auvergne-Rhône-Alpes;42;1;07;050;La Chapelle-en-Lafaye;138;3;141
84;Auvergne-Rhône-Alpes;42;3;08;051;La Chapelle-Villars;536;14;550
84;Auvergne-Rhône-Alpes;42;2;03;052;Charlieu;3714;96;3810
84;Auvergne-Rhône-Alpes;42;3;10;053;Châteauneuf;1651;19;1670
84;Auvergne-Rhône-Alpes;42;1;02;054;Châtelneuf;355;7;362
84;Auvergne-Rhône-Alpes;42;1;05;055;Châtelus;133;8;141
84;Auvergne-Rhône-Alpes;42;3;08;056;Chavanay;2885;50;2935
84;Auvergne-Rhône-Alpes;42;1;07;058;Chazelles-sur-Lavieu;254;7;261
84;Auvergne-Rhône-Alpes;42;1;05;059;Chazelles-sur-Lyon;5436;94;5530
84;Auvergne-Rhône-Alpes;42;1;07;060;Chenereilles;524;6;530
84;Auvergne-Rhône-Alpes;42;2;09;061;Cherier;553;14;567
84;Auvergne-Rhône-Alpes;42;1;05;062;Chevrières;1158;25;1183
84;Auvergne-Rhône-Alpes;42;2;04;063;Chirassimont;399;9;408
84;Auvergne-Rhône-Alpes;42;3;08;064;Chuyer;754;30;784
84;Auvergne-Rhône-Alpes;42;1;05;065;Civens;1415;53;1468
84;Auvergne-Rhône-Alpes;42;1;05;066;Cleppé;521;11;532
84;Auvergne-Rhône-Alpes;42;3;08;067;Colombier;297;3;300
84;Auvergne-Rhône-Alpes;42;2;03;068;Combre;419;11;430
84;Auvergne-Rhône-Alpes;42;2;04;069;Commelle-Vernay;3018;88;3106
84;Auvergne-Rhône-Alpes;42;2;04;070;Cordelle;925;24;949
84;Auvergne-Rhône-Alpes;42;2;04;071;Le Coteau;6886;134;7020
84;Auvergne-Rhône-Alpes;42;1;02;072;La Côte-en-Couzan;64;1;65
84;Auvergne-Rhône-Alpes;42;1;05;073;Cottance;741;18;759
84;Auvergne-Rhône-Alpes;42;2;03;074;Coutouvre;1075;27;1102
84;Auvergne-Rhône-Alpes;42;1;01;075;Craintilleux;1356;14;1370
84;Auvergne-Rhône-Alpes;42;2;09;076;Cremeaux;912;23;935
84;Auvergne-Rhône-Alpes;42;2;04;077;Croizet-sur-Gand;304;6;310
84;Auvergne-Rhône-Alpes;42;2;09;078;Le Crozet;248;10;258
84;Auvergne-Rhône-Alpes;42;2;03;079;Cuinzier;709;13;722
84;Auvergne-Rhône-Alpes;42;1;01;081;Cuzieu;1547;18;1565
84;Auvergne-Rhône-Alpes;42;3;10;083;Dargoire;529;4;533
84;Auvergne-Rhône-Alpes;42;1;02;084;Débats-Rivière-d'Orpra;160;4;164
84;Auvergne-Rhône-Alpes;42;3;08;085;Doizieux;843;14;857
84;Auvergne-Rhône-Alpes;42;2;03;086;Écoche;516;13;529
84;Auvergne-Rhône-Alpes;42;1;07;087;Écotay-l'Olme;1230;53;1283
84;Auvergne-Rhône-Alpes;42;1;05;088;Épercieux-Saint-Paul;755;17;772
84;Auvergne-Rhône-Alpes;42;1;02;089;Essertines-en-Châtelneuf;652;28;680
84;Auvergne-Rhône-Alpes;42;1;05;090;Essertines-en-Donzy;490;8;498
84;Auvergne-Rhône-Alpes;42;1;20;091;Estivareilles;684;12;696
84;Auvergne-Rhône-Alpes;42;3;21;092;L'Étrat;2702;110;2812
84;Auvergne-Rhône-Alpes;42;3;10;093;Farnay;1364;20;1384
84;Auvergne-Rhône-Alpes;42;1;05;094;Feurs;8352;136;8488
84;Auvergne-Rhône-Alpes;42;3;06;095;Firminy;16953;173;17126
84;Auvergne-Rhône-Alpes;42;3;21;096;Fontanès;683;11;694
84;Auvergne-Rhône-Alpes;42;3;21;097;La Fouillouse;4690;65;4755
84;Auvergne-Rhône-Alpes;42;2;04;098;Fourneaux;579;14;593
84;Auvergne-Rhône-Alpes;42;3;06;099;Fraisses;3732;54;3786
84;Auvergne-Rhône-Alpes;42;1;05;100;La Gimond;279;10;289
84;Auvergne-Rhône-Alpes;42;3;08;101;Graix;141;2;143
84;Auvergne-Rhône-Alpes;42;1;05;102;Grammond;882;22;904
84;Auvergne-Rhône-Alpes;42;3;10;103;La Grand-Croix;5100;37;5137
84;Auvergne-Rhône-Alpes;42;2;03;104;La Gresle;867;21;888
84;Auvergne-Rhône-Alpes;42;1;07;105;Grézieux-le-Fromental;254;4;258
84;Auvergne-Rhône-Alpes;42;2;02;106;Grézolles;243;7;250
84;Auvergne-Rhône-Alpes;42;1;07;107;Gumières;320;9;329
84;Auvergne-Rhône-Alpes;42;1;07;108;L'Hôpital-le-Grand;1112;14;1126
84;Auvergne-Rhône-Alpes;42;1;02;109;L'Hôpital-sous-Rochefort;108;1;109
84;Auvergne-Rhône-Alpes;42;3;13;110;L'Horme;4766;40;4806
84;Auvergne-Rhône-Alpes;42;2;03;112;Jarnosse;414;8;422
84;Auvergne-Rhône-Alpes;42;1;05;113;Jas;239;6;245
84;Auvergne-Rhône-Alpes;42;3;08;115;Jonzieux;1226;15;1241
84;Auvergne-Rhône-Alpes;42;2;09;116;Juré;246;9;255
84;Auvergne-Rhône-Alpes;42;1;07;117;Lavieu;112;8;120
84;Auvergne-Rhône-Alpes;42;2;04;118;Lay;754;18;772
84;Auvergne-Rhône-Alpes;42;1;02;119;Leigneux;361;10;371
84;Auvergne-Rhône-Alpes;42;2;09;120;Lentigny;1798;38;1836
84;Auvergne-Rhône-Alpes;42;1;07;121;Lérigneux;163;2;165
84;Auvergne-Rhône-Alpes;42;1;07;122;Lézigneux;1725;78;1803
84;Auvergne-Rhône-Alpes;42;3;10;123;Lorette;4746;28;4774
84;Auvergne-Rhône-Alpes;42;3;08;124;Lupé;299;6;305
84;Auvergne-Rhône-Alpes;42;2;02;125;Luré;140;2;142
84;Auvergne-Rhône-Alpes;42;1;07;126;Luriecq;1271;28;1299
84;Auvergne-Rhône-Alpes;42;2;11;127;Mably;7517;133;7650
84;Auvergne-Rhône-Alpes;42;2;04;128;Machézal;395;7;402
84;Auvergne-Rhône-Alpes;42;3;08;129;Maclas;1827;68;1895
84;Auvergne-Rhône-Alpes;42;1;07;130;Magneux-Haute-Rive;567;9;576
84;Auvergne-Rhône-Alpes;42;2;03;131;Maizilly;330;8;338
84;Auvergne-Rhône-Alpes;42;3;08;132;Malleval;562;16;578
84;Auvergne-Rhône-Alpes;42;3;21;133;Marcenod;693;19;712
84;Auvergne-Rhône-Alpes;42;1;02;134;Marcilly-le-Châtel;1386;47;1433
84;Auvergne-Rhône-Alpes;42;1;05;135;Marclopt;543;28;571
84;Auvergne-Rhône-Alpes;42;1;02;136;Marcoux;780;33;813
84;Auvergne-Rhône-Alpes;42;1;07;137;Margerie-Chantagret;804;15;819
84;Auvergne-Rhône-Alpes;42;1;05;138;Maringes;672;21;693
84;Auvergne-Rhône-Alpes;42;3;08;139;Marlhes;1340;70;1410
84;Auvergne-Rhône-Alpes;42;1;07;140;Marols;456;8;464
84;Auvergne-Rhône-Alpes;42;2;03;141;Mars;571;11;582
84;Auvergne-Rhône-Alpes;42;1;20;142;Merle-Leignec;322;6;328
84;Auvergne-Rhône-Alpes;42;1;05;143;Mizérieux;503;5;508
84;Auvergne-Rhône-Alpes;42;2;03;145;Montagny;1100;20;1120
84;Auvergne-Rhône-Alpes;42;1;07;146;Montarcher;65;3;68
84;Auvergne-Rhône-Alpes;42;1;07;147;Montbrison;15943;602;16545
84;Auvergne-Rhône-Alpes;42;1;05;148;Montchal;501;9;510
84;Auvergne-Rhône-Alpes;42;1;01;149;Montrond-les-Bains;5444;106;5550
84;Auvergne-Rhône-Alpes;42;1;02;150;Montverdun;1358;34;1392
84;Auvergne-Rhône-Alpes;42;1;07;151;Mornand-en-Forez;411;77;488
84;Auvergne-Rhône-Alpes;42;2;03;152;Nandax;559;326;885
84;Auvergne-Rhône-Alpes;42;2;04;153;Neaux;482;8;490
84;Auvergne-Rhône-Alpes;42;2;04;154;Néronde;467;50;517
84;Auvergne-Rhône-Alpes;42;1;05;155;Nervieux;1015;23;1038
84;Auvergne-Rhône-Alpes;42;2;04;156;Neulise;1379;19;1398
84;Auvergne-Rhône-Alpes;42;2;09;157;Noailly;794;13;807
84;Auvergne-Rhône-Alpes;42;2;09;158;Les Noës;211;3;214
84;Auvergne-Rhône-Alpes;42;1;02;159;Noirétable;1577;104;1681
84;Auvergne-Rhône-Alpes;42;2;02;160;Nollieux;188;6;194
84;Auvergne-Rhône-Alpes;42;2;04;161;Notre-Dame-de-Boisset;577;18;595
84;Auvergne-Rhône-Alpes;42;2;09;162;Ouches;1151;19;1170
84;Auvergne-Rhône-Alpes;42;2;09;163;La Pacaudière;1054;19;1073
84;Auvergne-Rhône-Alpes;42;1;02;164;Palogneux;68;0;68
84;Auvergne-Rhône-Alpes;42;1;05;165;Panissières;2883;81;2964
84;Auvergne-Rhône-Alpes;42;2;04;166;Parigny;631;16;647
84;Auvergne-Rhône-Alpes;42;3;08;167;Pavezin;388;10;398
84;Auvergne-Rhône-Alpes;42;3;08;168;Pélussin;3726;103;3829
84;Auvergne-Rhône-Alpes;42;1;20;169;Périgneux;1589;27;1616
84;Auvergne-Rhône-Alpes;42;2;04;170;Perreux;2106;179;2285
84;Auvergne-Rhône-Alpes;42;2;04;171;Pinay;284;7;291
84;Auvergne-Rhône-Alpes;42;3;08;172;Planfoy;1062;25;1087
84;Auvergne-Rhône-Alpes;42;2;02;173;Pommiers-en-Forez;358;9;367
84;Auvergne-Rhône-Alpes;42;1;05;174;Poncins;1168;23;1191
84;Auvergne-Rhône-Alpes;42;1;05;175;Pouilly-lès-Feurs;1207;34;1241
84;Auvergne-Rhône-Alpes;42;2;09;176;Pouilly-les-Nonains;2191;45;2236
84;Auvergne-Rhône-Alpes;42;2;03;177;Pouilly-sous-Charlieu;2562;53;2615
84;Auvergne-Rhône-Alpes;42;2;03;178;Pradines;871;12;883
84;Auvergne-Rhône-Alpes;42;1;02;179;Pralong;863;29;892
84;Auvergne-Rhône-Alpes;42;1;07;180;Précieux;1033;99;1132
84;Auvergne-Rhône-Alpes;42;2;03;181;Régny;1490;30;1520
84;Auvergne-Rhône-Alpes;42;2;09;182;Renaison;3209;107;3316
84;Auvergne-Rhône-Alpes;42;3;15;183;La Ricamarie;7943;47;7990
84;Auvergne-Rhône-Alpes;42;2;12;184;Riorges;10917;244;11161
84;Auvergne-Rhône-Alpes;42;1;01;185;Rivas;715;20;735
84;Auvergne-Rhône-Alpes;42;3;10;186;Rive-de-Gier;15086;122;15208
84;Auvergne-Rhône-Alpes;42;2;98;187;Roanne;34415;737;35152
84;Auvergne-Rhône-Alpes;42;1;07;188;Roche;253;4;257
84;Auvergne-Rhône-Alpes;42;3;16;189;Roche-la-Molière;9878;88;9966
84;Auvergne-Rhône-Alpes;42;3;08;191;Roisey;989;33;1022
84;Auvergne-Rhône-Alpes;42;1;20;192;Rozier-Côtes-d'Aurec;429;5;434
84;Auvergne-Rhône-Alpes;42;1;05;193;Rozier-en-Donzy;1425;37;1462
84;Auvergne-Rhône-Alpes;42;2;09;194;Sail-les-Bains;201;2;203
84;Auvergne-Rhône-Alpes;42;1;02;195;Sail-sous-Couzan;987;20;1007
84;Auvergne-Rhône-Alpes;42;2;04;196;Sainte-Agathe-en-Donzy;116;4;120
84;Auvergne-Rhône-Alpes;42;1;02;197;Sainte-Agathe-la-Bouteresse;1044;31;1075
84;Auvergne-Rhône-Alpes;42;2;09;198;Saint-Alban-les-Eaux;916;26;942
84;Auvergne-Rhône-Alpes;42;2;09;199;Saint-André-d'Apchon;1920;60;1980
84;Auvergne-Rhône-Alpes;42;1;01;200;Saint-André-le-Puy;1518;26;1544
84;Auvergne-Rhône-Alpes;42;3;08;201;Saint-Appolinard;694;29;723
84;Auvergne-Rhône-Alpes;42;1;05;202;Saint-Barthélemy-Lestra;687;16;703
84;Auvergne-Rhône-Alpes;42;2;09;203;Saint-Bonnet-des-Quarts;313;1;314
84;Auvergne-Rhône-Alpes;42;1;20;204;Saint-Bonnet-le-Château;1497;35;1532
84;Auvergne-Rhône-Alpes;42;1;02;205;Saint-Bonnet-le-Courreau;689;15;704
84;Auvergne-Rhône-Alpes;42;1;01;206;Saint-Bonnet-les-Oules;1718;36;1754
84;Auvergne-Rhône-Alpes;42;3;13;207;Saint-Chamond;35309;388;35697
84;Auvergne-Rhône-Alpes;42;3;21;208;Saint-Christo-en-Jarez;1909;45;1954
84;Auvergne-Rhône-Alpes;42;2;04;209;Sainte-Colombe-sur-Gand;390;12;402
84;Auvergne-Rhône-Alpes;42;3;08;210;Sainte-Croix-en-Jarez;477;7;484
84;Auvergne-Rhône-Alpes;42;1;20;211;Saint-Cyprien;2428;34;2462
84;Auvergne-Rhône-Alpes;42;2;04;212;Saint-Cyr-de-Favières;994;30;1024
84;Auvergne-Rhône-Alpes;42;2;04;213;Saint-Cyr-de-Valorges;310;12;322
84;Auvergne-Rhône-Alpes;42;1;05;214;Saint-Cyr-les-Vignes;1048;29;1077
84;Auvergne-Rhône-Alpes;42;2;03;215;Saint-Denis-de-Cabanne;1265;23;1288
84;Auvergne-Rhône-Alpes;42;1;05;216;Saint-Denis-sur-Coise;667;17;684
84;Auvergne-Rhône-Alpes;42;1;02;217;Saint-Didier-sur-Rochefort;456;7;463
84;Auvergne-Rhône-Alpes;42;3;99;218;Saint-Étienne;174082;1934;176016
84;Auvergne-Rhône-Alpes;42;1;02;219;Saint-Étienne-le-Molard;1028;23;1051
84;Auvergne-Rhône-Alpes;42;2;09;220;Saint-Forgeux-Lespinasse;606;19;625
84;Auvergne-Rhône-Alpes;42;1;02;221;Sainte-Foy-Saint-Sulpice;531;9;540
84;Auvergne-Rhône-Alpes;42;1;01;222;Saint-Galmier;5837;129;5966
84;Auvergne-Rhône-Alpes;42;3;16;223;Saint-Genest-Lerpt;6185;67;6252
84;Auvergne-Rhône-Alpes;42;3;08;224;Saint-Genest-Malifaux;2945;144;3089
84;Auvergne-Rhône-Alpes;42;3;10;225;Genilac;3866;87;3953
84;Auvergne-Rhône-Alpes;42;2;02;226;Saint-Georges-de-Baroille;438;3;441
84;Auvergne-Rhône-Alpes;42;1;02;227;Saint-Georges-en-Couzan;408;7;415
84;Auvergne-Rhône-Alpes;42;1;07;228;Saint-Georges-Haute-Ville;1465;26;1491
84;Auvergne-Rhône-Alpes;42;2;03;229;Saint-Germain-la-Montagne;225;6;231
84;Auvergne-Rhône-Alpes;42;2;02;230;Saint-Germain-Laval;1610;34;1644
84;Auvergne-Rhône-Alpes;42;2;09;231;Saint-Germain-Lespinasse;1226;70;1296
84;Auvergne-Rhône-Alpes;42;2;09;232;Saint-Haon-le-Châtel;636;11;647
84;Auvergne-Rhône-Alpes;42;2;09;233;Saint-Haon-le-Vieux;954;24;978
84;Auvergne-Rhône-Alpes;42;3;21;234;Saint-Héand;3659;54;3713
84;Auvergne-Rhône-Alpes;42;1;20;235;Saint-Hilaire-Cusson-la-Valmitte;332;5;337
84;Auvergne-Rhône-Alpes;42;2;03;236;Saint-Hilaire-sous-Charlieu;529;10;539
84;Auvergne-Rhône-Alpes;42;3;18;237;Saint-Jean-Bonnefonds;6633;68;6701
84;Auvergne-Rhône-Alpes;42;1;02;238;Saint-Jean-la-Vêtre;324;11;335
84;Auvergne-Rhône-Alpes;42;2;09;239;Saint-Jean-Saint-Maurice-sur-Loire;1155;24;1179
84;Auvergne-Rhône-Alpes;42;1;07;240;Saint-Jean-Soleymieux;858;20;878
84;Auvergne-Rhône-Alpes;42;2;04;241;Saint-Jodard;391;5;396
84;Auvergne-Rhône-Alpes;42;3;10;242;Saint-Joseph;1949;29;1978
84;Auvergne-Rhône-Alpes;42;2;02;243;Saint-Julien-d'Oddes;288;5;293
84;Auvergne-Rhône-Alpes;42;1;02;245;Vêtre-sur-Anzon;578;13;591
84;Auvergne-Rhône-Alpes;42;3;08;246;Saint-Julien-Molin-Molette;1146;18;1164
84;Auvergne-Rhône-Alpes;42;1;02;247;Saint-Just-en-Bas;282;9;291
84;Auvergne-Rhône-Alpes;42;2;09;248;Saint-Just-en-Chevalet;1125;38;1163
84;Auvergne-Rhône-Alpes;42;2;04;249;Saint-Just-la-Pendue;1661;32;1693
84;Auvergne-Rhône-Alpes;42;1;05;251;Saint-Laurent-la-Conche;579;13;592
84;Auvergne-Rhône-Alpes;42;1;02;252;Saint-Laurent-Rochefort;255;2;257
84;Auvergne-Rhône-Alpes;42;2;12;253;Saint-Léger-sur-Roanne;1161;39;1200
84;Auvergne-Rhône-Alpes;42;2;04;254;Saint-Marcel-de-Félines;792;17;809
84;Auvergne-Rhône-Alpes;42;2;09;255;Saint-Marcel-d'Urfé;278;7;285
84;Auvergne-Rhône-Alpes;42;1;20;256;Saint-Marcellin-en-Forez;5027;51;5078
84;Auvergne-Rhône-Alpes;42;2;09;257;Saint-Martin-d'Estréaux;841;9;850
84;Auvergne-Rhône-Alpes;42;3;10;259;Saint-Martin-la-Plaine;3799;60;3859
84;Auvergne-Rhône-Alpes;42;2;02;260;Saint-Martin-la-Sauveté;887;58;945
84;Auvergne-Rhône-Alpes;42;1;05;261;Saint-Martin-Lestra;907;19;926
84;Auvergne-Rhône-Alpes;42;1;20;262;Saint-Maurice-en-Gourgois;1819;37;1856
84;Auvergne-Rhône-Alpes;42;1;05;264;Saint-Médard-en-Forez;965;24;989
84;Auvergne-Rhône-Alpes;42;3;08;265;Saint-Michel-sur-Rhône;869;25;894
84;Auvergne-Rhône-Alpes;42;1;20;266;Saint-Nizier-de-Fornas;660;14;674
84;Auvergne-Rhône-Alpes;42;2;03;267;Saint-Nizier-sous-Charlieu;1695;45;1740
84;Auvergne-Rhône-Alpes;42;2;02;268;Vézelin-sur-Loire;803;15;818
84;Auvergne-Rhône-Alpes;42;1;07;269;Saint-Paul-d'Uzore;181;2;183
84;Auvergne-Rhône-Alpes;42;3;06;270;Saint-Paul-en-Cornillon;1354;31;1385
84;Auvergne-Rhône-Alpes;42;3;10;271;Saint-Paul-en-Jarez;4793;58;4851
84;Auvergne-Rhône-Alpes;42;3;08;272;Saint-Pierre-de-Bœuf;1697;38;1735
84;Auvergne-Rhône-Alpes;42;2;03;273;Saint-Pierre-la-Noaille;388;7;395
84;Auvergne-Rhône-Alpes;42;2;02;274;Saint-Polgues;263;5;268
84;Auvergne-Rhône-Alpes;42;3;18;275;Saint-Priest-en-Jarez;6088;94;6182
84;Auvergne-Rhône-Alpes;42;2;09;276;Saint-Priest-la-Prugne;424;6;430
84;Auvergne-Rhône-Alpes;42;2;04;277;Saint-Priest-la-Roche;337;0;337
84;Auvergne-Rhône-Alpes;42;1;02;278;Saint-Priest-la-Vêtre;142;1;143
84;Auvergne-Rhône-Alpes;42;1;20;279;Saint-Just-Saint-Rambert;15239;249;15488
84;Auvergne-Rhône-Alpes;42;3;08;280;Saint-Régis-du-Coin;411;11;422
84;Auvergne-Rhône-Alpes;42;2;09;281;Saint-Rirand;132;2;134
84;Auvergne-Rhône-Alpes;42;2;09;282;Saint-Romain-d'Urfé;239;5;244
84;Auvergne-Rhône-Alpes;42;3;21;283;Saint-Romain-en-Jarez;1214;28;1242
84;Auvergne-Rhône-Alpes;42;2;09;284;Saint-Romain-la-Motte;1419;55;1474
84;Auvergne-Rhône-Alpes;42;1;07;285;Saint-Romain-le-Puy;4099;65;4164
84;Auvergne-Rhône-Alpes;42;3;08;286;Saint-Romain-les-Atheux;948;15;963
84;Auvergne-Rhône-Alpes;42;3;08;287;Saint-Sauveur-en-Rue;1086;23;1109
84;Auvergne-Rhône-Alpes;42;1;02;288;Saint-Sixte;699;13;712
84;Auvergne-Rhône-Alpes;42;2;04;289;Saint-Symphorien-de-Lay;1923;62;1985
84;Auvergne-Rhône-Alpes;42;1;07;290;Saint-Thomas-la-Garde;591;19;610
84;Auvergne-Rhône-Alpes;42;2;03;293;Saint-Victor-sur-Rhins;1207;21;1228
84;Auvergne-Rhône-Alpes;42;2;04;294;Saint-Vincent-de-Boisset;979;27;1006
84;Auvergne-Rhône-Alpes;42;1;02;295;Les Salles;561;7;568
84;Auvergne-Rhône-Alpes;42;1;05;296;Salt-en-Donzy;552;15;567
84;Auvergne-Rhône-Alpes;42;1;05;297;Salvizinet;598;30;628
84;Auvergne-Rhône-Alpes;42;1;02;298;Sauvain;373;4;377
84;Auvergne-Rhône-Alpes;42;1;07;299;Savigneux;3448;75;3523
84;Auvergne-Rhône-Alpes;42;2;03;300;Sevelinges;646;15;661
84;Auvergne-Rhône-Alpes;42;1;07;301;Soleymieux;707;9;716
84;Auvergne-Rhône-Alpes;42;3;21;302;Sorbiers;8009;171;8180
84;Auvergne-Rhône-Alpes;42;2;02;303;Souternon;265;6;271
84;Auvergne-Rhône-Alpes;42;1;20;304;Sury-le-Comtal;6706;272;6978
84;Auvergne-Rhône-Alpes;42;3;21;305;La Talaudière;7044;99;7143
84;Auvergne-Rhône-Alpes;42;3;08;306;Tarentaise;492;12;504
84;Auvergne-Rhône-Alpes;42;3;10;307;Tartaras;926;18;944
84;Auvergne-Rhône-Alpes;42;3;08;308;La Terrasse-sur-Dorlay;772;8;780
84;Auvergne-Rhône-Alpes;42;3;08;310;Thélis-la-Combe;144;2;146
84;Auvergne-Rhône-Alpes;42;3;21;311;La Tour-en-Jarez;1462;38;1500
84;Auvergne-Rhône-Alpes;42;1;20;312;La Tourette;623;17;640
84;Auvergne-Rhône-Alpes;42;1;02;313;Trelins;667;20;687
84;Auvergne-Rhône-Alpes;42;2;09;314;La Tuilière;285;2;287
84;Auvergne-Rhône-Alpes;42;1;01;315;Unias;424;14;438
84;Auvergne-Rhône-Alpes;42;3;06;316;Unieux;8448;77;8525
84;Auvergne-Rhône-Alpes;42;2;09;317;Urbise;122;4;126
84;Auvergne-Rhône-Alpes;42;1;20;318;Usson-en-Forez;1490;22;1512
84;Auvergne-Rhône-Alpes;42;1;05;319;Valeille;690;11;701
84;Auvergne-Rhône-Alpes;42;3;21;320;Valfleury;707;10;717
84;Auvergne-Rhône-Alpes;42;1;02;321;La Valla-sur-Rochefort;102;1;103
84;Auvergne-Rhône-Alpes;42;3;08;322;La Valla-en-Gier;1082;26;1108
84;Auvergne-Rhône-Alpes;42;1;01;323;Veauche;9001;106;9107
84;Auvergne-Rhône-Alpes;42;1;01;324;Veauchette;1193;16;1209
84;Auvergne-Rhône-Alpes;42;2;04;325;Vendranges;382;4;386
84;Auvergne-Rhône-Alpes;42;3;08;326;Véranne;898;29;927
84;Auvergne-Rhône-Alpes;42;3;08;327;Vérin;663;14;677
84;Auvergne-Rhône-Alpes;42;1;07;328;Verrières-en-Forez;719;74;793
84;Auvergne-Rhône-Alpes;42;3;08;329;La Versanne;379;5;384
84;Auvergne-Rhône-Alpes;42;3;17;330;Villars;7861;133;7994
84;Auvergne-Rhône-Alpes;42;2;09;331;Villemontais;1024;31;1055
84;Auvergne-Rhône-Alpes;42;2;12;332;Villerest;5097;136;5233
84;Auvergne-Rhône-Alpes;42;2;03;333;Villers;591;13;604
84;Auvergne-Rhône-Alpes;42;2;04;334;Violay;1235;17;1252
84;Auvergne-Rhône-Alpes;42;1;05;335;Viricelles;445;18;463
84;Auvergne-Rhône-Alpes;42;1;05;336;Virigneux;632;17;649
84;Auvergne-Rhône-Alpes;42;2;09;337;Vivans;224;5;229
84;Auvergne-Rhône-Alpes;42;2;03;338;Vougy;1497;63;1560
84;Auvergne-Rhône-Alpes;42;2;09;339;Chausseterre;214;5;219
84;Auvergne-Rhône-Alpes;43;1;17;001;Agnat;174;4;178
84;Auvergne-Rhône-Alpes;43;2;13;002;Aiguilhe;1454;62;1516
84;Auvergne-Rhône-Alpes;43;2;11;003;Allègre;873;18;891
84;Auvergne-Rhône-Alpes;43;2;08;004;Alleyrac;119;7;126
84;Auvergne-Rhône-Alpes;43;2;18;005;Alleyras;153;2;155
84;Auvergne-Rhône-Alpes;43;1;10;006;Ally;128;2;130
84;Auvergne-Rhône-Alpes;43;3;19;007;Araules;604;18;622
84;Auvergne-Rhône-Alpes;43;2;18;008;Arlempdes;142;5;147
84;Auvergne-Rhône-Alpes;43;1;10;009;Arlet;23;0;23
84;Auvergne-Rhône-Alpes;43;2;15;010;Arsac-en-Velay;1200;30;1230
84;Auvergne-Rhône-Alpes;43;1;10;011;Aubazat;180;5;185
84;Auvergne-Rhône-Alpes;43;3;01;012;Aurec-sur-Loire;6166;83;6249
84;Auvergne-Rhône-Alpes;43;1;10;013;Vissac-Auteyrac;303;9;312
84;Auvergne-Rhône-Alpes;43;1;17;014;Autrac;53;2;55
84;Auvergne-Rhône-Alpes;43;1;07;015;Auvers;49;0;49
84;Auvergne-Rhône-Alpes;43;1;17;016;Auzon;905;25;930
84;Auvergne-Rhône-Alpes;43;1;17;017;Azérat;287;7;294
84;Auvergne-Rhône-Alpes;43;2;18;018;Bains;1388;127;1515
84;Auvergne-Rhône-Alpes;43;2;18;019;Barges;110;2;112
84;Auvergne-Rhône-Alpes;43;3;02;020;Bas-en-Basset;4461;69;4530
84;Auvergne-Rhône-Alpes;43;2;06;021;Beaulieu;1043;19;1062
84;Auvergne-Rhône-Alpes;43;1;04;022;Beaumont;270;12;282
84;Auvergne-Rhône-Alpes;43;2;11;023;Beaune-sur-Arzon;207;2;209
84;Auvergne-Rhône-Alpes;43;3;19;024;Beaux;849;14;863
84;Auvergne-Rhône-Alpes;43;3;02;025;Beauzac;2986;69;3055
84;Auvergne-Rhône-Alpes;43;2;16;026;Bellevue-la-Montagne;448;10;458
84;Auvergne-Rhône-Alpes;43;1;11;027;Berbezit;44;0;44
84;Auvergne-Rhône-Alpes;43;3;19;028;Bessamorel;480;16;496
84;Auvergne-Rhône-Alpes;43;1;07;029;La Besseyre-Saint-Mary;99;4;103
84;Auvergne-Rhône-Alpes;43;2;16;030;Blanzac;405;10;415
84;Auvergne-Rhône-Alpes;43;1;10;031;Blassac;134;5;139
84;Auvergne-Rhône-Alpes;43;2;14;032;Blavozy;1703;51;1754
84;Auvergne-Rhône-Alpes;43;1;17;033;Blesle;634;11;645
84;Auvergne-Rhône-Alpes;43;3;02;034;Boisset;358;1;359
84;Auvergne-Rhône-Alpes;43;1;11;035;Bonneval;76;1;77
84;Auvergne-Rhône-Alpes;43;2;16;036;Borne;406;7;413
84;Auvergne-Rhône-Alpes;43;2;18;037;Le Bouchet-Saint-Nicolas;280;7;287
84;Auvergne-Rhône-Alpes;43;1;04;038;Bournoncle-Saint-Pierre;1002;26;1028
84;Auvergne-Rhône-Alpes;43;2;18;039;Le Brignon;610;14;624
84;Auvergne-Rhône-Alpes;43;1;04;040;Brioude;6537;314;6851
84;Auvergne-Rhône-Alpes;43;2;14;041;Brives-Charensac;4238;226;4464
84;Auvergne-Rhône-Alpes;43;2;18;042;Cayres;700;19;719
84;Auvergne-Rhône-Alpes;43;2;16;043;Céaux-d'Allègre;475;7;482
84;Auvergne-Rhône-Alpes;43;1;10;044;Cerzat;207;5;212
84;Auvergne-Rhône-Alpes;43;2;12;045;Ceyssac;431;15;446
84;Auvergne-Rhône-Alpes;43;2;13;046;Chadrac;2429;70;2499
84;Auvergne-Rhône-Alpes;43;2;08;047;Chadron;336;9;345
84;Auvergne-Rhône-Alpes;43;1;11;048;La Chaise-Dieu;608;37;645
84;Auvergne-Rhône-Alpes;43;2;06;049;Chamalières-sur-Loire;497;9;506
84;Auvergne-Rhône-Alpes;43;1;17;050;Chambezon;126;0;126
84;Auvergne-Rhône-Alpes;43;3;08;051;Le Chambon-sur-Lignon;2420;45;2465
84;Auvergne-Rhône-Alpes;43;1;17;052;Champagnac-le-Vieux;190;5;195
84;Auvergne-Rhône-Alpes;43;2;08;053;Champclause;205;3;208
84;Auvergne-Rhône-Alpes;43;1;07;054;Chanaleilles;173;10;183
84;Auvergne-Rhône-Alpes;43;1;04;055;Chaniat;162;4;166
84;Auvergne-Rhône-Alpes;43;1;07;056;Chanteuges;419;13;432
84;Auvergne-Rhône-Alpes;43;2;11;057;La Chapelle-Bertin;47;1;48
84;Auvergne-Rhône-Alpes;43;3;09;058;La Chapelle-d'Aurec;1072;29;1101
84;Auvergne-Rhône-Alpes;43;1;11;059;La Chapelle-Geneste;110;1;111
84;Auvergne-Rhône-Alpes;43;1;07;060;Charraix;67;4;71
84;Auvergne-Rhône-Alpes;43;2;13;061;Chaspinhac;868;22;890
84;Auvergne-Rhône-Alpes;43;2;16;062;Chaspuzac;810;14;824
84;Auvergne-Rhône-Alpes;43;1;10;063;Chassagnes;155;1;156
84;Auvergne-Rhône-Alpes;43;1;17;064;Chassignolles;65;4;69
84;Auvergne-Rhône-Alpes;43;1;10;065;Chastel;120;4;124
84;Auvergne-Rhône-Alpes;43;2;08;066;Chaudeyrolles;121;4;125
84;Auvergne-Rhône-Alpes;43;1;10;067;Chavaniac-Lafayette;266;7;273
84;Auvergne-Rhône-Alpes;43;1;07;068;Chazelles;32;2;34
84;Auvergne-Rhône-Alpes;43;3;03;069;Chenereilles;310;12;322
84;Auvergne-Rhône-Alpes;43;1;10;070;Chilhac;167;3;170
84;Auvergne-Rhône-Alpes;43;2;11;071;Chomelix;462;5;467
84;Auvergne-Rhône-Alpes;43;1;10;072;La Chomette;153;4;157
84;Auvergne-Rhône-Alpes;43;1;11;073;Cistrières;132;3;135
84;Auvergne-Rhône-Alpes;43;1;04;074;Cohade;875;23;898
84;Auvergne-Rhône-Alpes;43;1;10;075;Collat;72;4;76
84;Auvergne-Rhône-Alpes;43;1;11;076;Connangles;132;2;134
84;Auvergne-Rhône-Alpes;43;2;18;077;Costaros;543;9;552
84;Auvergne-Rhône-Alpes;43;2;15;078;Coubon;3216;82;3298
84;Auvergne-Rhône-Alpes;43;1;10;079;Couteuges;296;5;301
84;Auvergne-Rhône-Alpes;43;2;11;080;Craponne-sur-Arzon;1968;20;1988
84;Auvergne-Rhône-Alpes;43;1;10;082;Cronce;69;2;71
84;Auvergne-Rhône-Alpes;43;1;07;083;Cubelles;149;4;153
84;Auvergne-Rhône-Alpes;43;2;18;084;Cussac-sur-Loire;1673;34;1707
84;Auvergne-Rhône-Alpes;43;1;07;085;Desges;55;4;59
84;Auvergne-Rhône-Alpes;43;1;10;086;Domeyrat;171;8;179
84;Auvergne-Rhône-Alpes;43;3;03;087;Dunières;2665;62;2727
84;Auvergne-Rhône-Alpes;43;1;17;088;Espalem;331;9;340
84;Auvergne-Rhône-Alpes;43;2;12;089;Espaly-Saint-Marcel;3521;127;3648
84;Auvergne-Rhône-Alpes;43;1;07;090;Esplantas-Vazeilles;127;4;131
84;Auvergne-Rhône-Alpes;43;2;08;091;Les Estables;319;17;336
84;Auvergne-Rhône-Alpes;43;2;08;092;Fay-sur-Lignon;358;8;366
84;Auvergne-Rhône-Alpes;43;1;11;093;Félines;317;7;324
84;Auvergne-Rhône-Alpes;43;1;10;094;Ferrussac;80;2;82
84;Auvergne-Rhône-Alpes;43;2;16;095;Fix-Saint-Geneys;139;3;142
84;Auvergne-Rhône-Alpes;43;1;04;096;Fontannes;886;222;1108
84;Auvergne-Rhône-Alpes;43;2;08;097;Freycenet-la-Cuche;105;2;107
84;Auvergne-Rhône-Alpes;43;2;08;098;Freycenet-la-Tour;109;5;114
84;Auvergne-Rhône-Alpes;43;1;17;099;Frugerès-les-Mines;552;6;558
84;Auvergne-Rhône-Alpes;43;1;10;100;Frugières-le-Pin;181;2;183
84;Auvergne-Rhône-Alpes;43;2;08;101;Goudet;56;6;62
84;Auvergne-Rhône-Alpes;43;3;19;102;Grazac;1114;17;1131
84;Auvergne-Rhône-Alpes;43;1;17;103;Grenier-Montgon;112;1;113
84;Auvergne-Rhône-Alpes;43;1;07;104;Grèzes;193;4;197
84;Auvergne-Rhône-Alpes;43;1;10;105;Javaugues;179;5;184
84;Auvergne-Rhône-Alpes;43;1;10;106;Jax;145;4;149
84;Auvergne-Rhône-Alpes;43;1;10;107;Josat;84;0;84
84;Auvergne-Rhône-Alpes;43;2;11;108;Jullianges;437;8;445
84;Auvergne-Rhône-Alpes;43;2;18;109;Lafarre;78;3;81
84;Auvergne-Rhône-Alpes;43;1;04;110;Lamothe;838;14;852
84;Auvergne-Rhône-Alpes;43;2;18;111;Landos;872;24;896
84;Auvergne-Rhône-Alpes;43;1;07;112;Langeac;3451;77;3528
84;Auvergne-Rhône-Alpes;43;2;08;113;Lantriac;1929;55;1984
84;Auvergne-Rhône-Alpes;43;3;19;114;Lapte;1736;38;1774
84;Auvergne-Rhône-Alpes;43;2;08;115;Laussonne;1015;18;1033
84;Auvergne-Rhône-Alpes;43;1;11;116;Laval-sur-Doulon;63;2;65
84;Auvergne-Rhône-Alpes;43;1;04;117;Lavaudieu;250;6;256
84;Auvergne-Rhône-Alpes;43;1;10;118;Lavoûte-Chilhac;266;6;272
84;Auvergne-Rhône-Alpes;43;2;06;119;Lavoûte-sur-Loire;829;18;847
84;Auvergne-Rhône-Alpes;43;1;17;120;Lempdes-sur-Allagnon;1317;26;1343
84;Auvergne-Rhône-Alpes;43;1;17;121;Léotoing;215;5;220
84;Auvergne-Rhône-Alpes;43;2;16;122;Lissac;292;8;300
84;Auvergne-Rhône-Alpes;43;1;17;123;Lorlanges;403;15;418
84;Auvergne-Rhône-Alpes;43;2;16;124;Loudes;938;17;955
84;Auvergne-Rhône-Alpes;43;1;10;125;Lubilhac;88;2;90
84;Auvergne-Rhône-Alpes;43;2;06;126;Malrevers;762;15;777
84;Auvergne-Rhône-Alpes;43;3;02;127;Malvalette;858;18;876
84;Auvergne-Rhône-Alpes;43;1;11;128;Malvières;137;2;139
84;Auvergne-Rhône-Alpes;43;3;03;129;Le Mas-de-Tence;152;7;159
84;Auvergne-Rhône-Alpes;43;3;08;130;Mazet-Saint-Voy;1111;29;1140
84;Auvergne-Rhône-Alpes;43;1;10;131;Mazerat-Aurouze;196;2;198
84;Auvergne-Rhône-Alpes;43;1;10;132;Mazeyrat-d'Allier;1441;43;1484
84;Auvergne-Rhône-Alpes;43;1;10;133;Mercœur;142;3;145
84;Auvergne-Rhône-Alpes;43;2;06;134;Mézères;146;4;150
84;Auvergne-Rhône-Alpes;43;2;08;135;Le Monastier-sur-Gazeille;1754;32;1786
84;Auvergne-Rhône-Alpes;43;1;07;136;Monistrol-d'Allier;213;1;214
84;Auvergne-Rhône-Alpes;43;3;09;137;Monistrol-sur-Loire;8962;431;9393
84;Auvergne-Rhône-Alpes;43;2;11;138;Monlet;414;12;426
84;Auvergne-Rhône-Alpes;43;1;10;139;Montclard;54;0;54
84;Auvergne-Rhône-Alpes;43;2;13;140;Le Monteil;682;17;699
84;Auvergne-Rhône-Alpes;43;3;03;141;Montfaucon-en-Velay;1152;23;1175
84;Auvergne-Rhône-Alpes;43;3;03;142;Montregard;581;9;590
84;Auvergne-Rhône-Alpes;43;2;08;143;Montusclat;126;0;126
84;Auvergne-Rhône-Alpes;43;2;08;144;Moudeyres;100;3;103
84;Auvergne-Rhône-Alpes;43;2;18;145;Ouides;54;0;54
84;Auvergne-Rhône-Alpes;43;1;04;147;Paulhac;640;24;664
84;Auvergne-Rhône-Alpes;43;1;10;148;Paulhaguet;864;13;877
84;Auvergne-Rhône-Alpes;43;1;07;149;Pébrac;117;4;121
84;Auvergne-Rhône-Alpes;43;2;06;150;Le Pertuis;474;12;486
84;Auvergne-Rhône-Alpes;43;1;07;151;Pinols;189;5;194
84;Auvergne-Rhône-Alpes;43;2;13;152;Polignac;2818;87;2905
84;Auvergne-Rhône-Alpes;43;3;01;153;Pont-Salomon;1889;36;1925
84;Auvergne-Rhône-Alpes;43;2;18;154;Pradelles;545;14;559
84;Auvergne-Rhône-Alpes;43;1;07;155;Prades;61;1;62
84;Auvergne-Rhône-Alpes;43;2;08;156;Présailles;114;6;120
84;Auvergne-Rhône-Alpes;43;2;99;157;Le Puy-en-Velay;18947;837;19784
84;Auvergne-Rhône-Alpes;43;2;06;158;Queyrières;347;12;359
84;Auvergne-Rhône-Alpes;43;3;03;159;Raucoules;941;24;965
84;Auvergne-Rhône-Alpes;43;2;18;160;Rauret;196;2;198
84;Auvergne-Rhône-Alpes;43;3;02;162;Retournac;2986;57;3043
84;Auvergne-Rhône-Alpes;43;3;03;163;Riotord;1182;17;1199
84;Auvergne-Rhône-Alpes;43;2;11;164;Roche-en-Régnier;479;4;483
84;Auvergne-Rhône-Alpes;43;2;06;165;Rosières;1528;29;1557
84;Auvergne-Rhône-Alpes;43;3;02;166;Saint-André-de-Chalencon;380;16;396
84;Auvergne-Rhône-Alpes;43;1;07;167;Saint-Arcons-d'Allier;196;4;200
84;Auvergne-Rhône-Alpes;43;2;18;168;Saint-Arcons-de-Barges;116;3;119
84;Auvergne-Rhône-Alpes;43;1;10;169;Saint-Austremoine;51;0;51
84;Auvergne-Rhône-Alpes;43;1;10;170;Saint-Beauzire;453;6;459
84;Auvergne-Rhône-Alpes;43;1;07;171;Saint-Bérain;81;4;85
84;Auvergne-Rhône-Alpes;43;3;03;172;Saint-Bonnet-le-Froid;215;3;218
84;Auvergne-Rhône-Alpes;43;1;07;173;Saint-Christophe-d'Allier;92;2;94
84;Auvergne-Rhône-Alpes;43;2;18;174;Saint-Christophe-sur-Dolaison;948;13;961
84;Auvergne-Rhône-Alpes;43;1;10;175;Saint-Cirgues;165;7;172
84;Auvergne-Rhône-Alpes;43;3;05;177;Saint-Didier-en-Velay;3459;53;3512
84;Auvergne-Rhône-Alpes;43;1;10;178;Saint-Didier-sur-Doulon;194;8;202
84;Auvergne-Rhône-Alpes;43;2;18;180;Saint-Étienne-du-Vigan;96;5;101
84;Auvergne-Rhône-Alpes;43;2;06;181;Saint-Étienne-Lardeyrol;752;20;772
84;Auvergne-Rhône-Alpes;43;1;17;182;Saint-Étienne-sur-Blesle;53;2;55
84;Auvergne-Rhône-Alpes;43;1;10;183;Sainte-Eugénie-de-Villeneuve;115;2;117
84;Auvergne-Rhône-Alpes;43;3;01;184;Saint-Ferréol-d'Auroure;2468;37;2505
84;Auvergne-Rhône-Alpes;43;1;17;185;Sainte-Florine;3226;77;3303
84;Auvergne-Rhône-Alpes;43;2;08;186;Saint-Front;406;5;411
84;Auvergne-Rhône-Alpes;43;2;16;187;Saint-Geneys-près-Saint-Paulien;321;4;325
84;Auvergne-Rhône-Alpes;43;1;10;188;Saint-Georges-d'Aurac;476;7;483
84;Auvergne-Rhône-Alpes;43;2;11;189;Saint-Georges-Lagricol;520;15;535
84;Auvergne-Rhône-Alpes;43;2;14;190;Saint-Germain-Laprade;3597;104;3701
84;Auvergne-Rhône-Alpes;43;1;04;191;Saint-Géron;245;5;250
84;Auvergne-Rhône-Alpes;43;2;18;192;Saint-Haon;281;10;291
84;Auvergne-Rhône-Alpes;43;1;17;193;Saint-Hilaire;161;2;163
84;Auvergne-Rhône-Alpes;43;2;06;194;Saint-Hostien;697;22;719
84;Auvergne-Rhône-Alpes;43;1;10;195;Saint-Ilpize;185;5;190
84;Auvergne-Rhône-Alpes;43;2;11;196;Saint-Jean-d'Aubrigoux;177;2;179
84;Auvergne-Rhône-Alpes;43;2;16;197;Saint-Jean-de-Nay;346;7;353
84;Auvergne-Rhône-Alpes;43;2;18;198;Saint-Jean-Lachalm;298;9;307
84;Auvergne-Rhône-Alpes;43;3;03;199;Saint-Jeures;967;25;992
84;Auvergne-Rhône-Alpes;43;2;06;200;Saint-Julien-Chapteuil;2010;45;2055
84;Auvergne-Rhône-Alpes;43;2;11;201;Saint-Julien-d'Ance;246;7;253
84;Auvergne-Rhône-Alpes;43;1;07;202;Saint-Julien-des-Chazes;65;3;68
84;Auvergne-Rhône-Alpes;43;3;19;203;Saint-Julien-du-Pinet;490;13;503
84;Auvergne-Rhône-Alpes;43;3;03;204;Saint-Julien-Molhesabate;171;1;172
84;Auvergne-Rhône-Alpes;43;3;01;205;Saint-Just-Malmont;4240;61;4301
84;Auvergne-Rhône-Alpes;43;1;10;206;Saint-Just-près-Brioude;404;16;420
84;Auvergne-Rhône-Alpes;43;1;04;207;Saint-Laurent-Chabreuges;248;11;259
84;Auvergne-Rhône-Alpes;43;1;10;208;Sainte-Marguerite;41;2;43
84;Auvergne-Rhône-Alpes;43;2;08;210;Saint-Martin-de-Fugères;236;7;243
84;Auvergne-Rhône-Alpes;43;3;09;211;Saint-Maurice-de-Lignon;2623;70;2693
84;Auvergne-Rhône-Alpes;43;3;11;212;Saint-Pal-de-Chalencon;1004;17;1021
84;Auvergne-Rhône-Alpes;43;3;05;213;Saint-Pal-de-Mons;2300;53;2353
84;Auvergne-Rhône-Alpes;43;1;11;214;Saint-Pal-de-Senouire;110;5;115
84;Auvergne-Rhône-Alpes;43;2;18;215;Saint-Paul-de-Tartas;184;4;188
84;Auvergne-Rhône-Alpes;43;2;16;216;Saint-Paulien;2428;58;2486
84;Auvergne-Rhône-Alpes;43;2;11;217;Saint-Pierre-du-Champ;544;11;555
84;Auvergne-Rhône-Alpes;43;2;06;218;Saint-Pierre-Eynac;1196;29;1225
84;Auvergne-Rhône-Alpes;43;1;10;219;Saint-Préjet-Armandon;114;5;119
84;Auvergne-Rhône-Alpes;43;1;07;220;Saint-Préjet-d'Allier;174;4;178
84;Auvergne-Rhône-Alpes;43;2;16;221;Saint-Privat-d'Allier;397;6;403
84;Auvergne-Rhône-Alpes;43;1;10;222;Saint-Privat-du-Dragon;165;2;167
84;Auvergne-Rhône-Alpes;43;3;03;223;Saint-Romain-Lachalm;1111;23;1134
84;Auvergne-Rhône-Alpes;43;3;05;224;Sainte-Sigolène;6023;97;6120
84;Auvergne-Rhône-Alpes;43;1;07;225;Saint-Vénérand;51;0;51
84;Auvergne-Rhône-Alpes;43;1;17;226;Saint-Vert;105;4;109
84;Auvergne-Rhône-Alpes;43;3;05;227;Saint-Victor-Malescours;816;18;834
84;Auvergne-Rhône-Alpes;43;2;11;228;Saint-Victor-sur-Arlanc;90;3;93
84;Auvergne-Rhône-Alpes;43;2;16;229;Saint-Vidal;610;12;622
84;Auvergne-Rhône-Alpes;43;2;06;230;Saint-Vincent;1040;18;1058
84;Auvergne-Rhône-Alpes;43;2;08;231;Salettes;142;5;147
84;Auvergne-Rhône-Alpes;43;1;10;232;Salzuit;347;12;359
84;Auvergne-Rhône-Alpes;43;2;16;233;Sanssac-l'Église;1084;40;1124
84;Auvergne-Rhône-Alpes;43;1;07;234;Saugues;1694;126;1820
84;Auvergne-Rhône-Alpes;43;3;05;236;La Séauve-sur-Semène;1485;20;1505
84;Auvergne-Rhône-Alpes;43;1;11;237;Sembadel;227;4;231
84;Auvergne-Rhône-Alpes;43;2;18;238;Séneujols;300;7;307
84;Auvergne-Rhône-Alpes;43;1;07;239;Siaugues-Sainte-Marie;804;15;819
84;Auvergne-Rhône-Alpes;43;3;02;240;Solignac-sous-Roche;266;5;271
84;Auvergne-Rhône-Alpes;43;2;18;241;Solignac-sur-Loire;1274;33;1307
84;Auvergne-Rhône-Alpes;43;1;07;242;Tailhac;72;2;74
84;Auvergne-Rhône-Alpes;43;3;03;244;Tence;3099;76;3175
84;Auvergne-Rhône-Alpes;43;1;07;245;Thoras;218;8;226
84;Auvergne-Rhône-Alpes;43;3;02;246;Tiranges;457;18;475
84;Auvergne-Rhône-Alpes;43;1;17;247;Torsiac;68;1;69
84;Auvergne-Rhône-Alpes;43;3;02;249;Valprivas;527;12;539
84;Auvergne-Rhône-Alpes;43;1;10;250;Vals-le-Chastel;42;4;46
84;Auvergne-Rhône-Alpes;43;2;12;251;Vals-près-le-Puy;3421;122;3543
84;Auvergne-Rhône-Alpes;43;2;11;252;Varennes-Saint-Honorat;25;2;27
84;Auvergne-Rhône-Alpes;43;2;08;253;Les Vastres;193;9;202
84;Auvergne-Rhône-Alpes;43;2;16;254;Vazeilles-Limandre;266;4;270
84;Auvergne-Rhône-Alpes;43;1;07;256;Venteuges;341;5;346
84;Auvergne-Rhône-Alpes;43;2;16;257;Vergezac;501;9;510
84;Auvergne-Rhône-Alpes;43;1;17;258;Vergongheon;1810;51;1861
84;Auvergne-Rhône-Alpes;43;2;16;259;Vernassal;362;12;374
84;Auvergne-Rhône-Alpes;43;2;16;260;Le Vernet;22;0;22
84;Auvergne-Rhône-Alpes;43;1;17;261;Vézézoux;622;11;633
84;Auvergne-Rhône-Alpes;43;1;04;262;Vieille-Brioude;1193;30;1223
84;Auvergne-Rhône-Alpes;43;2;18;263;Vielprat;68;0;68
84;Auvergne-Rhône-Alpes;43;1;10;264;Villeneuve-d'Allier;285;16;301
84;Auvergne-Rhône-Alpes;43;3;09;265;Les Villettes;1452;47;1499
84;Auvergne-Rhône-Alpes;43;2;06;267;Vorey;1450;11;1461
84;Auvergne-Rhône-Alpes;43;3;19;268;Yssingeaux;7320;423;7743
52;Pays de la Loire;44;5;08;001;Abbaretz;2056;40;2096
52;Pays de la Loire;44;2;07;002;Aigrefeuille-sur-Maine;4057;142;4199
52;Pays de la Loire;44;5;01;003;Ancenis-Saint-Géréon;11081;398;11479
52;Pays de la Loire;44;3;89;005;Chaumes-en-Retz;7049;109;7158
52;Pays de la Loire;44;3;09;006;Assérac;1875;43;1918
52;Pays de la Loire;44;5;19;007;Avessac;2444;56;2500
52;Pays de la Loire;44;2;29;009;Basse-Goulaine;9410;249;9659
52;Pays de la Loire;44;3;02;010;Batz-sur-Mer;2822;72;2894
52;Pays de la Loire;44;3;20;012;La Bernerie-en-Retz;3206;40;3246
52;Pays de la Loire;44;3;27;013;Besné;3249;41;3290
52;Pays de la Loire;44;2;28;014;Le Bignon;3927;72;3999
52;Pays de la Loire;44;5;03;015;Blain;10086;175;10261
52;Pays de la Loire;44;2;30;016;La Boissière-du-Doré;1071;18;1089
52;Pays de la Loire;44;2;21;018;Bouaye;8102;139;8241
52;Pays de la Loire;44;3;03;019;Bouée;1044;11;1055
52;Pays de la Loire;44;2;21;020;Bouguenais;20450;298;20748
52;Pays de la Loire;44;3;10;021;Villeneuve-en-Retz;5013;87;5100
52;Pays de la Loire;44;2;07;022;Boussay;2722;50;2772
52;Pays de la Loire;44;5;03;023;Bouvron;3081;45;3126
52;Pays de la Loire;44;2;21;024;Brains;2862;59;2921
52;Pays de la Loire;44;3;03;025;Campbon;3949;67;4016
52;Pays de la Loire;44;2;04;026;Carquefou;20463;500;20963
52;Pays de la Loire;44;5;18;027;Casson;2480;41;2521
52;Pays de la Loire;44;5;18;028;Le Cellier;3984;106;4090
52;Pays de la Loire;44;2;30;029;Divatte-sur-Loire;7042;120;7162
52;Pays de la Loire;44;3;09;030;La Chapelle-des-Marais;4339;93;4432
52;Pays de la Loire;44;5;06;031;La Chapelle-Glain;804;16;820
52;Pays de la Loire;44;2;30;032;La Chapelle-Heulin;3414;50;3464
52;Pays de la Loire;44;3;03;033;La Chapelle-Launay;3194;43;3237
52;Pays de la Loire;44;2;05;035;La Chapelle-sur-Erdre;19981;439;20420
52;Pays de la Loire;44;5;06;036;Châteaubriant;12016;458;12474
52;Pays de la Loire;44;2;31;037;Château-Thébaud;3157;186;3343
52;Pays de la Loire;44;3;20;038;Chauvé;2965;47;3012
52;Pays de la Loire;44;2;10;039;Cheix-en-Retz;1152;8;1160
52;Pays de la Loire;44;2;28;041;La Chevrolière;5951;90;6041
52;Pays de la Loire;44;2;07;043;Clisson;7507;245;7752
52;Pays de la Loire;44;5;08;044;Conquereuil;1084;27;1111
52;Pays de la Loire;44;2;03;045;Cordemais;3800;46;3846
52;Pays de la Loire;44;3;23;046;Corsept;2658;54;2712
52;Pays de la Loire;44;2;24;047;Couëron;22680;291;22971
52;Pays de la Loire;44;5;01;048;Couffé;2541;51;2592
52;Pays de la Loire;44;3;02;049;Le Croisic;4114;56;4170
52;Pays de la Loire;44;3;19;050;Crossac;3003;27;3030
52;Pays de la Loire;44;5;08;051;Derval;3511;428;3939
52;Pays de la Loire;44;3;27;052;Donges;8109;82;8191
52;Pays de la Loire;44;3;19;053;Drefféac;2288;37;2325
52;Pays de la Loire;44;5;06;054;Erbray;3045;71;3116
52;Pays de la Loire;44;3;02;055;La Baule-Escoublac;16160;546;16706
52;Pays de la Loire;44;5;05;056;Fay-de-Bretagne;3705;61;3766
52;Pays de la Loire;44;5;19;057;Fégréac;2302;60;2362
52;Pays de la Loire;44;5;06;058;Fercé;472;11;483
52;Pays de la Loire;44;3;23;061;Frossay;3228;55;3283
52;Pays de la Loire;44;5;03;062;Le Gâvre;1842;32;1874
52;Pays de la Loire;44;2;07;063;Gétigné;3746;88;3834
52;Pays de la Loire;44;2;07;064;Gorges;4950;357;5307
52;Pays de la Loire;44;5;06;065;Grand-Auverné;769;21;790
52;Pays de la Loire;44;5;05;066;Grandchamps-des-Fontaines;6606;117;6723
52;Pays de la Loire;44;5;08;067;Guémené-Penfao;5239;83;5322
52;Pays de la Loire;44;3;19;068;Guenrouet;3378;55;3433
52;Pays de la Loire;44;3;09;069;Guérande;16042;570;16612
52;Pays de la Loire;44;2;31;070;La Haie-Fouassière;4694;113;4807
52;Pays de la Loire;44;2;29;071;Haute-Goulaine;5954;156;6110
52;Pays de la Loire;44;3;09;072;Herbignac;7088;115;7203
52;Pays de la Loire;44;5;18;073;Héric;6407;116;6523
52;Pays de la Loire;44;2;24;074;Indre;4087;51;4138
52;Pays de la Loire;44;5;06;075;Issé;1804;39;1843
52;Pays de la Loire;44;5;08;076;Jans;1408;19;1427
52;Pays de la Loire;44;5;18;077;Joué-sur-Erdre;2632;28;2660
52;Pays de la Loire;44;5;06;078;Juigné-des-Moutiers;330;3;333
52;Pays de la Loire;44;2;30;079;Le Landreau;3118;297;3415
52;Pays de la Loire;44;3;03;080;Lavau-sur-Loire;771;18;789
52;Pays de la Loire;44;2;28;081;Legé;4633;109;4742
52;Pays de la Loire;44;5;18;082;Ligné;5371;109;5480
52;Pays de la Loire;44;2;28;083;La Limouzinière;2487;29;2516
52;Pays de la Loire;44;2;30;084;Le Loroux-Bottereau;8517;137;8654
52;Pays de la Loire;44;5;06;085;Louisfert;965;32;997
52;Pays de la Loire;44;5;08;086;Lusanger;1056;22;1078
52;Pays de la Loire;44;2;10;087;Machecoul-Saint-Même;7626;233;7859
52;Pays de la Loire;44;2;07;088;Maisdon-sur-Sèvre;3023;43;3066
52;Pays de la Loire;44;3;03;089;Malville;3564;57;3621
52;Pays de la Loire;44;2;10;090;La Marne;1606;22;1628
52;Pays de la Loire;44;5;08;091;Marsac-sur-Don;1524;31;1555
52;Pays de la Loire;44;5;08;092;Massérac;684;10;694
52;Pays de la Loire;44;2;04;094;Mauves-sur-Loire;3259;65;3324
52;Pays de la Loire;44;5;06;095;La Meilleraye-de-Bretagne;1548;25;1573
52;Pays de la Loire;44;5;01;096;Mésanger;4726;97;4823
52;Pays de la Loire;44;3;09;097;Mesquer;2088;46;2134
52;Pays de la Loire;44;3;19;098;Missillac;5432;70;5502
52;Pays de la Loire;44;5;06;099;Moisdon-la-Rivière;1967;60;2027
52;Pays de la Loire;44;2;07;100;Monnières;2316;61;2377
52;Pays de la Loire;44;2;23;101;La Montagne;6372;143;6515
52;Pays de la Loire;44;2;28;102;Montbert;3238;54;3292
52;Pays de la Loire;44;3;27;103;Montoir-de-Bretagne;7216;95;7311
52;Pays de la Loire;44;5;01;104;Montrelais;833;11;844
52;Pays de la Loire;44;5;08;105;Mouais;365;7;372
52;Pays de la Loire;44;3;20;106;Les Moutiers-en-Retz;1805;22;1827
52;Pays de la Loire;44;5;18;107;Mouzeil;1942;35;1977
52;Pays de la Loire;44;2;30;108;Mouzillon;2874;54;2928
52;Pays de la Loire;44;2;96;109;Nantes;320732;5125;325857
52;Pays de la Loire;44;5;18;110;Nort-sur-Erdre;9198;198;9396
52;Pays de la Loire;44;5;18;111;Notre-Dame-des-Landes;2285;40;2325
52;Pays de la Loire;44;5;06;112;Noyal-sur-Brutz;586;11;597
52;Pays de la Loire;44;5;08;113;Nozay;4216;89;4305
52;Pays de la Loire;44;2;25;114;Orvault;27438;698;28136
52;Pays de la Loire;44;5;01;115;Oudon;3936;67;4003
52;Pays de la Loire;44;3;23;116;Paimbœuf;3008;111;3119
52;Pays de la Loire;44;2;30;117;Le Pallet;3305;48;3353
52;Pays de la Loire;44;5;01;118;Pannecé;1424;26;1450
52;Pays de la Loire;44;2;10;119;Paulx;2004;32;2036
52;Pays de la Loire;44;2;23;120;Le Pellerin;5251;218;5469
52;Pays de la Loire;44;5;06;121;Petit-Auverné;427;3;430
52;Pays de la Loire;44;5;18;122;Petit-Mars;3818;55;3873
52;Pays de la Loire;44;5;08;123;Pierric;997;14;1011
52;Pays de la Loire;44;5;01;124;Le Pin;751;15;766
52;Pays de la Loire;44;3;09;125;Piriac-sur-Mer;2368;50;2418
52;Pays de la Loire;44;3;20;126;La Plaine-sur-Mer;4448;87;4535
52;Pays de la Loire;44;2;07;127;La Planche;2780;35;2815
52;Pays de la Loire;44;5;19;128;Plessé;5265;105;5370
52;Pays de la Loire;44;3;19;129;Pontchâteau;11030;276;11306
52;Pays de la Loire;44;2;28;130;Pont-Saint-Martin;6690;85;6775
52;Pays de la Loire;44;3;20;131;Pornic;16886;454;17340
52;Pays de la Loire;44;3;02;132;Pornichet;11828;331;12159
52;Pays de la Loire;44;2;10;133;Port-Saint-Père;2981;54;3035
52;Pays de la Loire;44;5;01;134;Pouillé-les-Côteaux;1085;22;1107
52;Pays de la Loire;44;3;02;135;Le Pouliguen;4024;92;4116
52;Pays de la Loire;44;3;20;136;Préfailles;1226;28;1254
52;Pays de la Loire;44;3;03;137;Prinquiau;3476;64;3540
52;Pays de la Loire;44;5;08;138;Puceul;1148;19;1167
52;Pays de la Loire;44;3;03;139;Quilly;1435;21;1456
52;Pays de la Loire;44;2;30;140;La Regrippière;1520;26;1546
52;Pays de la Loire;44;2;30;141;La Remaudière;1286;13;1299
52;Pays de la Loire;44;2;07;142;Remouillé;1949;37;1986
52;Pays de la Loire;44;2;97;143;Rezé;42993;763;43756
52;Pays de la Loire;44;5;18;144;Riaillé;2358;58;2416
52;Pays de la Loire;44;2;10;145;Rouans;3134;47;3181
52;Pays de la Loire;44;5;06;146;Rougé;2156;40;2196
52;Pays de la Loire;44;5;06;148;Ruffigné;705;8;713
52;Pays de la Loire;44;5;08;149;Saffré;3989;48;4037
52;Pays de la Loire;44;2;21;150;Saint-Aignan-Grandlieu;3973;61;4034
52;Pays de la Loire;44;3;02;151;Saint-André-des-Eaux;6813;174;6987
52;Pays de la Loire;44;3;19;152;Sainte-Anne-sur-Brivet;2964;53;3017
52;Pays de la Loire;44;5;06;153;Saint-Aubin-des-Châteaux;1741;50;1791
52;Pays de la Loire;44;3;23;154;Saint-Brevin-les-Pins;14473;336;14809
52;Pays de la Loire;44;2;28;155;Saint-Colomban;3428;75;3503
52;Pays de la Loire;44;2;28;156;Corcoué-sur-Logne;3074;39;3113
52;Pays de la Loire;44;2;10;157;Saint-Étienne-de-Mer-Morte;1724;21;1745
52;Pays de la Loire;44;2;03;158;Saint-Étienne-de-Montluc;7578;180;7758
52;Pays de la Loire;44;2;31;159;Saint-Fiacre-sur-Maine;1236;24;1260
52;Pays de la Loire;44;3;19;161;Saint-Gildas-des-Bois;3761;69;3830
52;Pays de la Loire;44;2;98;162;Saint-Herblain;49067;734;49801
52;Pays de la Loire;44;5;01;163;Vair-sur-Loire;4807;106;4913
52;Pays de la Loire;44;3;10;164;Saint-Hilaire-de-Chaléons;2336;46;2382
52;Pays de la Loire;44;2;07;165;Saint-Hilaire-de-Clisson;2325;47;2372
52;Pays de la Loire;44;2;23;166;Saint-Jean-de-Boiseau;5970;115;6085
52;Pays de la Loire;44;3;09;168;Saint-Joachim;4109;63;4172
52;Pays de la Loire;44;2;30;169;Saint-Julien-de-Concelles;7505;109;7614
52;Pays de la Loire;44;5;06;170;Saint-Julien-de-Vouvantes;959;20;979
52;Pays de la Loire;44;2;21;171;Saint-Léger-les-Vignes;1999;33;2032
52;Pays de la Loire;44;2;04;172;Sainte-Luce-sur-Loire;15417;263;15680
52;Pays de la Loire;44;2;07;173;Saint-Lumine-de-Clisson;2140;45;2185
52;Pays de la Loire;44;2;28;174;Saint-Lumine-de-Coutais;2278;39;2317
52;Pays de la Loire;44;3;09;175;Saint-Lyphard;4962;95;5057
52;Pays de la Loire;44;3;27;176;Saint-Malo-de-Guersac;3206;53;3259
52;Pays de la Loire;44;2;10;178;Saint-Mars-de-Coutais;2600;44;2644
52;Pays de la Loire;44;5;18;179;Saint-Mars-du-Désert;5236;84;5320
52;Pays de la Loire;44;5;01;180;Vallons-de-l'Erdre;6485;122;6607
52;Pays de la Loire;44;3;20;182;Saint-Michel-Chef-Chef;5297;88;5385
52;Pays de la Loire;44;3;09;183;Saint-Molf;2805;62;2867
52;Pays de la Loire;44;3;99;184;Saint-Nazaire;71887;1756;73643
52;Pays de la Loire;44;5;19;185;Saint-Nicolas-de-Redon;3280;66;3346
52;Pays de la Loire;44;2;10;186;Sainte-Pazanne;7111;135;7246
52;Pays de la Loire;44;3;23;187;Saint-Père-en-Retz;4594;148;4742
52;Pays de la Loire;44;2;28;188;Saint-Philbert-de-Grand-Lieu;9213;196;9409
52;Pays de la Loire;44;3;19;189;Sainte-Reine-de-Bretagne;2408;34;2442
52;Pays de la Loire;44;2;29;190;Saint-Sébastien-sur-Loire;27958;681;28639
52;Pays de la Loire;44;3;23;192;Saint-Viaud;2730;45;2775
52;Pays de la Loire;44;5;08;193;Saint-Vincent-des-Landes;1531;22;1553
52;Pays de la Loire;44;2;24;194;Sautron;8473;166;8639
52;Pays de la Loire;44;3;03;195;Savenay;9283;193;9476
52;Pays de la Loire;44;3;19;196;Sévérac;1653;24;1677
52;Pays de la Loire;44;5;08;197;Sion-les-Mines;1651;34;1685
52;Pays de la Loire;44;2;31;198;Les Sorinières;8900;110;9010
52;Pays de la Loire;44;5;06;199;Soudan;1996;52;2048
52;Pays de la Loire;44;5;06;200;Soulvache;339;7;346
52;Pays de la Loire;44;5;05;201;Sucé-sur-Erdre;7325;203;7528
52;Pays de la Loire;44;5;18;202;Teillé;1808;26;1834
52;Pays de la Loire;44;2;03;203;Le Temple-de-Bretagne;2032;19;2051
52;Pays de la Loire;44;2;04;204;Thouaré-sur-Loire;10704;180;10884
52;Pays de la Loire;44;5;18;205;Les Touches;2535;38;2573
52;Pays de la Loire;44;2;28;206;Touvois;1890;29;1919
52;Pays de la Loire;44;5;18;207;Trans-sur-Erdre;1102;10;1112
52;Pays de la Loire;44;5;08;208;Treffieux;941;9;950
52;Pays de la Loire;44;5;05;209;Treillières;10054;254;10308
52;Pays de la Loire;44;3;27;210;Trignac;8101;80;8181
52;Pays de la Loire;44;3;09;211;La Turballe;4889;93;4982
52;Pays de la Loire;44;2;30;212;Vallet;9412;219;9631
52;Pays de la Loire;44;5;01;213;Loireauxence;7533;125;7658
52;Pays de la Loire;44;5;08;214;Vay;2051;28;2079
52;Pays de la Loire;44;2;31;215;Vertou;25879;570;26449
52;Pays de la Loire;44;2;07;216;Vieillevigne;4040;74;4114
52;Pays de la Loire;44;5;05;217;Vigneux-de-Bretagne;6328;93;6421
52;Pays de la Loire;44;5;06;218;Villepot;684;15;699
52;Pays de la Loire;44;2;10;220;Vue;1632;21;1653
52;Pays de la Loire;44;5;08;221;La Chevallerais;1536;19;1555
52;Pays de la Loire;44;5;01;222;La Roche-Blanche;1241;20;1261
52;Pays de la Loire;44;2;28;223;Geneston;3688;48;3736
52;Pays de la Loire;44;5;08;224;La Grigonnais;1748;21;1769
24;Centre-Val de Loire;45;1;07;001;Adon;197;5;202
24;Centre-Val de Loire;45;1;08;002;Aillant-sur-Milleron;376;5;381
24;Centre-Val de Loire;45;1;02;004;Amilly;13279;579;13858
24;Centre-Val de Loire;45;3;17;005;Andonville;262;6;268
24;Centre-Val de Loire;45;2;05;006;Ardon;1128;29;1157
24;Centre-Val de Loire;45;2;10;008;Artenay;1969;29;1998
24;Centre-Val de Loire;45;3;17;009;Aschères-le-Marché;1143;30;1173
24;Centre-Val de Loire;45;3;09;010;Ascoux;1075;38;1113
24;Centre-Val de Loire;45;3;17;011;Attray;208;3;211
24;Centre-Val de Loire;45;3;17;012;Audeville;181;3;184
24;Centre-Val de Loire;45;3;09;013;Augerville-la-Rivière;225;8;233
24;Centre-Val de Loire;45;3;09;014;Aulnay-la-Rivière;499;11;510
24;Centre-Val de Loire;45;3;17;015;Autruy-sur-Juine;710;13;723
24;Centre-Val de Loire;45;1;07;016;Autry-le-Châtel;931;21;952
24;Centre-Val de Loire;45;1;08;017;Auvilliers-en-Gâtinais;339;3;342
24;Centre-Val de Loire;45;3;09;018;Auxy;965;18;983
24;Centre-Val de Loire;45;2;01;019;Baccon;651;31;682
24;Centre-Val de Loire;45;2;10;020;Le Bardon;979;18;997
24;Centre-Val de Loire;45;3;09;021;Barville-en-Gâtinais;309;6;315
24;Centre-Val de Loire;45;3;09;022;Batilly-en-Gâtinais;444;6;450
24;Centre-Val de Loire;45;1;07;023;Batilly-en-Puisaye;111;2;113
24;Centre-Val de Loire;45;2;01;024;Baule;2045;47;2092
24;Centre-Val de Loire;45;3;17;025;Bazoches-les-Gallerandes;1526;22;1548
24;Centre-Val de Loire;45;1;04;026;Bazoches-sur-le-Betz;980;15;995
24;Centre-Val de Loire;45;1;08;027;Beauchamps-sur-Huillard;390;8;398
24;Centre-Val de Loire;45;2;01;028;Beaugency;7384;187;7571
24;Centre-Val de Loire;45;1;07;029;Beaulieu-sur-Loire;1779;23;1802
24;Centre-Val de Loire;45;3;09;030;Beaune-la-Rolande;2006;128;2134
24;Centre-Val de Loire;45;1;08;031;Bellegarde;1446;88;1534
24;Centre-Val de Loire;45;1;04;032;Le Bignon-Mirabeau;316;8;324
24;Centre-Val de Loire;45;3;09;033;Boësses;368;20;388
24;Centre-Val de Loire;45;2;18;034;Boigny-sur-Bionne;2105;49;2154
24;Centre-Val de Loire;45;3;09;035;Boiscommun;1125;24;1149
24;Centre-Val de Loire;45;1;07;036;Boismorand;848;29;877
24;Centre-Val de Loire;45;3;17;037;Boisseaux;508;10;518
24;Centre-Val de Loire;45;3;09;038;Bondaroy;416;13;429
24;Centre-Val de Loire;45;2;21;039;Bonnée;706;19;725
24;Centre-Val de Loire;45;1;07;040;Bonny-sur-Loire;1861;24;1885
24;Centre-Val de Loire;45;3;09;041;Bordeaux-en-Gâtinais;108;3;111
24;Centre-Val de Loire;45;2;21;042;Les Bordes;1895;40;1935
24;Centre-Val de Loire;45;2;18;043;Bou;1013;24;1037
24;Centre-Val de Loire;45;2;17;044;Bougy-lez-Neuville;162;7;169
24;Centre-Val de Loire;45;3;09;045;Bouilly-en-Gâtinais;311;12;323
24;Centre-Val de Loire;45;2;10;046;Boulay-les-Barres;1057;17;1074
24;Centre-Val de Loire;45;3;09;047;Bouzonville-aux-Bois;414;13;427
24;Centre-Val de Loire;45;2;03;049;Bouzy-la-Forêt;1216;31;1247
24;Centre-Val de Loire;45;3;09;050;Boynes;1326;38;1364
24;Centre-Val de Loire;45;2;21;051;Bray-Saint-Aignan;1740;34;1774
24;Centre-Val de Loire;45;1;07;052;Breteau;99;0;99
24;Centre-Val de Loire;45;1;07;053;Briare;5212;95;5307
24;Centre-Val de Loire;45;3;09;054;Briarres-sur-Essonne;540;8;548
24;Centre-Val de Loire;45;2;10;055;Bricy;556;10;566
24;Centre-Val de Loire;45;3;09;056;Bromeilles;319;5;324
24;Centre-Val de Loire;45;2;10;058;Bucy-le-Roi;178;7;185
24;Centre-Val de Loire;45;2;10;059;Bucy-Saint-Liphard;191;1;192
24;Centre-Val de Loire;45;1;07;060;La Bussière;779;19;798
24;Centre-Val de Loire;45;1;02;061;Cepoy;2400;58;2458
24;Centre-Val de Loire;45;2;10;062;Cercottes;1501;24;1525
24;Centre-Val de Loire;45;2;21;063;Cerdon;924;18;942
24;Centre-Val de Loire;45;1;07;064;Cernoy-en-Berry;442;6;448
24;Centre-Val de Loire;45;3;17;065;Césarville-Dossainville;224;3;227
24;Centre-Val de Loire;45;1;08;066;Chailly-en-Gâtinais;677;10;687
24;Centre-Val de Loire;45;2;10;067;Chaingy;3987;109;4096
24;Centre-Val de Loire;45;1;02;068;Châlette-sur-Loing;12743;236;12979
24;Centre-Val de Loire;45;3;09;069;Chambon-la-Forêt;954;23;977
24;Centre-Val de Loire;45;1;07;070;Champoulet;58;0;58
24;Centre-Val de Loire;45;2;06;072;Chanteau;1652;25;1677
24;Centre-Val de Loire;45;1;04;073;Chantecoq;494;6;500
24;Centre-Val de Loire;45;2;10;074;La Chapelle-Onzerain;111;2;113
24;Centre-Val de Loire;45;2;19;075;La Chapelle-Saint-Mesmin;10095;211;10306
24;Centre-Val de Loire;45;1;04;076;La Chapelle-Saint-Sépulcre;228;7;235
24;Centre-Val de Loire;45;1;08;077;La Chapelle-sur-Aveyron;622;6;628
24;Centre-Val de Loire;45;1;08;078;Chapelon;252;2;254
24;Centre-Val de Loire;45;1;08;079;Le Charme;157;0;157
24;Centre-Val de Loire;45;3;17;080;Charmont-en-Beauce;341;14;355
24;Centre-Val de Loire;45;2;10;081;Charsonville;612;16;628
24;Centre-Val de Loire;45;2;03;082;Châteauneuf-sur-Loire;8382;120;8502
24;Centre-Val de Loire;45;1;04;083;Château-Renard;2106;33;2139
24;Centre-Val de Loire;45;1;08;084;Châtenoy;436;9;445
24;Centre-Val de Loire;45;1;08;085;Châtillon-Coligny;1869;25;1894
24;Centre-Val de Loire;45;3;17;086;Châtillon-le-Roi;277;4;281
24;Centre-Val de Loire;45;1;07;087;Châtillon-sur-Loire;3122;52;3174
24;Centre-Val de Loire;45;3;17;088;Chaussy;287;10;297
24;Centre-Val de Loire;45;2;18;089;Chécy;8699;176;8875
24;Centre-Val de Loire;45;1;04;091;Chevannes;317;13;330
24;Centre-Val de Loire;45;1;11;092;Chevillon-sur-Huillard;1465;36;1501
24;Centre-Val de Loire;45;2;10;093;Chevilly;2634;37;2671
24;Centre-Val de Loire;45;1;04;094;Chevry-sous-le-Bignon;225;2;227
24;Centre-Val de Loire;45;3;09;095;Chilleurs-aux-Bois;2096;43;2139
24;Centre-Val de Loire;45;1;07;096;Les Choux;529;7;536
24;Centre-Val de Loire;45;1;04;097;Chuelles;1217;13;1230
24;Centre-Val de Loire;45;2;01;098;Cléry-Saint-André;3466;69;3535
24;Centre-Val de Loire;45;2;10;099;Coinces;506;9;515
24;Centre-Val de Loire;45;2;18;100;Combleux;500;20;520
24;Centre-Val de Loire;45;2;03;101;Combreux;274;6;280
24;Centre-Val de Loire;45;1;02;102;Conflans-sur-Loing;355;10;365
24;Centre-Val de Loire;45;1;04;103;Corbeilles;1556;18;1574
24;Centre-Val de Loire;45;1;02;104;Corquilleroy;2822;60;2882
24;Centre-Val de Loire;45;1;08;105;Cortrat;77;2;79
24;Centre-Val de Loire;45;1;08;107;Coudroy;315;0;315
24;Centre-Val de Loire;45;1;21;108;Coullons;2293;34;2327
24;Centre-Val de Loire;45;2;10;109;Coulmiers;544;11;555
24;Centre-Val de Loire;45;3;09;110;Courcelles-le-Roi;313;8;321
24;Centre-Val de Loire;45;3;09;111;Courcy-aux-Loges;452;4;456
24;Centre-Val de Loire;45;1;08;112;La Cour-Marigny;342;11;353
24;Centre-Val de Loire;45;1;04;113;Courtemaux;262;5;267
24;Centre-Val de Loire;45;1;04;114;Courtempierre;229;11;240
24;Centre-Val de Loire;45;1;04;115;Courtenay;3848;66;3914
24;Centre-Val de Loire;45;2;01;116;Cravant;945;26;971
24;Centre-Val de Loire;45;3;17;118;Crottes-en-Pithiverais;331;4;335
24;Centre-Val de Loire;45;3;17;119;Dadonville;2404;53;2457
24;Centre-Val de Loire;45;1;07;120;Dammarie-en-Puisaye;171;2;173
24;Centre-Val de Loire;45;1;08;121;Dammarie-sur-Loing;472;9;481
24;Centre-Val de Loire;45;2;21;122;Dampierre-en-Burly;1424;37;1461
24;Centre-Val de Loire;45;2;03;123;Darvoy;1875;34;1909
24;Centre-Val de Loire;45;3;09;124;Desmonts;175;3;178
24;Centre-Val de Loire;45;3;09;125;Dimancheville;111;2;113
24;Centre-Val de Loire;45;2;03;126;Donnery;2854;63;2917
24;Centre-Val de Loire;45;1;04;127;Dordives;3272;36;3308
24;Centre-Val de Loire;45;1;04;129;Douchy-Montcorbon;1346;27;1373
24;Centre-Val de Loire;45;2;01;130;Dry;1407;27;1434
24;Centre-Val de Loire;45;3;09;131;Échilleuses;386;11;397
24;Centre-Val de Loire;45;3;09;132;Égry;354;4;358
24;Centre-Val de Loire;45;3;17;133;Engenville;563;17;580
24;Centre-Val de Loire;45;2;10;134;Épieds-en-Beauce;1419;29;1448
24;Centre-Val de Loire;45;3;17;135;Erceville;305;10;315
24;Centre-Val de Loire;45;1;04;136;Ervauville;545;8;553
24;Centre-Val de Loire;45;3;09;137;Escrennes;726;17;743
24;Centre-Val de Loire;45;1;07;138;Escrignelles;51;0;51
24;Centre-Val de Loire;45;3;09;139;Estouy;494;17;511
24;Centre-Val de Loire;45;1;07;141;Faverelles;156;1;157
24;Centre-Val de Loire;45;2;03;142;Fay-aux-Loges;3792;68;3860
24;Centre-Val de Loire;45;1;07;143;Feins-en-Gâtinais;32;1;33
24;Centre-Val de Loire;45;2;20;144;Férolles;1139;87;1226
24;Centre-Val de Loire;45;1;04;145;Ferrières-en-Gâtinais;3712;79;3791
24;Centre-Val de Loire;45;2;05;146;La Ferté-Saint-Aubin;7371;159;7530
24;Centre-Val de Loire;45;2;06;147;Fleury-les-Aubrais;21104;260;21364
24;Centre-Val de Loire;45;1;04;148;Fontenay-sur-Loing;1710;43;1753
24;Centre-Val de Loire;45;1;04;149;Foucherolles;270;3;273
24;Centre-Val de Loire;45;1;08;150;Fréville-du-Gâtinais;183;4;187
24;Centre-Val de Loire;45;3;09;151;Gaubertin;250;8;258
24;Centre-Val de Loire;45;2;10;152;Gémigny;213;5;218
24;Centre-Val de Loire;45;2;21;153;Germigny-des-Prés;727;24;751
24;Centre-Val de Loire;45;2;10;154;Gidy;2043;34;2077
24;Centre-Val de Loire;45;1;07;155;Gien;13305;411;13716
24;Centre-Val de Loire;45;1;04;156;Girolles;595;14;609
24;Centre-Val de Loire;45;3;09;157;Givraines;413;6;419
24;Centre-Val de Loire;45;1;04;158;Gondreville;318;10;328
24;Centre-Val de Loire;45;3;09;159;Grangermont;188;7;195
24;Centre-Val de Loire;45;3;17;160;Greneville-en-Beauce;709;8;717
24;Centre-Val de Loire;45;1;04;161;Griselles;799;20;819
24;Centre-Val de Loire;45;3;17;162;Guigneville;525;13;538
24;Centre-Val de Loire;45;2;21;164;Guilly;661;16;677
24;Centre-Val de Loire;45;1;04;165;Gy-les-Nonains;609;7;616
24;Centre-Val de Loire;45;2;10;166;Huêtre;285;8;293
24;Centre-Val de Loire;45;2;10;167;Huisseau-sur-Mauves;1728;29;1757
24;Centre-Val de Loire;45;2;03;168;Ingrannes;550;4;554
24;Centre-Val de Loire;45;2;19;169;Ingré;9541;236;9777
24;Centre-Val de Loire;45;3;17;170;Intville-la-Guétard;167;2;169
24;Centre-Val de Loire;45;2;21;171;Isdes;545;14;559
24;Centre-Val de Loire;45;2;03;173;Jargeau;4688;51;4739
24;Centre-Val de Loire;45;3;17;174;Jouy-en-Pithiverais;262;6;268
24;Centre-Val de Loire;45;2;01;175;Jouy-le-Potier;1504;25;1529
24;Centre-Val de Loire;45;3;09;176;Juranville;426;4;430
24;Centre-Val de Loire;45;3;09;177;Laas;238;3;241
24;Centre-Val de Loire;45;1;08;178;Ladon;1385;24;1409
24;Centre-Val de Loire;45;2;01;179;Lailly-en-Val;3101;49;3150
24;Centre-Val de Loire;45;1;07;180;Langesse;82;0;82
24;Centre-Val de Loire;45;3;17;181;Léouville;89;2;91
24;Centre-Val de Loire;45;2;05;182;Ligny-le-Ribault;1238;24;1262
24;Centre-Val de Loire;45;2;10;183;Lion-en-Beauce;133;4;137
24;Centre-Val de Loire;45;2;21;184;Lion-en-Sullias;394;6;400
24;Centre-Val de Loire;45;1;11;185;Lombreuil;298;9;307
24;Centre-Val de Loire;45;3;09;186;Lorcy;589;13;602
24;Centre-Val de Loire;45;1;08;187;Lorris;2988;62;3050
24;Centre-Val de Loire;45;2;06;188;Loury;2515;62;2577
24;Centre-Val de Loire;45;1;04;189;Louzouer;248;6;254
24;Centre-Val de Loire;45;3;09;191;Le Malesherbois;8004;161;8165
24;Centre-Val de Loire;45;2;05;193;Marcilly-en-Villette;2145;46;2191
24;Centre-Val de Loire;45;2;18;194;Mardié;2938;50;2988
24;Centre-Val de Loire;45;3;09;195;Mareau-aux-Bois;559;13;572
24;Centre-Val de Loire;45;2;01;196;Mareau-aux-Prés;1576;30;1606
24;Centre-Val de Loire;45;2;06;197;Marigny-les-Usages;1755;38;1793
24;Centre-Val de Loire;45;3;09;198;Marsainvilliers;304;9;313
24;Centre-Val de Loire;45;1;04;199;Melleroy;500;5;505
24;Centre-Val de Loire;45;2;05;200;Ménestreau-en-Villette;1401;37;1438
24;Centre-Val de Loire;45;1;04;201;Mérinville;177;3;180
24;Centre-Val de Loire;45;2;01;202;Messas;1009;15;1024
24;Centre-Val de Loire;45;2;10;203;Meung-sur-Loire;6567;93;6660
24;Centre-Val de Loire;45;2;01;204;Mézières-lez-Cléry;840;22;862
24;Centre-Val de Loire;45;1;08;205;Mézières-en-Gâtinais;257;6;263
24;Centre-Val de Loire;45;1;04;206;Mignères;320;4;324
24;Centre-Val de Loire;45;1;04;207;Mignerette;389;8;397
24;Centre-Val de Loire;45;1;11;208;Montargis;14738;482;15220
24;Centre-Val de Loire;45;3;09;209;Montbarrois;302;5;307
24;Centre-Val de Loire;45;1;08;210;Montbouy;733;19;752
24;Centre-Val de Loire;45;1;08;212;Montcresson;1261;28;1289
24;Centre-Val de Loire;45;1;08;213;Montereau;626;19;645
24;Centre-Val de Loire;45;2;17;214;Montigny;238;4;242
24;Centre-Val de Loire;45;3;09;215;Montliard;247;3;250
24;Centre-Val de Loire;45;1;11;216;Mormant-sur-Vernisson;128;2;130
24;Centre-Val de Loire;45;3;17;217;Morville-en-Beauce;166;5;171
24;Centre-Val de Loire;45;1;07;218;Le Moulinet-sur-Solin;112;1;113
24;Centre-Val de Loire;45;1;08;219;Moulon;192;2;194
24;Centre-Val de Loire;45;3;09;220;Nancray-sur-Rimarde;574;17;591
24;Centre-Val de Loire;45;1;04;222;Nargis;1469;36;1505
24;Centre-Val de Loire;45;1;08;223;Nesploy;360;6;366
24;Centre-Val de Loire;45;2;17;224;Neuville-aux-Bois;4978;77;5055
24;Centre-Val de Loire;45;3;09;225;La Neuville-sur-Essonne;351;14;365
24;Centre-Val de Loire;45;2;21;226;Neuvy-en-Sullias;1356;23;1379
24;Centre-Val de Loire;45;1;07;227;Nevoy;1164;22;1186
24;Centre-Val de Loire;45;3;09;228;Nibelle;1189;28;1217
24;Centre-Val de Loire;45;1;08;229;Nogent-sur-Vernisson;2575;37;2612
24;Centre-Val de Loire;45;1;08;230;Noyers;731;5;736
24;Centre-Val de Loire;45;3;17;231;Oison;129;5;134
24;Centre-Val de Loire;45;2;12;232;Olivet;22503;514;23017
24;Centre-Val de Loire;45;3;09;233;Ondreville-sur-Essonne;399;3;402
24;Centre-Val de Loire;45;2;99;234;Orléans;117026;2354;119380
24;Centre-Val de Loire;45;2;15;235;Ormes;4194;79;4273
24;Centre-Val de Loire;45;3;09;237;Orville;125;1;126
24;Centre-Val de Loire;45;1;07;238;Ousson-sur-Loire;691;12;703
24;Centre-Val de Loire;45;1;08;239;Oussoy-en-Gâtinais;415;6;421
24;Centre-Val de Loire;45;3;17;240;Outarville;1322;23;1345
24;Centre-Val de Loire;45;2;20;241;Ouvrouer-les-Champs;542;12;554
24;Centre-Val de Loire;45;1;08;242;Ouzouer-des-Champs;277;5;282
24;Centre-Val de Loire;45;1;08;243;Ouzouer-sous-Bellegarde;313;6;319
24;Centre-Val de Loire;45;2;21;244;Ouzouer-sur-Loire;2593;82;2675
24;Centre-Val de Loire;45;1;07;245;Ouzouer-sur-Trézée;1118;21;1139
24;Centre-Val de Loire;45;3;17;246;Pannecières;131;5;136
24;Centre-Val de Loire;45;1;11;247;Pannes;3694;64;3758
24;Centre-Val de Loire;45;2;10;248;Patay;2270;38;2308
24;Centre-Val de Loire;45;1;02;249;Paucourt;907;23;930
24;Centre-Val de Loire;45;1;04;250;Pers-en-Gâtinais;248;3;251
24;Centre-Val de Loire;45;1;07;251;Pierrefitte-ès-Bois;306;3;309
24;Centre-Val de Loire;45;3;17;252;Pithiviers;9067;146;9213
24;Centre-Val de Loire;45;3;17;253;Pithiviers-le-Vieil;1747;43;1790
24;Centre-Val de Loire;45;1;21;254;Poilly-lez-Gien;2419;49;2468
24;Centre-Val de Loire;45;1;04;255;Préfontaines;438;5;443
24;Centre-Val de Loire;45;1;08;256;Presnoy;248;6;254
24;Centre-Val de Loire;45;1;08;257;Pressigny-les-Pins;510;7;517
24;Centre-Val de Loire;45;3;09;258;Puiseaux;3413;56;3469
24;Centre-Val de Loire;45;1;08;259;Quiers-sur-Bézonde;1128;21;1149
24;Centre-Val de Loire;45;3;09;260;Ramoulu;250;8;258
24;Centre-Val de Loire;45;2;06;261;Rebréchien;1306;17;1323
24;Centre-Val de Loire;45;2;10;262;Rouvray-Sainte-Croix;139;2;141
24;Centre-Val de Loire;45;3;17;263;Rouvres-Saint-Jean;297;8;305
24;Centre-Val de Loire;45;2;10;264;Rozières-en-Beauce;182;4;186
24;Centre-Val de Loire;45;1;04;265;Rozoy-le-Vieil;405;5;410
24;Centre-Val de Loire;45;2;10;266;Ruan;202;1;203
24;Centre-Val de Loire;45;2;21;268;Saint-Aignan-le-Jaillard;614;8;622
24;Centre-Val de Loire;45;2;10;269;Saint-Ay;3607;72;3679
24;Centre-Val de Loire;45;2;21;270;Saint-Benoît-sur-Loire;2004;52;2056
24;Centre-Val de Loire;45;1;21;271;Saint-Brisson-sur-Loire;962;22;984
24;Centre-Val de Loire;45;2;05;272;Saint-Cyr-en-Val;3313;75;3388
24;Centre-Val de Loire;45;2;03;273;Saint-Denis-de-l'Hôtel;3028;40;3068
24;Centre-Val de Loire;45;2;20;274;Saint-Denis-en-Val;7633;188;7821
24;Centre-Val de Loire;45;1;04;275;Saint-Firmin-des-Bois;466;5;471
24;Centre-Val de Loire;45;1;07;276;Saint-Firmin-sur-Loire;510;5;515
24;Centre-Val de Loire;45;2;21;277;Saint-Florent;451;12;463
24;Centre-Val de Loire;45;1;08;278;Sainte-Geneviève-des-Bois;1065;69;1134
24;Centre-Val de Loire;45;1;04;279;Saint-Germain-des-Prés;1891;42;1933
24;Centre-Val de Loire;45;1;21;280;Saint-Gondon;1079;16;1095
24;Centre-Val de Loire;45;1;04;281;Saint-Hilaire-les-Andrésis;950;17;967
24;Centre-Val de Loire;45;2;12;282;Saint-Hilaire-Saint-Mesmin;3099;86;3185
24;Centre-Val de Loire;45;1;08;283;Saint-Hilaire-sur-Puiseaux;159;6;165
24;Centre-Val de Loire;45;2;18;284;Saint-Jean-de-Braye;21396;587;21983
24;Centre-Val de Loire;45;2;19;285;Saint-Jean-de-la-Ruelle;16570;242;16812
24;Centre-Val de Loire;45;2;20;286;Saint-Jean-le-Blanc;9225;135;9360
24;Centre-Val de Loire;45;3;09;288;Saint-Loup-des-Vignes;396;9;405
24;Centre-Val de Loire;45;2;17;289;Saint-Lyé-la-Forêt;1216;18;1234
24;Centre-Val de Loire;45;2;03;290;Saint-Martin-d'Abbat;1789;28;1817
24;Centre-Val de Loire;45;1;21;291;Saint-Martin-sur-Ocre;1232;47;1279
24;Centre-Val de Loire;45;1;08;292;Saint-Maurice-sur-Aveyron;852;13;865
24;Centre-Val de Loire;45;1;11;293;Saint-Maurice-sur-Fessard;1151;24;1175
24;Centre-Val de Loire;45;3;09;294;Saint-Michel;141;1;142
24;Centre-Val de Loire;45;2;10;296;Saint-Péravy-la-Colombe;749;16;765
24;Centre-Val de Loire;45;2;21;297;Saint-Père-sur-Loire;1025;16;1041
24;Centre-Val de Loire;45;2;12;298;Saint-Pryvé-Saint-Mesmin;6170;103;6273
24;Centre-Val de Loire;45;2;10;299;Saint-Sigismond;270;0;270
24;Centre-Val de Loire;45;2;20;300;Sandillon;4186;104;4290
24;Centre-Val de Loire;45;3;09;301;Santeau;397;3;400
24;Centre-Val de Loire;45;2;15;302;Saran;16598;189;16787
24;Centre-Val de Loire;45;1;04;303;Sceaux-du-Gâtinais;626;17;643
24;Centre-Val de Loire;45;2;03;305;Seichebrières;214;1;215
24;Centre-Val de Loire;45;1;04;306;La Selle-en-Hermoy;781;14;795
24;Centre-Val de Loire;45;1;04;307;La Selle-sur-le-Bied;1090;25;1115
24;Centre-Val de Loire;45;2;18;308;Semoy;3217;75;3292
24;Centre-Val de Loire;45;2;05;309;Sennely;702;15;717
24;Centre-Val de Loire;45;3;17;310;Sermaises;1691;22;1713
24;Centre-Val de Loire;45;2;20;311;Sigloy;659;18;677
24;Centre-Val de Loire;45;1;11;312;Solterre;475;8;483
24;Centre-Val de Loire;45;2;10;313;Sougy;813;13;826
24;Centre-Val de Loire;45;2;03;314;Sully-la-Chapelle;451;9;460
24;Centre-Val de Loire;45;2;21;315;Sully-sur-Loire;5141;62;5203
24;Centre-Val de Loire;45;2;03;316;Sury-aux-Bois;789;23;812
24;Centre-Val de Loire;45;2;01;317;Tavers;1351;30;1381
24;Centre-Val de Loire;45;3;17;320;Thignonville;420;12;432
24;Centre-Val de Loire;45;1;08;321;Thimory;699;20;719
24;Centre-Val de Loire;45;1;04;322;Thorailles;188;4;192
24;Centre-Val de Loire;45;1;07;323;Thou;220;4;224
24;Centre-Val de Loire;45;2;20;324;Tigy;2381;48;2429
24;Centre-Val de Loire;45;3;17;325;Tivernon;291;4;295
24;Centre-Val de Loire;45;2;10;326;Tournoisis;389;9;398
24;Centre-Val de Loire;45;2;06;327;Traînou;3445;83;3528
24;Centre-Val de Loire;45;1;04;328;Treilles-en-Gâtinais;293;5;298
24;Centre-Val de Loire;45;1;04;329;Triguères;1282;24;1306
24;Centre-Val de Loire;45;2;10;330;Trinay;215;4;219
24;Centre-Val de Loire;45;2;20;331;Vannes-sur-Cosson;614;9;623
24;Centre-Val de Loire;45;1;08;332;Varennes-Changy;1492;24;1516
24;Centre-Val de Loire;45;2;06;333;Vennecy;1974;40;2014
24;Centre-Val de Loire;45;1;08;334;Vieilles-Maisons-sur-Joudry;632;8;640
24;Centre-Val de Loire;45;2;20;335;Vienne-en-Val;1938;44;1982
24;Centre-Val de Loire;45;2;21;336;Viglain;867;13;880
24;Centre-Val de Loire;45;2;10;337;Villamblain;284;2;286
24;Centre-Val de Loire;45;1;11;338;Villemandeur;6835;367;7202
24;Centre-Val de Loire;45;1;08;339;Villemoutiers;483;7;490
24;Centre-Val de Loire;45;2;21;340;Villemurlin;563;11;574
24;Centre-Val de Loire;45;2;10;341;Villeneuve-sur-Conie;197;6;203
24;Centre-Val de Loire;45;2;17;342;Villereau;398;3;401
24;Centre-Val de Loire;45;1;04;343;Villevoques;206;6;212
24;Centre-Val de Loire;45;2;01;344;Villorceau;1084;20;1104
24;Centre-Val de Loire;45;1;11;345;Vimory;1118;34;1152
24;Centre-Val de Loire;45;2;03;346;Vitry-aux-Loges;2269;41;2310
24;Centre-Val de Loire;45;3;09;347;Vrigny;811;16;827
24;Centre-Val de Loire;45;3;09;348;Yèvre-la-Ville;694;17;711
76;Occitanie;46;1;12;001;Albas;523;12;535
76;Occitanie;46;2;10;002;Albiac;72;2;74
76;Occitanie;46;3;10;003;Alvignac;692;24;716
76;Occitanie;46;2;11;004;Anglars;227;6;233
76;Occitanie;46;1;12;005;Anglars-Juillac;332;9;341
76;Occitanie;46;3;09;006;Anglars-Nozac;389;4;393
76;Occitanie;46;1;02;007;Arcambal;986;23;1009
76;Occitanie;46;3;15;008;Les Arques;218;3;221
76;Occitanie;46;2;11;009;Assier;661;19;680
76;Occitanie;46;1;13;010;Aujols;370;10;380
76;Occitanie;46;2;16;011;Autoire;363;11;374
76;Occitanie;46;2;16;012;Aynac;554;14;568
76;Occitanie;46;1;13;013;Bach;185;6;191
76;Occitanie;46;2;08;015;Bagnac-sur-Célé;1473;34;1507
76;Occitanie;46;3;14;016;Baladou;384;15;399
76;Occitanie;46;2;16;017;Bannes;144;4;148
76;Occitanie;46;3;10;018;Le Bastit;133;2;135
76;Occitanie;46;1;13;020;Beauregard;230;12;242
76;Occitanie;46;2;07;021;Béduer;697;23;720
76;Occitanie;46;1;12;022;Bélaye;209;3;212
76;Occitanie;46;1;13;023;Belfort-du-Quercy;515;6;521
76;Occitanie;46;2;06;024;Belmont-Bretenoux;404;12;416
76;Occitanie;46;1;13;026;Belmont-Sainte-Foi;122;3;125
76;Occitanie;46;1;05;027;Berganty;122;2;124
76;Occitanie;46;3;14;028;Bétaille;1069;29;1098
76;Occitanie;46;2;06;029;Biars-sur-Cère;1998;52;2050
76;Occitanie;46;3;10;030;Bio;337;12;349
76;Occitanie;46;3;05;031;Blars;131;2;133
76;Occitanie;46;1;04;032;Boissières;403;5;408
76;Occitanie;46;1;15;033;Porte-du-Quercy;560;12;572
76;Occitanie;46;2;11;034;Le Bourg;306;8;314
76;Occitanie;46;2;07;035;Boussac;180;8;188
76;Occitanie;46;2;11;036;Le Bouyssou;125;2;127
76;Occitanie;46;1;05;037;Bouziès;93;1;94
76;Occitanie;46;2;06;038;Bretenoux;1370;28;1398
76;Occitanie;46;2;05;039;Brengues;211;2;213
76;Occitanie;46;1;05;040;Cabrerets;225;8;233
76;Occitanie;46;2;05;041;Cadrieu;155;8;163
76;Occitanie;46;1;98;042;Cahors;20159;922;21081
76;Occitanie;46;2;06;043;Cahus;199;5;204
76;Occitanie;46;1;12;044;Caillac;600;22;622
76;Occitanie;46;2;05;045;Cajarc;1117;32;1149
76;Occitanie;46;1;04;046;Calamane;460;10;470
76;Occitanie;46;3;17;047;Calès;168;6;174
76;Occitanie;46;2;05;049;Calvignac;215;5;220
76;Occitanie;46;1;12;050;Cambayrac;135;4;139
76;Occitanie;46;2;07;051;Cambes;374;7;381
76;Occitanie;46;2;07;052;Camboulit;257;5;262
76;Occitanie;46;2;07;053;Camburat;424;12;436
76;Occitanie;46;3;05;054;Caniac-du-Causse;393;2;395
76;Occitanie;46;2;08;055;Capdenac;1112;27;1139
76;Occitanie;46;2;05;056;Carayac;106;2;108
76;Occitanie;46;2;11;057;Cardaillac;622;12;634
76;Occitanie;46;3;14;058;Carennac;413;14;427
76;Occitanie;46;3;10;059;Carlucet;224;10;234
76;Occitanie;46;1;12;060;Carnac-Rouffiac;229;1;230
76;Occitanie;46;1;15;061;Cassagnes;177;6;183
76;Occitanie;46;1;12;062;Castelfranc;429;6;435
76;Occitanie;46;1;13;063;Castelnau Montratier-Sainte Alauzie;1836;38;1874
76;Occitanie;46;1;04;064;Catus;914;7;921
76;Occitanie;46;3;14;065;Cavagnac;426;15;441
76;Occitanie;46;3;09;066;Cazals;643;6;649
76;Occitanie;46;1;05;068;Cénevières;167;2;169
76;Occitanie;46;1;13;069;Cézac;169;3;172
76;Occitanie;46;1;03;070;Cieurac;599;14;613
76;Occitanie;46;3;04;072;Concorès;303;6;309
76;Occitanie;46;1;13;073;Concots;415;17;432
76;Occitanie;46;3;14;074;Condat;412;8;420
76;Occitanie;46;2;07;075;Corn;239;5;244
76;Occitanie;46;2;06;076;Cornac;347;7;354
76;Occitanie;46;3;10;078;Couzou;96;1;97
76;Occitanie;46;3;05;079;Cras;102;2;104
76;Occitanie;46;1;04;080;Crayssac;781;15;796
76;Occitanie;46;1;05;081;Crégols;72;3;75
76;Occitanie;46;1;13;082;Cremps;366;9;375
76;Occitanie;46;3;14;083;Cressensac-Sarrazac;1125;15;1140
76;Occitanie;46;3;14;084;Creysse;307;7;314
76;Occitanie;46;2;08;085;Cuzac;238;6;244
76;Occitanie;46;3;14;086;Cuzance;640;13;653
76;Occitanie;46;3;09;087;Dégagnac;649;18;667
76;Occitanie;46;1;12;088;Douelle;825;22;847
76;Occitanie;46;1;15;089;Duravel;947;9;956
76;Occitanie;46;2;10;090;Durbans;152;1;153
76;Occitanie;46;1;13;091;Escamps;208;4;212
76;Occitanie;46;1;05;092;Esclauzels;219;3;222
76;Occitanie;46;2;05;093;Espagnac-Sainte-Eulalie;86;2;88
76;Occitanie;46;2;05;094;Espédaillac;267;6;273
76;Occitanie;46;1;04;095;Espère;1040;25;1065
76;Occitanie;46;2;11;096;Espeyroux;96;2;98
76;Occitanie;46;2;06;097;Estal;109;6;115
76;Occitanie;46;3;17;098;Fajoles;306;7;313
76;Occitanie;46;2;07;100;Faycelles;697;29;726
76;Occitanie;46;2;08;101;Felzins;473;9;482
76;Occitanie;46;2;99;102;Figeac;9784;596;10380
76;Occitanie;46;1;13;103;Saint-Paul-Flaugnac;994;26;1020
76;Occitanie;46;2;10;104;Flaujac-Gare;91;5;96
76;Occitanie;46;1;03;105;Flaujac-Poujols;792;17;809
76;Occitanie;46;3;14;106;Floirac;239;9;248
76;Occitanie;46;1;15;107;Floressas;173;5;178
76;Occitanie;46;2;07;108;Fons;409;13;422
76;Occitanie;46;1;13;109;Fontanes;513;9;522
76;Occitanie;46;2;07;111;Fourmagnac;171;4;175
76;Occitanie;46;1;04;112;Francoulès;250;6;256
76;Occitanie;46;3;04;113;Frayssinet;306;5;311
76;Occitanie;46;3;15;114;Frayssinet-le-Gélat;365;7;372
76;Occitanie;46;2;16;115;Frayssinhes;161;7;168
76;Occitanie;46;2;05;116;Frontenac;71;6;77
76;Occitanie;46;2;06;117;Gagnac-sur-Cère;667;40;707
76;Occitanie;46;3;17;118;Gignac;674;15;689
76;Occitanie;46;1;04;119;Gigouzac;299;0;299
76;Occitanie;46;3;09;120;Gindou;343;4;347
76;Occitanie;46;3;04;121;Ginouillac;142;3;145
76;Occitanie;46;2;06;122;Gintrac;105;3;108
76;Occitanie;46;2;06;123;Girac;360;7;367
76;Occitanie;46;2;06;124;Glanes;297;12;309
76;Occitanie;46;2;11;125;Gorses;329;10;339
76;Occitanie;46;3;15;126;Goujounac;217;4;221
76;Occitanie;46;3;09;127;Gourdon;3959;127;4086
76;Occitanie;46;3;10;128;Gramat;3480;59;3539
76;Occitanie;46;2;05;129;Gréalou;290;10;300
76;Occitanie;46;1;15;130;Grézels;226;3;229
76;Occitanie;46;2;05;131;Grèzes;166;5;171
76;Occitanie;46;2;10;132;Issendolus;516;22;538
76;Occitanie;46;2;11;133;Issepts;269;3;272
76;Occitanie;46;1;15;134;Les Junies;267;6;273
76;Occitanie;46;2;11;135;Labastide-du-Haut-Mont;48;2;50
76;Occitanie;46;1;04;136;Labastide-du-Vert;272;7;279
76;Occitanie;46;1;03;137;Labastide-Marnhac;1274;23;1297
76;Occitanie;46;3;05;138;Cœur de Causse;900;18;918
76;Occitanie;46;2;11;139;Labathude;201;7;208
76;Occitanie;46;1;13;140;Laburgade;362;15;377
76;Occitanie;46;1;15;142;Lacapelle-Cabanac;173;2;175
76;Occitanie;46;2;11;143;Lacapelle-Marival;1285;41;1326
76;Occitanie;46;3;17;144;Lacave;249;11;260
76;Occitanie;46;3;17;145;Lachapelle-Auzac;794;11;805
76;Occitanie;46;2;16;146;Ladirat;93;2;95
76;Occitanie;46;1;15;147;Lagardelle;128;0;128
76;Occitanie;46;1;13;148;Lalbenque;1836;45;1881
76;Occitanie;46;1;02;149;Lamagdelaine;703;14;717
76;Occitanie;46;3;04;151;Lamothe-Cassel;115;3;118
76;Occitanie;46;3;17;152;Lamothe-Fénelon;302;4;306
76;Occitanie;46;3;17;153;Lanzac;578;12;590
76;Occitanie;46;1;13;154;Laramière;351;7;358
76;Occitanie;46;2;05;155;Larnagol;137;1;138
76;Occitanie;46;1;02;156;Bellefont-La Rauze;1213;30;1243
76;Occitanie;46;2;05;157;Larroque-Toirac;133;5;138
76;Occitanie;46;2;16;159;Latouille-Lentillac;228;5;233
76;Occitanie;46;2;11;160;Latronquière;419;14;433
76;Occitanie;46;2;11;161;Lauresses;246;6;252
76;Occitanie;46;3;05;162;Lauzès;205;6;211
76;Occitanie;46;2;06;163;Laval-de-Cère;285;4;289
76;Occitanie;46;3;09;164;Lavercantière;252;11;263
76;Occitanie;46;3;10;165;Lavergne;471;11;482
76;Occitanie;46;3;05;167;Lentillac-du-Causse;110;0;110
76;Occitanie;46;2;08;168;Lentillac-Saint-Blaise;190;2;192
76;Occitanie;46;3;09;169;Léobard;203;7;210
76;Occitanie;46;2;16;170;Leyme;924;26;950
76;Occitanie;46;1;15;171;Lherm;228;3;231
76;Occitanie;46;1;13;172;Lhospitalet;502;16;518
76;Occitanie;46;1;13;173;Limogne-en-Quercy;773;8;781
76;Occitanie;46;2;08;174;Linac;235;8;243
76;Occitanie;46;2;07;175;Lissac-et-Mouret;926;36;962
76;Occitanie;46;2;11;176;Livernon;709;14;723
76;Occitanie;46;2;16;177;Loubressac;511;20;531
76;Occitanie;46;3;17;178;Loupiac;260;2;262
76;Occitanie;46;1;13;179;Lugagnac;128;5;133
76;Occitanie;46;2;08;180;Lunan;606;27;633
76;Occitanie;46;3;05;181;Lunegarde;93;5;98
76;Occitanie;46;1;12;182;Luzech;1776;28;1804
76;Occitanie;46;2;05;183;Marcilhac-sur-Célé;202;3;205
76;Occitanie;46;3;09;184;Marminiac;348;12;360
76;Occitanie;46;3;14;185;Martel;1638;38;1676
76;Occitanie;46;3;17;186;Masclat;360;5;365
76;Occitanie;46;1;15;187;Mauroux;525;10;535
76;Occitanie;46;1;04;188;Maxou;295;10;305
76;Occitanie;46;2;16;189;Mayrinhac-Lentour;492;13;505
76;Occitanie;46;1;04;190;Mechmont;127;3;130
76;Occitanie;46;1;01;191;Mercuès;1135;25;1160
76;Occitanie;46;3;17;192;Meyronne;263;8;271
76;Occitanie;46;3;10;193;Miers;454;8;462
76;Occitanie;46;3;09;194;Milhac;187;6;193
76;Occitanie;46;2;16;195;Molières;358;8;366
76;Occitanie;46;3;04;196;Montamel;94;1;95
76;Occitanie;46;1;03;197;Le Montat;1069;125;1194
76;Occitanie;46;2;05;198;Montbrun;110;1;111
76;Occitanie;46;1;15;199;Montcabrier;345;6;351
76;Occitanie;46;3;15;200;Montcléra;262;4;266
76;Occitanie;46;1;12;201;Montcuq-en-Quercy-Blanc;1804;50;1854
76;Occitanie;46;1;13;202;Montdoumerc;554;5;559
76;Occitanie;46;2;11;203;Montet-et-Bouxal;213;6;219
76;Occitanie;46;3;04;204;Montfaucon;593;8;601
76;Occitanie;46;1;04;205;Montgesty;318;2;320
76;Occitanie;46;1;12;206;Montlauzun;118;6;124
76;Occitanie;46;2;08;207;Montredon;301;6;307
76;Occitanie;46;3;14;208;Montvalent;294;7;301
76;Occitanie;46;3;17;209;Nadaillac-de-Rouge;162;9;171
76;Occitanie;46;3;05;210;Nadillac;71;1;72
76;Occitanie;46;1;04;211;Nuzéjouls;357;2;359
76;Occitanie;46;3;05;212;Orniac;71;0;71
76;Occitanie;46;3;10;213;Padirac;165;4;169
76;Occitanie;46;1;12;214;Parnac;386;10;396
76;Occitanie;46;3;17;215;Payrac;635;14;649
76;Occitanie;46;3;09;216;Payrignac;652;29;681
76;Occitanie;46;1;13;217;Pern;431;11;442
76;Occitanie;46;1;15;218;Pescadoires;186;4;190
76;Occitanie;46;3;04;219;Peyrilles;344;13;357
76;Occitanie;46;3;17;220;Pinsac;772;28;800
76;Occitanie;46;2;07;221;Planioles;539;11;550
76;Occitanie;46;3;15;222;Pomarède;193;3;196
76;Occitanie;46;1;04;223;Pontcirq;178;2;180
76;Occitanie;46;1;01;224;Pradines;3578;103;3681
76;Occitanie;46;1;15;225;Prayssac;2419;66;2485
76;Occitanie;46;2;08;226;Prendeignes;230;7;237
76;Occitanie;46;1;13;227;Promilhanes;221;4;225
76;Occitanie;46;2;06;228;Prudhomat;724;20;744
76;Occitanie;46;2;06;229;Puybrun;1020;19;1039
76;Occitanie;46;2;05;230;Puyjourdes;89;4;93
76;Occitanie;46;1;15;231;Puy-l'Évêque;1929;24;1953
76;Occitanie;46;3;14;232;Le Vignon-en-Quercy;985;24;1009
76;Occitanie;46;2;05;233;Quissac;108;1;109
76;Occitanie;46;3;09;234;Rampoux;99;2;101
76;Occitanie;46;2;10;235;Reilhac;170;4;174
76;Occitanie;46;3;17;236;Reilhaguet;150;0;150
76;Occitanie;46;2;11;237;Reyrevignes;365;12;377
76;Occitanie;46;3;10;238;Rignac;285;9;294
76;Occitanie;46;3;17;239;Le Roc;208;5;213
76;Occitanie;46;3;10;240;Rocamadour;617;20;637
76;Occitanie;46;3;09;241;Rouffilhac;189;4;193
76;Occitanie;46;2;11;242;Rudelle;181;5;186
76;Occitanie;46;2;11;243;Rueyres;189;1;190
76;Occitanie;46;2;11;244;Sabadel-Latronquière;93;1;94
76;Occitanie;46;3;05;245;Sabadel-Lauzès;82;0;82
76;Occitanie;46;2;16;246;Saignes;74;1;75
76;Occitanie;46;1;13;247;Saillac;151;5;156
76;Occitanie;46;2;11;249;Saint-Bressou;123;5;128
76;Occitanie;46;3;15;250;Saint-Caprais;83;2;85
76;Occitanie;46;2;16;251;Saint-Céré;3427;155;3582
76;Occitanie;46;3;05;252;Les Pechs du Vers;314;8;322
76;Occitanie;46;3;04;253;Saint-Chamarand;181;2;183
76;Occitanie;46;2;05;254;Saint-Chels;137;5;142
76;Occitanie;46;2;11;255;Saint-Cirgues;330;13;343
76;Occitanie;46;1;05;256;Saint-Cirq-Lapopie;201;6;207
76;Occitanie;46;3;09;257;Saint-Cirq-Madelon;133;1;134
76;Occitanie;46;3;09;258;Saint-Cirq-Souillaguet;165;1;166
76;Occitanie;46;3;09;259;Saint-Clair;140;2;142
76;Occitanie;46;2;11;260;Sainte-Colombe;227;10;237
76;Occitanie;46;1;12;262;Lendou-en-Quercy;629;13;642
76;Occitanie;46;1;12;263;Barguelonne-en-Quercy;697;16;713
76;Occitanie;46;1;04;264;Saint-Denis-Catus;200;7;207
76;Occitanie;46;3;14;265;Saint-Denis-lès-Martel;333;5;338
76;Occitanie;46;2;08;266;Saint-Félix;535;9;544
76;Occitanie;46;3;04;267;Saint-Germain-du-Bel-Air;567;12;579
76;Occitanie;46;1;05;268;Saint Géry-Vers;907;20;927
76;Occitanie;46;2;11;269;Saint-Hilaire;60;2;62
76;Occitanie;46;2;05;270;Saint-Jean-de-Laur;242;3;245
76;Occitanie;46;2;16;271;Saint-Jean-Lespinasse;405;17;422
76;Occitanie;46;2;08;272;Saint-Jean-Mirabel;287;3;290
76;Occitanie;46;2;16;273;Saint-Laurent-les-Tours;844;26;870
76;Occitanie;46;1;05;276;Saint-Martin-Labouval;183;5;188
76;Occitanie;46;1;15;277;Saint-Martin-le-Redon;201;4;205
76;Occitanie;46;2;11;279;Saint-Maurice-en-Quercy;206;3;209
76;Occitanie;46;1;04;280;Saint-Médard;177;5;182
76;Occitanie;46;2;16;281;Saint-Médard-de-Presque;198;6;204
76;Occitanie;46;2;11;282;Saint-Médard-Nicourby;95;0;95
76;Occitanie;46;3;14;283;Saint-Michel-de-Bannières;317;8;325
76;Occitanie;46;2;06;284;Saint-Michel-Loubéjou;407;8;415
76;Occitanie;46;2;16;286;Saint-Paul-de-Vern;175;4;179
76;Occitanie;46;2;08;288;Saint-Perdoux;215;10;225
76;Occitanie;46;2;05;289;Saint-Pierre-Toirac;159;1;160
76;Occitanie;46;3;09;290;Saint-Projet;342;7;349
76;Occitanie;46;2;11;292;Saint-Simon;193;6;199
76;Occitanie;46;3;17;293;Saint-Sozy;483;12;495
76;Occitanie;46;2;05;294;Saint-Sulpice;144;4;148
76;Occitanie;46;2;16;295;Saint-Vincent-du-Pendit;222;4;226
76;Occitanie;46;1;12;296;Saint-Vincent-Rive-d'Olt;429;16;445
76;Occitanie;46;3;09;297;Salviac;1208;25;1233
76;Occitanie;46;2;05;299;Sauliac-sur-Célé;119;4;123
76;Occitanie;46;1;12;301;Sauzet;530;5;535
76;Occitanie;46;2;11;302;Sénaillac-Latronquière;132;2;134
76;Occitanie;46;3;05;303;Sénaillac-Lauzès;134;2;136
76;Occitanie;46;3;04;304;Séniergues;141;1;142
76;Occitanie;46;1;15;305;Sérignac;310;3;313
76;Occitanie;46;2;11;306;Sonac;88;1;89
76;Occitanie;46;1;15;307;Soturac;640;7;647
76;Occitanie;46;3;04;308;Soucirac;102;1;103
76;Occitanie;46;3;17;309;Souillac;3203;317;3520
76;Occitanie;46;3;05;310;Soulomès;132;2;134
76;Occitanie;46;2;06;311;Sousceyrac-en-Quercy;1334;19;1353
76;Occitanie;46;3;14;312;Strenquels;275;2;277
76;Occitanie;46;2;06;313;Tauriac;454;10;464
76;Occitanie;46;2;11;314;Terrou;176;39;215
76;Occitanie;46;2;06;315;Teyssieu;166;3;169
76;Occitanie;46;3;04;316;Thédirac;289;5;294
76;Occitanie;46;3;10;317;Thégra;484;13;497
76;Occitanie;46;2;11;318;Thémines;238;11;249
76;Occitanie;46;2;11;319;Théminettes;173;3;176
76;Occitanie;46;1;05;320;Tour-de-Faure;314;14;328
76;Occitanie;46;1;15;321;Touzac;370;8;378
76;Occitanie;46;1;03;322;Trespoux-Rassiels;811;31;842
76;Occitanie;46;3;04;323;Ussel;99;2;101
76;Occitanie;46;3;04;324;Uzech;215;4;219
76;Occitanie;46;1;13;328;Varaire;345;12;357
76;Occitanie;46;1;13;329;Vaylats;328;2;330
76;Occitanie;46;3;14;330;Vayrac;1305;24;1329
76;Occitanie;46;2;08;332;Viazac;336;15;351
76;Occitanie;46;1;13;333;Vidaillac;183;4;187
76;Occitanie;46;3;09;334;Le Vigan;1546;57;1603
76;Occitanie;46;1;12;335;Villesèque;389;16;405
76;Occitanie;46;1;15;336;Vire-sur-Lot;340;32;372
76;Occitanie;46;3;17;337;Mayrac;261;7;268
76;Occitanie;46;2;11;338;Bessonies;75;1;76
76;Occitanie;46;2;16;339;Saint-Jean-Lagineste;380;8;388
76;Occitanie;46;1;04;340;Saint-Pierre-Lafeuille;371;13;384
75;Nouvelle-Aquitaine;47;1;97;001;Agen;32214;832;33046
75;Nouvelle-Aquitaine;47;2;07;002;Agmé;108;4;112
75;Nouvelle-Aquitaine;47;2;19;003;Agnac;439;10;449
75;Nouvelle-Aquitaine;47;1;06;004;Aiguillon;4253;115;4368
75;Nouvelle-Aquitaine;47;2;19;005;Allemans-du-Dropt;485;5;490
75;Nouvelle-Aquitaine;47;3;12;006;Allez-et-Cazeneuve;602;13;615
75;Nouvelle-Aquitaine;47;4;08;007;Allons;165;5;170
75;Nouvelle-Aquitaine;47;4;11;008;Ambrus;108;4;112
75;Nouvelle-Aquitaine;47;4;05;009;Andiran;240;9;249
75;Nouvelle-Aquitaine;47;2;08;010;Antagnac;222;3;225
75;Nouvelle-Aquitaine;47;3;09;011;Anthé;198;9;207
75;Nouvelle-Aquitaine;47;4;08;012;Anzex;310;2;312
75;Nouvelle-Aquitaine;47;2;08;013;Argenton;320;11;331
75;Nouvelle-Aquitaine;47;2;19;014;Armillac;208;7;215
75;Nouvelle-Aquitaine;47;1;17;015;Astaffort;2036;39;2075
75;Nouvelle-Aquitaine;47;1;15;016;Aubiac;1165;24;1189
75;Nouvelle-Aquitaine;47;3;16;017;Auradou;422;9;431
75;Nouvelle-Aquitaine;47;2;07;018;Auriac-sur-Dropt;173;6;179
75;Nouvelle-Aquitaine;47;1;01;019;Bajamont;986;16;1002
75;Nouvelle-Aquitaine;47;2;07;020;Baleyssagues;188;8;196
75;Nouvelle-Aquitaine;47;4;11;021;Barbaste;1501;70;1571
75;Nouvelle-Aquitaine;47;1;06;022;Bazens;535;9;544
75;Nouvelle-Aquitaine;47;3;10;023;Beaugas;344;8;352
75;Nouvelle-Aquitaine;47;2;13;024;Beaupuy;1638;43;1681
75;Nouvelle-Aquitaine;47;1;16;025;Beauville;550;10;560
75;Nouvelle-Aquitaine;47;4;08;026;Beauziac;227;8;235
75;Nouvelle-Aquitaine;47;3;21;027;Bias;2987;43;3030
75;Nouvelle-Aquitaine;47;2;14;028;Birac-sur-Trec;847;20;867
75;Nouvelle-Aquitaine;47;3;09;029;Blanquefort-sur-Briolance;506;13;519
75;Nouvelle-Aquitaine;47;1;16;030;Blaymont;211;6;217
75;Nouvelle-Aquitaine;47;1;02;031;Boé;5639;94;5733
75;Nouvelle-Aquitaine;47;1;02;032;Bon-Encontre;6222;147;6369
75;Nouvelle-Aquitaine;47;3;10;033;Boudy-de-Beauregard;407;8;415
75;Nouvelle-Aquitaine;47;2;08;034;Bouglon;639;14;653
75;Nouvelle-Aquitaine;47;2;19;035;Bourgougnague;316;75;391
75;Nouvelle-Aquitaine;47;3;09;036;Bourlens;374;6;380
75;Nouvelle-Aquitaine;47;3;10;037;Bournel;254;4;258
75;Nouvelle-Aquitaine;47;1;06;038;Bourran;611;25;636
75;Nouvelle-Aquitaine;47;4;08;039;Boussès;36;0;36
75;Nouvelle-Aquitaine;47;1;15;040;Brax;2100;47;2147
75;Nouvelle-Aquitaine;47;4;11;041;Bruch;729;17;746
75;Nouvelle-Aquitaine;47;2;18;042;Brugnac;182;6;188
75;Nouvelle-Aquitaine;47;4;11;043;Buzet-sur-Baïse;1257;27;1284
75;Nouvelle-Aquitaine;47;3;19;044;Cahuzac;310;6;316
75;Nouvelle-Aquitaine;47;4;05;045;Calignac;476;5;481
75;Nouvelle-Aquitaine;47;2;08;046;Calonges;595;13;608
75;Nouvelle-Aquitaine;47;2;07;047;Cambes;183;5;188
75;Nouvelle-Aquitaine;47;3;10;048;Cancon;1347;18;1365
75;Nouvelle-Aquitaine;47;3;12;049;Casseneuil;2402;50;2452
75;Nouvelle-Aquitaine;47;1;16;050;Cassignas;131;2;133
75;Nouvelle-Aquitaine;47;1;17;051;Castelculier;2391;48;2439
75;Nouvelle-Aquitaine;47;4;08;052;Casteljaloux;4521;54;4575
75;Nouvelle-Aquitaine;47;1;16;053;Castella;383;7;390
75;Nouvelle-Aquitaine;47;2;18;054;Castelmoron-sur-Lot;1796;22;1818
75;Nouvelle-Aquitaine;47;3;10;055;Castelnaud-de-Gratecambe;516;7;523
75;Nouvelle-Aquitaine;47;2;07;056;Castelnau-sur-Gupie;912;33;945
75;Nouvelle-Aquitaine;47;3;19;057;Castillonnès;1366;20;1386
75;Nouvelle-Aquitaine;47;4;08;058;Caubeyres;262;10;272
75;Nouvelle-Aquitaine;47;2;07;059;Caubon-Saint-Sauveur;262;4;266
75;Nouvelle-Aquitaine;47;1;17;060;Caudecoste;1136;23;1159
75;Nouvelle-Aquitaine;47;2;14;061;Caumont-sur-Garonne;789;8;797
75;Nouvelle-Aquitaine;47;1;16;062;Cauzac;413;4;417
75;Nouvelle-Aquitaine;47;3;19;063;Cavarc;163;2;165
75;Nouvelle-Aquitaine;47;3;09;064;Cazideroque;242;6;248
75;Nouvelle-Aquitaine;47;2;18;065;Clairac;2578;196;2774
75;Nouvelle-Aquitaine;47;1;06;066;Clermont-Dessous;878;18;896
75;Nouvelle-Aquitaine;47;1;17;067;Clermont-Soubiran;394;8;402
75;Nouvelle-Aquitaine;47;2;13;068;Cocumont;1089;23;1112
75;Nouvelle-Aquitaine;47;1;15;069;Colayrac-Saint-Cirq;3129;48;3177
75;Nouvelle-Aquitaine;47;3;09;070;Condezaygues;846;18;864
75;Nouvelle-Aquitaine;47;2;18;071;Coulx;244;2;246
75;Nouvelle-Aquitaine;47;3;09;072;Courbiac;108;3;111
75;Nouvelle-Aquitaine;47;1;06;073;Cours;196;6;202
75;Nouvelle-Aquitaine;47;2;13;074;Couthures-sur-Garonne;371;7;378
75;Nouvelle-Aquitaine;47;1;16;075;La Croix-Blanche;1094;24;1118
75;Nouvelle-Aquitaine;47;1;17;076;Cuq;280;5;285
75;Nouvelle-Aquitaine;47;3;09;077;Cuzorn;852;18;870
75;Nouvelle-Aquitaine;47;4;11;078;Damazan;1357;45;1402
75;Nouvelle-Aquitaine;47;3;16;079;Dausse;524;17;541
75;Nouvelle-Aquitaine;47;3;10;080;Dévillac;141;2;143
75;Nouvelle-Aquitaine;47;3;12;081;Dolmayrac;714;15;729
75;Nouvelle-Aquitaine;47;1;16;082;Dondas;215;1;216
75;Nouvelle-Aquitaine;47;3;10;083;Doudrac;106;1;107
75;Nouvelle-Aquitaine;47;3;19;084;Douzains;274;6;280
75;Nouvelle-Aquitaine;47;4;08;085;Durance;297;3;300
75;Nouvelle-Aquitaine;47;2;07;086;Duras;1214;22;1236
75;Nouvelle-Aquitaine;47;1;16;087;Engayrac;160;7;167
75;Nouvelle-Aquitaine;47;2;07;088;Escassefort;612;9;621
75;Nouvelle-Aquitaine;47;2;07;089;Esclottes;148;3;151
75;Nouvelle-Aquitaine;47;4;05;090;Espiens;363;8;371
75;Nouvelle-Aquitaine;47;1;15;091;Estillac;2278;44;2322
75;Nouvelle-Aquitaine;47;1;17;092;Fals;399;6;405
75;Nouvelle-Aquitaine;47;4;08;093;Fargues-sur-Ourbise;344;9;353
75;Nouvelle-Aquitaine;47;2;14;094;Fauguerolles;814;14;828
75;Nouvelle-Aquitaine;47;2;18;095;Fauillet;860;14;874
75;Nouvelle-Aquitaine;47;3;19;096;Ferrensac;204;5;209
75;Nouvelle-Aquitaine;47;4;11;097;Feugarolles;1007;18;1025
75;Nouvelle-Aquitaine;47;4;05;098;Fieux;346;15;361
75;Nouvelle-Aquitaine;47;3;12;099;Fongrave;620;16;636
75;Nouvelle-Aquitaine;47;1;01;100;Foulayronnes;5479;218;5697
75;Nouvelle-Aquitaine;47;2;14;101;Fourques-sur-Garonne;1333;27;1360
75;Nouvelle-Aquitaine;47;4;05;102;Francescas;738;11;749
75;Nouvelle-Aquitaine;47;4;05;103;Fréchou;228;3;231
75;Nouvelle-Aquitaine;47;1;06;104;Frégimont;259;5;264
75;Nouvelle-Aquitaine;47;3;16;105;Frespech;283;5;288
75;Nouvelle-Aquitaine;47;3;09;106;Fumel;4709;106;4815
75;Nouvelle-Aquitaine;47;1;06;107;Galapian;317;3;320
75;Nouvelle-Aquitaine;47;2;13;108;Gaujac;244;7;251
75;Nouvelle-Aquitaine;47;3;10;109;Gavaudun;295;5;300
75;Nouvelle-Aquitaine;47;2;14;110;Gontaud-de-Nogaret;1630;30;1660
75;Nouvelle-Aquitaine;47;1;06;111;Granges-sur-Lot;592;16;608
75;Nouvelle-Aquitaine;47;2;18;112;Grateloup-Saint-Gayrand;440;8;448
75;Nouvelle-Aquitaine;47;1;17;113;Grayssas;141;3;144
75;Nouvelle-Aquitaine;47;2;08;114;Grézet-Cavagnan;398;7;405
75;Nouvelle-Aquitaine;47;2;08;115;Guérin;251;6;257
75;Nouvelle-Aquitaine;47;3;21;117;Hautefage-la-Tour;1016;13;1029
75;Nouvelle-Aquitaine;47;2;18;118;Hautesvignes;180;4;184
75;Nouvelle-Aquitaine;47;4;08;119;Houeillès;550;9;559
75;Nouvelle-Aquitaine;47;2;07;120;Jusix;99;3;102
75;Nouvelle-Aquitaine;47;2;08;121;Labastide-Castel-Amouroux;307;3;310
75;Nouvelle-Aquitaine;47;2;18;122;Labretonie;180;2;182
75;Nouvelle-Aquitaine;47;3;09;123;Lacapelle-Biron;414;5;419
75;Nouvelle-Aquitaine;47;3;10;124;Lacaussade;209;5;214
75;Nouvelle-Aquitaine;47;1;06;125;Lacépède;313;7;320
75;Nouvelle-Aquitaine;47;2;07;126;Lachapelle;97;1;98
75;Nouvelle-Aquitaine;47;2;18;127;Lafitte-sur-Lot;812;11;823
75;Nouvelle-Aquitaine;47;1;17;128;Lafox;1104;30;1134
75;Nouvelle-Aquitaine;47;1;06;129;Lagarrigue;278;6;284
75;Nouvelle-Aquitaine;47;2;08;130;Lagruère;326;4;330
75;Nouvelle-Aquitaine;47;2;07;131;Lagupie;700;15;715
75;Nouvelle-Aquitaine;47;3;19;132;Lalandusse;224;3;227
75;Nouvelle-Aquitaine;47;4;05;133;Lamontjoie;586;11;597
75;Nouvelle-Aquitaine;47;4;05;134;Lannes;365;9;374
75;Nouvelle-Aquitaine;47;2;18;135;Laparade;389;8;397
75;Nouvelle-Aquitaine;47;2;19;136;Laperche;141;2;143
75;Nouvelle-Aquitaine;47;1;15;137;Laplume;1342;31;1373
75;Nouvelle-Aquitaine;47;1;16;138;Laroque-Timbaut;1597;24;1621
75;Nouvelle-Aquitaine;47;4;05;139;Lasserre;94;1;95
75;Nouvelle-Aquitaine;47;1;06;140;Laugnac;699;14;713
75;Nouvelle-Aquitaine;47;3;10;141;Laussou;279;6;285
75;Nouvelle-Aquitaine;47;2;19;142;Lauzun;739;12;751
75;Nouvelle-Aquitaine;47;4;11;143;Lavardac;2278;58;2336
75;Nouvelle-Aquitaine;47;2;19;144;Lavergne;564;20;584
75;Nouvelle-Aquitaine;47;1;17;145;Layrac;3726;55;3781
75;Nouvelle-Aquitaine;47;3;20;146;Lédat;1416;28;1444
75;Nouvelle-Aquitaine;47;2;07;147;Lévignac-de-Guyenne;685;12;697
75;Nouvelle-Aquitaine;47;4;08;148;Leyritz-Moncassin;203;1;204
75;Nouvelle-Aquitaine;47;2;14;150;Longueville;367;6;373
75;Nouvelle-Aquitaine;47;2;07;151;Loubès-Bernac;419;4;423
75;Nouvelle-Aquitaine;47;3;19;152;Lougratte;413;6;419
75;Nouvelle-Aquitaine;47;1;06;154;Lusignan-Petit;373;4;377
75;Nouvelle-Aquitaine;47;1;06;155;Madaillan;662;16;678
75;Nouvelle-Aquitaine;47;2;13;156;Marcellus;857;8;865
75;Nouvelle-Aquitaine;47;2;98;157;Marmande;17265;532;17797
75;Nouvelle-Aquitaine;47;1;15;158;Marmont-Pachas;171;5;176
75;Nouvelle-Aquitaine;47;2;08;159;Le Mas-d'Agenais;1482;34;1516
75;Nouvelle-Aquitaine;47;3;09;160;Masquières;182;2;184
75;Nouvelle-Aquitaine;47;3;16;161;Massels;116;1;117
75;Nouvelle-Aquitaine;47;3;16;162;Massoulès;216;5;221
75;Nouvelle-Aquitaine;47;2;07;163;Mauvezin-sur-Gupie;608;12;620
75;Nouvelle-Aquitaine;47;3;10;164;Mazières-Naresse;105;3;108
75;Nouvelle-Aquitaine;47;2;13;165;Meilhan-sur-Garonne;1338;59;1397
75;Nouvelle-Aquitaine;47;4;05;167;Mézin;1465;24;1489
75;Nouvelle-Aquitaine;47;2;19;168;Miramont-de-Guyenne;3087;103;3190
75;Nouvelle-Aquitaine;47;1;15;169;Moirax;1188;54;1242
75;Nouvelle-Aquitaine;47;3;10;170;Monbahus;625;23;648
75;Nouvelle-Aquitaine;47;1;16;171;Monbalen;445;8;453
75;Nouvelle-Aquitaine;47;4;05;172;Moncaut;587;18;605
75;Nouvelle-Aquitaine;47;3;12;173;Monclar;890;10;900
75;Nouvelle-Aquitaine;47;4;05;174;Moncrabeau;736;17;753
75;Nouvelle-Aquitaine;47;3;10;175;Monflanquin;2338;53;2391
75;Nouvelle-Aquitaine;47;4;11;176;Montgaillard-en-Albret;171;12;183
75;Nouvelle-Aquitaine;47;4;11;177;Monheurt;190;2;192
75;Nouvelle-Aquitaine;47;3;10;178;Monségur;401;5;406
75;Nouvelle-Aquitaine;47;3;09;179;Monsempron-Libos;2054;34;2088
75;Nouvelle-Aquitaine;47;4;05;180;Montagnac-sur-Auvignon;641;14;655
75;Nouvelle-Aquitaine;47;3;10;181;Montagnac-sur-Lède;271;3;274
75;Nouvelle-Aquitaine;47;3;12;182;Montastruc;241;1;242
75;Nouvelle-Aquitaine;47;3;19;183;Montauriol;185;2;187
75;Nouvelle-Aquitaine;47;3;10;184;Montaut;261;4;265
75;Nouvelle-Aquitaine;47;3;09;185;Montayral;2669;51;2720
75;Nouvelle-Aquitaine;47;4;11;186;Montesquieu;767;12;779
75;Nouvelle-Aquitaine;47;2;07;187;Monteton;327;2;329
75;Nouvelle-Aquitaine;47;2;19;188;Montignac-de-Lauzun;286;3;289
75;Nouvelle-Aquitaine;47;2;07;189;Montignac-Toupinerie;145;2;147
75;Nouvelle-Aquitaine;47;1;06;190;Montpezat;550;45;595
75;Nouvelle-Aquitaine;47;2;13;191;Montpouillan;836;16;852
75;Nouvelle-Aquitaine;47;3;10;192;Monviel;78;0;78
75;Nouvelle-Aquitaine;47;3;10;193;Moulinet;199;6;205
75;Nouvelle-Aquitaine;47;2;07;194;Moustier;317;5;322
75;Nouvelle-Aquitaine;47;4;05;195;Nérac;6854;511;7365
75;Nouvelle-Aquitaine;47;1;06;196;Nicole;223;1;224
75;Nouvelle-Aquitaine;47;4;05;197;Nomdieu;253;1;254
75;Nouvelle-Aquitaine;47;3;10;198;Pailloles;325;5;330
75;Nouvelle-Aquitaine;47;2;07;199;Pardaillan;323;11;334
75;Nouvelle-Aquitaine;47;3;10;200;Parranquet;114;1;115
75;Nouvelle-Aquitaine;47;1;04;201;Le Passage;9352;166;9518
75;Nouvelle-Aquitaine;47;3;10;202;Paulhiac;309;7;316
75;Nouvelle-Aquitaine;47;3;16;203;Penne-d'Agenais;2395;37;2432
75;Nouvelle-Aquitaine;47;2;19;204;Peyrière;284;3;287
75;Nouvelle-Aquitaine;47;4;08;205;Pindères;197;8;205
75;Nouvelle-Aquitaine;47;3;12;206;Pinel-Hauterive;570;5;575
75;Nouvelle-Aquitaine;47;4;11;207;Pompiey;203;4;207
75;Nouvelle-Aquitaine;47;4;08;208;Pompogne;198;6;204
75;Nouvelle-Aquitaine;47;1;01;209;Pont-du-Casse;4156;119;4275
75;Nouvelle-Aquitaine;47;1;06;210;Port-Sainte-Marie;1844;31;1875
75;Nouvelle-Aquitaine;47;4;05;211;Poudenas;207;7;214
75;Nouvelle-Aquitaine;47;2;08;212;Poussignac;288;6;294
75;Nouvelle-Aquitaine;47;1;06;213;Prayssas;991;26;1017
75;Nouvelle-Aquitaine;47;4;11;214;Puch-d'Agenais;692;16;708
75;Nouvelle-Aquitaine;47;3;21;215;Pujols;3717;119;3836
75;Nouvelle-Aquitaine;47;2;07;216;Puymiclan;681;12;693
75;Nouvelle-Aquitaine;47;1;17;217;Puymirol;913;15;928
75;Nouvelle-Aquitaine;47;2;19;218;Puysserampion;237;4;241
75;Nouvelle-Aquitaine;47;3;10;219;Rayet;180;2;182
75;Nouvelle-Aquitaine;47;4;11;220;Razimet;292;5;297
75;Nouvelle-Aquitaine;47;4;05;221;Réaup-Lisse;602;14;616
75;Nouvelle-Aquitaine;47;4;08;222;La Réunion;497;9;506
75;Nouvelle-Aquitaine;47;3;10;223;Rives;201;6;207
75;Nouvelle-Aquitaine;47;2;08;224;Romestaing;159;6;165
75;Nouvelle-Aquitaine;47;1;15;225;Roquefort;2126;43;2169
75;Nouvelle-Aquitaine;47;2;19;226;Roumagne;522;8;530
75;Nouvelle-Aquitaine;47;2;08;227;Ruffiac;180;2;182
75;Nouvelle-Aquitaine;47;3;21;228;Saint-Antoine-de-Ficalba;715;10;725
75;Nouvelle-Aquitaine;47;2;07;229;Saint-Astier;223;5;228
75;Nouvelle-Aquitaine;47;3;10;230;Saint-Aubin;389;7;396
75;Nouvelle-Aquitaine;47;2;07;231;Saint-Avit;175;2;177
75;Nouvelle-Aquitaine;47;2;07;232;Saint-Barthélemy-d'Agenais;518;3;521
75;Nouvelle-Aquitaine;47;2;13;233;Sainte-Bazeille;3174;94;3268
75;Nouvelle-Aquitaine;47;1;17;234;Saint-Caprais-de-Lerm;675;20;695
75;Nouvelle-Aquitaine;47;2;19;235;Saint-Colomb-de-Lauzun;472;7;479
75;Nouvelle-Aquitaine;47;2;07;236;Sainte-Colombe-de-Duras;104;2;106
75;Nouvelle-Aquitaine;47;3;21;237;Sainte-Colombe-de-Villeneuve;505;11;516
75;Nouvelle-Aquitaine;47;1;15;238;Sainte-Colombe-en-Bruilhois;1548;51;1599
75;Nouvelle-Aquitaine;47;3;12;239;Saint-Étienne-de-Fougères;853;15;868
75;Nouvelle-Aquitaine;47;3;10;240;Saint-Étienne-de-Villeréal;270;10;280
75;Nouvelle-Aquitaine;47;3;10;241;Saint-Eutrope-de-Born;680;18;698
75;Nouvelle-Aquitaine;47;3;09;242;Saint-Front-sur-Lémance;516;13;529
75;Nouvelle-Aquitaine;47;2;08;244;Sainte-Gemme-Martaillac;387;5;392
75;Nouvelle-Aquitaine;47;2;07;245;Saint-Géraud;91;2;93
75;Nouvelle-Aquitaine;47;1;15;246;Saint-Hilaire-de-Lusignan;1496;39;1535
75;Nouvelle-Aquitaine;47;2;07;247;Saint-Jean-de-Duras;245;10;255
75;Nouvelle-Aquitaine;47;1;17;248;Saint-Jean-de-Thurac;567;10;577
75;Nouvelle-Aquitaine;47;4;11;249;Saint-Laurent;522;2;524
75;Nouvelle-Aquitaine;47;4;11;250;Saint-Léger;118;4;122
75;Nouvelle-Aquitaine;47;4;11;251;Saint-Léon;319;4;323
75;Nouvelle-Aquitaine;47;3;12;252;Sainte-Livrade-sur-Lot;6487;173;6660
75;Nouvelle-Aquitaine;47;2;08;253;Sainte-Marthe;657;4;661
75;Nouvelle-Aquitaine;47;4;08;254;Saint-Martin-Curton;306;8;314
75;Nouvelle-Aquitaine;47;1;16;255;Saint-Martin-de-Beauville;168;2;170
75;Nouvelle-Aquitaine;47;3;10;256;Saint-Martin-de-Villeréal;104;4;108
75;Nouvelle-Aquitaine;47;2;07;257;Saint-Martin-Petit;617;9;626
75;Nouvelle-Aquitaine;47;4;05;258;Sainte-Maure-de-Peyriac;310;11;321
75;Nouvelle-Aquitaine;47;3;10;259;Saint-Maurice-de-Lestapel;103;4;107
75;Nouvelle-Aquitaine;47;1;16;260;Saint-Maurin;396;5;401
75;Nouvelle-Aquitaine;47;1;17;262;Saint-Nicolas-de-la-Balerme;424;6;430
75;Nouvelle-Aquitaine;47;2;14;263;Saint-Pardoux-du-Breuil;606;15;621
75;Nouvelle-Aquitaine;47;2;19;264;Saint-Pardoux-Isaac;1090;19;1109
75;Nouvelle-Aquitaine;47;3;12;265;Saint-Pastour;372;8;380
75;Nouvelle-Aquitaine;47;4;05;266;Saint-Pé-Saint-Simon;192;2;194
75;Nouvelle-Aquitaine;47;4;11;267;Saint-Pierre-de-Buzet;289;2;291
75;Nouvelle-Aquitaine;47;1;17;269;Saint-Pierre-de-Clairac;845;19;864
75;Nouvelle-Aquitaine;47;2;07;271;Saint-Pierre-sur-Dropt;356;3;359
75;Nouvelle-Aquitaine;47;3;19;272;Saint-Quentin-du-Dropt;195;7;202
75;Nouvelle-Aquitaine;47;1;16;273;Saint-Robert;187;6;193
75;Nouvelle-Aquitaine;47;1;17;274;Saint-Romain-le-Noble;393;6;399
75;Nouvelle-Aquitaine;47;1;06;275;Saint-Salvy;201;1;202
75;Nouvelle-Aquitaine;47;1;06;276;Saint-Sardos;301;7;308
75;Nouvelle-Aquitaine;47;2;13;277;Saint-Sauveur-de-Meilhan;342;1;343
75;Nouvelle-Aquitaine;47;2;07;278;Saint-Sernin;478;9;487
75;Nouvelle-Aquitaine;47;1;17;279;Saint-Sixte;359;5;364
75;Nouvelle-Aquitaine;47;3;16;280;Saint-Sylvestre-sur-Lot;2367;53;2420
75;Nouvelle-Aquitaine;47;1;17;281;Saint-Urcisse;252;1;253
75;Nouvelle-Aquitaine;47;4;05;282;Saint-Vincent-de-Lamontjoie;231;7;238
75;Nouvelle-Aquitaine;47;3;09;283;Saint-Vite;1164;31;1195
75;Nouvelle-Aquitaine;47;3;10;284;Salles;287;7;294
75;Nouvelle-Aquitaine;47;2;14;285;Samazan;897;17;914
75;Nouvelle-Aquitaine;47;4;08;286;Sauméjan;100;5;105
75;Nouvelle-Aquitaine;47;4;05;287;Saumont;258;8;266
75;Nouvelle-Aquitaine;47;1;17;288;Sauvagnas;522;14;536
75;Nouvelle-Aquitaine;47;1;16;289;La Sauvetat-de-Savères;510;7;517
75;Nouvelle-Aquitaine;47;2;07;290;La Sauvetat-du-Dropt;557;6;563
75;Nouvelle-Aquitaine;47;3;10;291;La Sauvetat-sur-Lède;628;16;644
75;Nouvelle-Aquitaine;47;3;09;292;Sauveterre-la-Lémance;576;6;582
75;Nouvelle-Aquitaine;47;1;17;293;Sauveterre-Saint-Denis;382;18;400
75;Nouvelle-Aquitaine;47;2;07;294;Savignac-de-Duras;217;1;218
75;Nouvelle-Aquitaine;47;3;10;295;Savignac-sur-Leyze;305;6;311
75;Nouvelle-Aquitaine;47;2;19;296;Ségalas;155;2;157
75;Nouvelle-Aquitaine;47;3;06;297;Sembas;141;3;144
75;Nouvelle-Aquitaine;47;2;08;298;Sénestis;209;0;209
75;Nouvelle-Aquitaine;47;3;19;299;Sérignac-Péboudou;173;2;175
75;Nouvelle-Aquitaine;47;1;15;300;Sérignac-sur-Garonne;1169;19;1188
75;Nouvelle-Aquitaine;47;2;07;301;Seyches;1058;12;1070
75;Nouvelle-Aquitaine;47;4;05;302;Sos;653;6;659
75;Nouvelle-Aquitaine;47;2;07;303;Soumensac;226;3;229
75;Nouvelle-Aquitaine;47;2;14;304;Taillebourg;60;2;62
75;Nouvelle-Aquitaine;47;1;16;305;Tayrac;382;6;388
75;Nouvelle-Aquitaine;47;3;12;306;Le Temple-sur-Lot;1059;19;1078
75;Nouvelle-Aquitaine;47;3;09;307;Thézac;200;5;205
75;Nouvelle-Aquitaine;47;4;11;308;Thouars-sur-Garonne;223;2;225
75;Nouvelle-Aquitaine;47;3;12;309;Tombebœuf;456;4;460
75;Nouvelle-Aquitaine;47;2;18;310;Tonneins;9213;158;9371
75;Nouvelle-Aquitaine;47;3;10;311;Tourliac;135;2;137
75;Nouvelle-Aquitaine;47;3;09;312;Tournon-d'Agenais;764;13;777
75;Nouvelle-Aquitaine;47;3;12;313;Tourtrès;140;1;141
75;Nouvelle-Aquitaine;47;3;16;314;Trémons;400;11;411
75;Nouvelle-Aquitaine;47;3;09;315;Trentels;911;25;936
75;Nouvelle-Aquitaine;47;2;18;316;Varès;663;7;670
75;Nouvelle-Aquitaine;47;2;18;317;Verteuil-d'Agenais;550;5;555
75;Nouvelle-Aquitaine;47;4;11;318;Vianne;988;16;1004
75;Nouvelle-Aquitaine;47;3;12;319;Villebramar;111;3;114
75;Nouvelle-Aquitaine;47;4;08;320;Villefranche-du-Queyran;397;2;399
75;Nouvelle-Aquitaine;47;2;07;321;Villeneuve-de-Duras;319;5;324
75;Nouvelle-Aquitaine;47;3;99;323;Villeneuve-sur-Lot;21690;695;22385
75;Nouvelle-Aquitaine;47;3;10;324;Villeréal;1275;32;1307
75;Nouvelle-Aquitaine;47;2;08;325;Villeton;458;6;464
75;Nouvelle-Aquitaine;47;2;14;326;Virazeil;1676;35;1711
75;Nouvelle-Aquitaine;47;4;11;327;Xaintrailles;388;11;399
75;Nouvelle-Aquitaine;47;3;09;328;Saint-Georges;545;19;564
76;Occitanie;48;2;01;001;Albaret-le-Comtal;164;1;165
76;Occitanie;48;2;12;002;Albaret-Sainte-Marie;557;21;578
76;Occitanie;48;2;06;003;Allenc;257;6;263
76;Occitanie;48;2;13;004;Altier;219;6;225
76;Occitanie;48;2;08;005;Antrenas;327;4;331
76;Occitanie;48;2;01;007;Arzenc-d'Apcher;50;0;50
76;Occitanie;48;2;06;008;Arzenc-de-Randon;191;8;199
76;Occitanie;48;2;01;009;Peyre en Aubrac;2295;98;2393
76;Occitanie;48;2;07;010;Auroux;365;6;371
76;Occitanie;48;2;01;012;Les Monts-Verts;342;6;348
76;Occitanie;48;2;06;013;Badaroux;986;41;1027
76;Occitanie;48;2;13;015;Pied-de-Borne;176;8;184
76;Occitanie;48;2;03;016;Balsièges;566;18;584
76;Occitanie;48;2;02;017;Banassac-Canilhac;1078;36;1114
76;Occitanie;48;2;03;018;Barjac;773;19;792
76;Occitanie;48;1;04;019;Barre-des-Cévennes;204;7;211
76;Occitanie;48;1;04;020;Bassurels;67;0;67
76;Occitanie;48;2;13;021;La Bastide-Puylaurent;162;5;167
76;Occitanie;48;2;01;025;Les Bessons;420;24;444
76;Occitanie;48;2;12;026;Blavignac;266;1;267
76;Occitanie;48;2;13;027;Mont Lozère et Goulet;1062;30;1092
76;Occitanie;48;1;13;028;Les Bondons;145;7;152
76;Occitanie;48;2;06;029;Le Born;151;3;154
76;Occitanie;48;2;13;030;Brenoux;389;7;396
76;Occitanie;48;2;01;031;Brion;80;4;84
76;Occitanie;48;2;01;032;Le Buisson;220;6;226
76;Occitanie;48;2;02;034;La Canourgue;2099;98;2197
76;Occitanie;48;1;04;036;Cassagnas;125;2;127
76;Occitanie;48;2;06;037;Chadenet;120;1;121
76;Occitanie;48;2;06;038;Bel-Air-Val-d'Ance;545;7;552
76;Occitanie;48;2;02;039;Chanac;1452;44;1496
76;Occitanie;48;2;07;041;Chastanier;77;2;79
76;Occitanie;48;2;11;042;Chastel-Nouvel;918;34;952
76;Occitanie;48;2;06;043;Châteauneuf-de-Randon;524;7;531
76;Occitanie;48;2;01;044;Chauchailles;85;2;87
76;Occitanie;48;2;06;045;Chaudeyrac;291;9;300
76;Occitanie;48;2;11;046;Chaulhac;64;4;68
76;Occitanie;48;2;07;048;Cheylard-l'Évêque;63;2;65
76;Occitanie;48;1;13;050;Bédouès-Cocurès;451;12;463
76;Occitanie;48;1;04;051;Le Collet-de-Dèze;686;48;734
76;Occitanie;48;2;13;053;Cubières;193;8;201
76;Occitanie;48;2;13;054;Cubiérettes;48;5;53
76;Occitanie;48;2;03;055;Cultures;190;4;194
76;Occitanie;48;2;03;056;Esclanèdes;411;8;419
76;Occitanie;48;2;01;058;La Fage-Montivernoux;148;4;152
76;Occitanie;48;2;01;059;La Fage-Saint-Julien;306;8;314
76;Occitanie;48;1;05;061;Florac Trois Rivières;2082;54;2136
76;Occitanie;48;2;11;063;Fontans;231;3;234
76;Occitanie;48;2;01;064;Fournels;369;7;376
76;Occitanie;48;1;04;065;Fraissinet-de-Fourques;80;0;80
76;Occitanie;48;1;04;067;Gabriac;100;2;102
76;Occitanie;48;2;03;068;Gabrias;160;6;166
76;Occitanie;48;1;05;069;Gatuzières;52;0;52
76;Occitanie;48;2;06;070;Grandrieu;751;18;769
76;Occitanie;48;2;01;071;Grandvals;63;1;64
76;Occitanie;48;2;03;072;Grèzes;236;6;242
76;Occitanie;48;2;01;073;Les Hermaux;94;2;96
76;Occitanie;48;1;05;074;Hures-la-Parade;226;11;237
76;Occitanie;48;1;05;075;Ispagnac;900;25;925
76;Occitanie;48;2;11;077;Julianges;47;2;49
76;Occitanie;48;2;11;079;Lajo;116;3;119
76;Occitanie;48;2;07;080;Langogne;2875;194;3069
76;Occitanie;48;2;13;081;Lanuéjols;334;9;343
76;Occitanie;48;2;06;082;Laubert;100;2;102
76;Occitanie;48;2;11;083;Les Laubies;151;3;154
76;Occitanie;48;2;02;085;Laval-du-Tarn;93;4;97
76;Occitanie;48;2;07;086;Luc;206;7;213
76;Occitanie;48;2;01;087;Prinsuéjols-Malbouzon;264;10;274
76;Occitanie;48;1;02;088;La Malène;134;5;139
76;Occitanie;48;2;11;089;Le Malzieu-Forain;497;10;507
76;Occitanie;48;2;11;090;Le Malzieu-Ville;735;18;753
76;Occitanie;48;2;01;091;Marchastel;46;3;49
76;Occitanie;48;2;08;092;Marvejols;4713;243;4956
76;Occitanie;48;1;02;094;Massegros Causses Gorges;944;28;972
76;Occitanie;48;2;99;095;Mende;12336;807;13143
76;Occitanie;48;1;05;096;Meyrueis;794;113;907
76;Occitanie;48;1;04;097;Moissac-Vallée-Française;217;10;227
76;Occitanie;48;1;04;098;Molezon;97;4;101
76;Occitanie;48;2;03;099;Bourgs sur Colagne;2091;46;2137
76;Occitanie;48;2;06;100;Montbel;127;1;128
76;Occitanie;48;2;03;103;Montrodat;1176;69;1245
76;Occitanie;48;2;01;104;Nasbinals;564;33;597
76;Occitanie;48;2;07;105;Naussac-Fontanes;373;15;388
76;Occitanie;48;2;01;106;Noalhac;95;7;102
76;Occitanie;48;2;03;107;Palhers;177;5;182
76;Occitanie;48;2;06;108;La Panouse;76;2;78
76;Occitanie;48;2;11;110;Paulhac-en-Margeride;102;4;106
76;Occitanie;48;2;06;111;Pelouse;235;5;240
76;Occitanie;48;2;06;112;Pierrefiche;164;3;167
76;Occitanie;48;1;04;115;Le Pompidou;166;4;170
76;Occitanie;48;1;13;116;Pont de Montvert - Sud Mont Lozère;554;18;572
76;Occitanie;48;2;13;117;Pourcharesses;123;4;127
76;Occitanie;48;2;13;119;Prévenchères;257;8;265
76;Occitanie;48;2;12;121;Prunières;231;10;241
76;Occitanie;48;2;01;123;Recoules-d'Aubrac;169;6;175
76;Occitanie;48;2;08;124;Recoules-de-Fumas;103;1;104
76;Occitanie;48;2;08;126;Lachamp-Ribennes;363;11;374
76;Occitanie;48;2;11;127;Monts-de-Randon;1264;25;1289
76;Occitanie;48;2;12;128;Rimeize;597;20;617
76;Occitanie;48;2;07;129;Rocles;227;4;231
76;Occitanie;48;1;04;130;Rousses;127;2;129
76;Occitanie;48;1;05;131;Le Rozier;132;7;139
76;Occitanie;48;2;11;132;Saint-Alban-sur-Limagnole;1378;33;1411
76;Occitanie;48;2;13;135;Saint-André-Capcèze;190;2;192
76;Occitanie;48;1;04;136;Saint-André-de-Lancize;154;2;156
76;Occitanie;48;2;13;137;Saint-Bauzile;612;20;632
76;Occitanie;48;2;03;138;Saint-Bonnet-de-Chirac;67;2;69
76;Occitanie;48;2;07;139;Saint Bonnet-Laval;253;2;255
76;Occitanie;48;2;12;140;Saint-Chély-d'Apcher;4220;594;4814
76;Occitanie;48;1;05;141;Mas-Saint-Chély;105;6;111
76;Occitanie;48;1;04;144;Sainte-Croix-Vallée-Française;284;5;289
76;Occitanie;48;2;11;145;Saint-Denis-en-Margeride;153;7;160
76;Occitanie;48;1;05;146;Gorges du Tarn Causses;905;33;938
76;Occitanie;48;2;13;147;Saint-Étienne-du-Valdonnez;640;50;690
76;Occitanie;48;1;04;148;Saint-Étienne-Vallée-Française;502;24;526
76;Occitanie;48;2;11;149;Sainte-Eulalie;35;2;37
76;Occitanie;48;2;07;150;Saint-Flour-de-Mercoire;186;14;200
76;Occitanie;48;2;06;151;Saint-Frézal-d'Albuges;60;3;63
76;Occitanie;48;1;04;152;Ventalon en Cévennes;263;5;268
76;Occitanie;48;2;11;153;Saint-Gal;88;5;93
76;Occitanie;48;1;04;155;Saint-Germain-de-Calberte;468;8;476
76;Occitanie;48;2;03;156;Saint-Germain-du-Teil;860;23;883
76;Occitanie;48;2;06;157;Sainte-Hélène;104;2;106
76;Occitanie;48;1;04;158;Saint-Hilaire-de-Lavit;98;5;103
76;Occitanie;48;2;06;160;Saint-Jean-la-Fouillouse;146;6;152
76;Occitanie;48;2;01;161;Saint-Juéry;64;2;66
76;Occitanie;48;1;04;163;Saint-Julien-des-Points;117;3;120
76;Occitanie;48;2;01;165;Saint-Laurent-de-Muret;187;9;196
76;Occitanie;48;1;04;166;Cans et Cévennes;290;12;302
76;Occitanie;48;2;01;167;Saint-Laurent-de-Veyrès;37;1;38
76;Occitanie;48;2;08;168;Saint-Léger-de-Peyre;190;5;195
76;Occitanie;48;2;11;169;Saint-Léger-du-Malzieu;207;11;218
76;Occitanie;48;1;04;170;Saint-Martin-de-Boubaux;196;5;201
76;Occitanie;48;1;04;171;Saint-Martin-de-Lansuscle;193;2;195
76;Occitanie;48;1;04;173;Saint-Michel-de-Dèze;229;3;232
76;Occitanie;48;2;06;174;Saint-Paul-le-Froid;139;4;143
76;Occitanie;48;2;01;175;Saint-Pierre-de-Nogaret;174;9;183
76;Occitanie;48;1;05;176;Saint-Pierre-des-Tripiers;91;4;95
76;Occitanie;48;2;12;177;Saint-Pierre-le-Vieux;319;9;328
76;Occitanie;48;1;04;178;Saint-Privat-de-Vallongue;223;7;230
76;Occitanie;48;2;11;179;Saint-Privat-du-Fau;109;2;111
76;Occitanie;48;2;02;181;Saint-Saturnin;62;4;66
76;Occitanie;48;2;06;182;Saint-Sauveur-de-Ginestoux;58;0;58
76;Occitanie;48;2;03;185;Les Salelles;166;5;171
76;Occitanie;48;2;01;187;Les Salces;103;1;104
76;Occitanie;48;2;11;188;Serverette;246;4;250
76;Occitanie;48;2;01;190;Termes;217;8;225
76;Occitanie;48;2;02;191;La Tieule;95;3;98
76;Occitanie;48;2;01;192;Trélans;91;1;92
76;Occitanie;48;1;04;193;Vebron;216;0;216
76;Occitanie;48;1;13;194;Vialas;429;40;469
76;Occitanie;48;2;13;198;Villefort;570;16;586
52;Pays de la Loire;49;3;15;002;Allonnes;2947;49;2996
52;Pays de la Loire;49;3;14;003;Tuffalun;1743;37;1780
52;Pays de la Loire;49;1;98;007;Angers;155876;3227;159103
52;Pays de la Loire;49;4;20;008;Angrie;922;24;946
52;Pays de la Loire;49;3;14;009;Antoigné;460;4;464
52;Pays de la Loire;49;4;20;010;Armaillé;319;5;324
52;Pays de la Loire;49;3;19;011;Artannes-sur-Thouet;422;7;429
52;Pays de la Loire;49;1;11;012;Aubigné-sur-Layon;365;7;372
52;Pays de la Loire;49;1;04;015;Avrillé;14727;391;15118
52;Pays de la Loire;49;1;21;017;Baracé;612;2;614
52;Pays de la Loire;49;3;08;018;Baugé-en-Anjou;11735;243;11978
52;Pays de la Loire;49;1;03;020;Beaucouzé;5528;107;5635
52;Pays de la Loire;49;3;08;021;Beaufort-en-Anjou;7096;146;7242
52;Pays de la Loire;49;1;11;022;Beaulieu-sur-Layon;1359;29;1388
52;Pays de la Loire;49;2;09;023;Beaupréau-en-Mauges;23465;702;24167
52;Pays de la Loire;49;4;10;026;Bécon-les-Granits;2784;90;2874
52;Pays de la Loire;49;2;09;027;Bégrolles-en-Mauges;2126;41;2167
52;Pays de la Loire;49;1;03;028;Béhuard;126;6;132
52;Pays de la Loire;49;1;17;029;Blaison-Saint-Sulpice;1302;29;1331
52;Pays de la Loire;49;3;15;030;Blou;955;32;987
52;Pays de la Loire;49;1;02;035;Bouchemaine;6757;140;6897
52;Pays de la Loire;49;4;20;036;Bouillé-Ménard;755;17;772
52;Pays de la Loire;49;4;20;038;Bourg-l'Évêque;234;4;238
52;Pays de la Loire;49;3;15;041;Brain-sur-Allonnes;2046;36;2082
52;Pays de la Loire;49;3;15;045;La Breille-les-Pins;600;13;613
52;Pays de la Loire;49;1;05;048;Briollay;3129;41;3170
52;Pays de la Loire;49;1;86;050;Brissac Loire Aubance;10906;273;11179
52;Pays de la Loire;49;3;14;053;Brossay;347;5;352
52;Pays de la Loire;49;4;20;054;Candé;2821;49;2870
52;Pays de la Loire;49;1;05;055;Cantenay-Épinard;2362;36;2398
52;Pays de la Loire;49;4;20;056;Carbay;267;3;270
52;Pays de la Loire;49;2;13;057;Cernusson;334;6;340
52;Pays de la Loire;49;2;13;058;Les Cerqueux;883;7;890
52;Pays de la Loire;49;3;14;060;Bellevigne-les-Châteaux;3471;79;3550
52;Pays de la Loire;49;4;20;061;Challain-la-Potherie;795;15;810
52;Pays de la Loire;49;1;10;063;Chalonnes-sur-Loire;6475;174;6649
52;Pays de la Loire;49;4;21;064;Chambellay;394;12;406
52;Pays de la Loire;49;4;21;067;Chenillé-Champteussé;342;6;348
52;Pays de la Loire;49;1;10;068;Champtocé-sur-Loire;1855;31;1886
52;Pays de la Loire;49;2;16;069;Orée d'Anjou;16468;308;16776
52;Pays de la Loire;49;2;13;070;Chanteloup-les-Bois;692;10;702
52;Pays de la Loire;49;1;06;076;La Chapelle-Saint-Laud;782;11;793
52;Pays de la Loire;49;4;21;080;Les Hauts-d'Anjou;8743;152;8895
52;Pays de la Loire;49;1;10;082;Chaudefonds-sur-Layon;932;17;949
52;Pays de la Loire;49;1;11;086;Terranjou;3950;73;4023
52;Pays de la Loire;49;4;20;089;Chazé-sur-Argos;1052;28;1080
52;Pays de la Loire;49;1;21;090;Cheffes;995;8;1003
52;Pays de la Loire;49;2;11;092;Chemillé-en-Anjou;21187;624;21811
52;Pays de la Loire;49;2;99;099;Cholet;54357;1929;56286
52;Pays de la Loire;49;3;14;100;Cizay-la-Madeleine;470;17;487
52;Pays de la Loire;49;2;13;102;Cléré-sur-Layon;341;5;346
52;Pays de la Loire;49;1;06;107;Cornillé-les-Caves;471;15;486
52;Pays de la Loire;49;2;13;109;Coron;1566;29;1595
52;Pays de la Loire;49;1;06;110;Corzé;1907;33;1940
52;Pays de la Loire;49;3;14;112;Le Coudray-Macouard;961;27;988
52;Pays de la Loire;49;3;14;113;Courchamps;527;9;536
52;Pays de la Loire;49;3;15;114;Courléon;142;4;146
52;Pays de la Loire;49;1;10;120;Denée;1405;29;1434
52;Pays de la Loire;49;3;14;121;Dénezé-sous-Doué;464;8;472
52;Pays de la Loire;49;3;19;123;Distré;1746;56;1802
52;Pays de la Loire;49;3;14;125;Doué-en-Anjou;11224;248;11472
52;Pays de la Loire;49;1;21;127;Durtal;3343;74;3417
52;Pays de la Loire;49;1;05;129;Écouflant;4454;59;4513
52;Pays de la Loire;49;1;05;130;Écuillé;673;7;680
52;Pays de la Loire;49;3;14;131;Épieds;720;7;727
52;Pays de la Loire;49;1;21;132;Étriché;1548;17;1565
52;Pays de la Loire;49;1;05;135;Feneu;2188;40;2228
52;Pays de la Loire;49;3;08;138;Les Bois d'Anjou;2574;52;2626
52;Pays de la Loire;49;3;19;140;Fontevraud-l'Abbaye;1515;23;1538
52;Pays de la Loire;49;4;21;155;Grez-Neuville;1423;40;1463
52;Pays de la Loire;49;1;10;160;Ingrandes-Le Fresne sur Loire;2687;60;2747
52;Pays de la Loire;49;4;21;161;La Jaille-Yvon;342;6;348
52;Pays de la Loire;49;1;06;163;Jarzé Villages;2766;31;2797
52;Pays de la Loire;49;1;17;167;Les Garennes sur Loire;4614;109;4723
52;Pays de la Loire;49;4;21;170;Juvardeil;814;12;826
52;Pays de la Loire;49;3;15;171;La Lande-Chasles;122;2;124
52;Pays de la Loire;49;1;06;174;Huillé-Lézigné;1318;22;1340
52;Pays de la Loire;49;4;21;176;Le Lion-d'Angers;5201;77;5278
52;Pays de la Loire;49;4;20;178;Loiré;882;21;903
52;Pays de la Loire;49;3;15;180;Longué-Jumelles;6759;106;6865
52;Pays de la Loire;49;3;14;182;Louresse-Rochemenier;893;16;909
52;Pays de la Loire;49;4;10;183;Val d'Erdre-Auxence;4908;79;4987
52;Pays de la Loire;49;1;06;188;Marcé;836;15;851
52;Pays de la Loire;49;2;13;192;Maulévrier;3204;79;3283
52;Pays de la Loire;49;2;18;193;Le May-sur-Èvre;3827;91;3918
52;Pays de la Loire;49;3;08;194;Mazé-Milon;5860;92;5952
52;Pays de la Loire;49;2;13;195;Mazières-en-Mauges;1265;30;1295
52;Pays de la Loire;49;1;89;200;Longuenée-en-Anjou;6334;172;6506
52;Pays de la Loire;49;3;07;201;La Ménitré;2043;39;2082
52;Pays de la Loire;49;4;21;205;Miré;999;10;1009
52;Pays de la Loire;49;1;21;209;Montigné-lès-Rairies;446;3;449
52;Pays de la Loire;49;2;13;211;Montilliers;1220;20;1240
52;Pays de la Loire;49;1;04;214;Montreuil-Juigné;7791;151;7942
52;Pays de la Loire;49;3;14;215;Montreuil-Bellay;3705;250;3955
52;Pays de la Loire;49;1;06;216;Montreuil-sur-Loir;581;9;590
52;Pays de la Loire;49;4;21;217;Montreuil-sur-Maine;770;10;780
52;Pays de la Loire;49;2;09;218;Montrevault-sur-Èvre;15732;306;16038
52;Pays de la Loire;49;3;19;219;Montsoreau;423;6;429
52;Pays de la Loire;49;1;21;220;Morannes sur Sarthe-Daumeray;3669;45;3714
52;Pays de la Loire;49;3;15;221;Mouliherne;808;23;831
52;Pays de la Loire;49;1;11;222;Mozé-sur-Louet;2028;45;2073
52;Pays de la Loire;49;1;17;223;Mûrs-Erigné;5661;99;5760
52;Pays de la Loire;49;3;15;224;Neuillé;988;11;999
52;Pays de la Loire;49;3;08;228;Noyant-Villages;5529;117;5646
52;Pays de la Loire;49;2;13;231;Nuaillé;1443;38;1481
52;Pays de la Loire;49;3;19;235;Parnay;408;6;414
52;Pays de la Loire;49;2;13;236;Passavant-sur-Layon;127;2;129
52;Pays de la Loire;49;3;08;237;La Pellerine;129;2;131
52;Pays de la Loire;49;2;13;240;La Plaine;1000;31;1031
52;Pays de la Loire;49;1;07;241;Le Plessis-Grammoire;2594;51;2645
52;Pays de la Loire;49;2;16;244;Mauges-sur-Loire;18083;476;18559
52;Pays de la Loire;49;1;17;246;Les Ponts-de-Cé;12589;534;13123
52;Pays de la Loire;49;1;10;247;La Possonnière;2448;42;2490
52;Pays de la Loire;49;4;20;248;Ombrée d'Anjou;8908;209;9117
52;Pays de la Loire;49;3;14;253;Le Puy-Notre-Dame;1154;23;1177
52;Pays de la Loire;49;1;21;257;Les Rairies;1033;14;1047
52;Pays de la Loire;49;1;10;259;Rochefort-sur-Loire;2307;56;2363
52;Pays de la Loire;49;2;18;260;La Romagne;1961;83;2044
52;Pays de la Loire;49;3;85;261;Gennes-Val-de-Loire;8480;167;8647
52;Pays de la Loire;49;3;19;262;Rou-Marson;649;24;673
52;Pays de la Loire;49;4;10;266;Saint-Augustin-des-Bois;1247;29;1276
52;Pays de la Loire;49;1;06;267;Saint-Barthélemy-d'Anjou;9207;226;9433
52;Pays de la Loire;49;2;18;269;Saint-Christophe-du-Bois;2873;61;2934
52;Pays de la Loire;49;1;03;271;Saint-Clément-de-la-Place;2094;28;2122
52;Pays de la Loire;49;3;15;272;Saint-Clément-des-Levées;1097;15;1112
52;Pays de la Loire;49;1;02;278;Sainte-Gemmes-sur-Loire;3515;253;3768
52;Pays de la Loire;49;1;10;283;Saint-Georges-sur-Loire;3706;40;3746
52;Pays de la Loire;49;1;10;284;Saint-Germain-des-Prés;1402;20;1422
52;Pays de la Loire;49;1;17;288;Saint-Jean-de-la-Croix;224;6;230
52;Pays de la Loire;49;3;14;291;Saint-Just-sur-Dive;375;4;379
52;Pays de la Loire;49;1;11;292;Val-du-Layon;3455;48;3503
52;Pays de la Loire;49;1;03;294;Saint-Lambert-la-Potherie;2932;30;2962
52;Pays de la Loire;49;1;03;298;Saint-Léger-de-Linières;3749;65;3814
52;Pays de la Loire;49;2;18;299;Saint-Léger-sous-Cholet;3062;71;3133
52;Pays de la Loire;49;2;18;301;Sèvremoine;25519;576;26095
52;Pays de la Loire;49;3;14;302;Saint-Macaire-du-Bois;449;5;454
52;Pays de la Loire;49;1;03;306;Saint-Martin-du-Fouilloux;1668;36;1704
52;Pays de la Loire;49;1;07;307;Loire-Authion;16293;565;16858
52;Pays de la Loire;49;1;17;308;Saint-Melaine-sur-Aubance;2172;54;2226
52;Pays de la Loire;49;2;13;310;Saint-Paul-du-Bois;601;19;620
52;Pays de la Loire;49;3;15;311;Saint-Philbert-du-Peuple;1328;27;1355
52;Pays de la Loire;49;4;10;321;Saint-Sigismond;390;8;398
52;Pays de la Loire;49;1;06;323;Verrières-en-Anjou;7534;302;7836
52;Pays de la Loire;49;1;07;326;Sarrigné;829;19;848
52;Pays de la Loire;49;3;19;328;Saumur;26154;958;27112
52;Pays de la Loire;49;1;03;329;Savennières;1337;50;1387
52;Pays de la Loire;49;4;21;330;Sceaux-d'Anjou;1174;16;1190
52;Pays de la Loire;49;4;20;331;Segré-en-Anjou Bleu;17660;818;18478
52;Pays de la Loire;49;2;18;332;La Séguinière;4212;116;4328
52;Pays de la Loire;49;1;06;333;Seiches-sur-le-Loir;2879;58;2937
52;Pays de la Loire;49;1;06;334;Sermaise;332;5;337
52;Pays de la Loire;49;2;13;336;Somloire;872;17;889
52;Pays de la Loire;49;1;17;338;Soulaines-sur-Aubance;1399;20;1419
52;Pays de la Loire;49;1;05;339;Soulaire-et-Bourg;1491;39;1530
52;Pays de la Loire;49;3;19;341;Souzay-Champigny;730;17;747
52;Pays de la Loire;49;2;13;343;La Tessoualle;3195;74;3269
52;Pays de la Loire;49;4;21;344;Thorigné-d'Anjou;1252;23;1275
52;Pays de la Loire;49;1;11;345;Bellevigne-en-Layon;5780;117;5897
52;Pays de la Loire;49;1;21;347;Tiercé;4470;72;4542
52;Pays de la Loire;49;2;13;352;Toutlemonde;1316;34;1350
52;Pays de la Loire;49;1;07;353;Trélazé;15056;185;15241
52;Pays de la Loire;49;2;13;355;Trémentines;3085;79;3164
52;Pays de la Loire;49;3;19;358;Turquant;572;14;586
52;Pays de la Loire;49;3;14;359;Les Ulmes;574;16;590
52;Pays de la Loire;49;3;15;361;Varennes-sur-Loire;1859;28;1887
52;Pays de la Loire;49;3;19;362;Varrains;1241;29;1270
52;Pays de la Loire;49;3;14;364;Vaudelnay;1122;21;1143
52;Pays de la Loire;49;4;87;367;Erdre-en-Anjou;5759;81;5840
52;Pays de la Loire;49;3;15;368;Vernantes;1993;39;2032
52;Pays de la Loire;49;3;15;369;Vernoil-le-Fourrier;1278;22;1300
52;Pays de la Loire;49;3;19;370;Verrie;473;9;482
52;Pays de la Loire;49;2;13;371;Vezins;1733;28;1761
52;Pays de la Loire;49;2;13;373;Lys-Haut-Layon;7748;169;7917
52;Pays de la Loire;49;3;15;374;Villebernier;1438;32;1470
52;Pays de la Loire;49;1;06;377;Rives-du-Loir-en-Anjou;5642;89;5731
52;Pays de la Loire;49;3;15;378;Vivy;2545;35;2580
52;Pays de la Loire;49;2;13;381;Yzernay;1821;31;1852
28;Normandie;50;4;22;002;Agneaux;4245;432;4677
28;Normandie;50;3;01;003;Agon-Coutainville;2869;64;2933
28;Normandie;50;4;18;004;Airel;552;3;555
28;Normandie;50;4;18;006;Amigny;154;5;159
28;Normandie;50;1;03;008;Anctoville-sur-Boscq;439;19;458
28;Normandie;50;2;26;013;Anneville-en-Saire;384;8;392
28;Normandie;50;3;20;015;Annoville;641;13;654
28;Normandie;50;3;05;016;Appeville;184;2;186
28;Normandie;50;1;19;019;Aucey-la-Plaine;415;6;421
28;Normandie;50;2;05;021;Audouville-la-Hubert;76;1;77
28;Normandie;50;2;26;022;Aumeville-Lestre;110;3;113
28;Normandie;50;4;05;023;Auvers;691;10;701
28;Normandie;50;3;01;024;Auxais;166;3;169
28;Normandie;50;1;84;025;Avranches;10277;508;10785
28;Normandie;50;2;25;026;Azeville;78;1;79
28;Normandie;50;1;02;027;Bacilly;963;29;992
28;Normandie;50;3;20;028;La Baleine;106;3;109
28;Normandie;50;1;16;029;Barenton;1176;65;1241
28;Normandie;50;2;26;030;Barfleur;553;9;562
28;Normandie;50;2;17;031;Barneville-Carteret;2214;54;2268
28;Normandie;50;4;23;032;La Barre-de-Semilly;1034;31;1065
28;Normandie;50;2;17;033;Baubigny;138;4;142
28;Normandie;50;4;23;034;Baudre;560;19;579
28;Normandie;50;3;05;036;Baupte;439;11;450
28;Normandie;50;1;03;038;Beauchamps;430;11;441
28;Normandie;50;4;09;039;Beaucoudray;129;3;132
28;Normandie;50;1;16;040;Beauficel;119;6;125
28;Normandie;50;2;14;041;La Hague;11257;319;11576
28;Normandie;50;1;19;042;Beauvoir;442;6;448
28;Normandie;50;3;20;044;Belval;325;8;333
28;Normandie;50;2;17;045;Benoîtville;610;22;632
28;Normandie;50;4;18;046;Bérigny;432;9;441
28;Normandie;50;4;27;048;Beslon;555;9;564
28;Normandie;50;2;04;049;Besneville;658;19;677
28;Normandie;50;4;09;050;Beuvrigny;135;5;140
28;Normandie;50;2;05;052;Beuzeville-la-Bastille;145;2;147
28;Normandie;50;4;09;054;Biéville;191;4;195
28;Normandie;50;2;04;055;Biniville;113;2;115
28;Normandie;50;3;01;058;Blainville-sur-Mer;1604;45;1649
28;Normandie;50;2;05;059;Blosville;326;1;327
28;Normandie;50;4;27;060;La Bloutière;445;8;453
28;Normandie;50;1;27;062;Boisyvon;110;2;112
28;Normandie;50;2;04;064;La Bonneville;180;6;186
28;Normandie;50;1;02;066;Jullouville;2396;79;2475
28;Normandie;50;4;27;069;Bourguenolles;345;11;356
28;Normandie;50;2;05;070;Boutteville;69;1;70
28;Normandie;50;3;10;072;Brainville;210;6;216
28;Normandie;50;1;15;074;Brécey;2168;145;2313
28;Normandie;50;1;03;076;Bréhal;3463;79;3542
28;Normandie;50;2;24;077;Bretteville;1027;43;1070
28;Normandie;50;3;11;078;Bretteville-sur-Ay;421;7;428
28;Normandie;50;2;04;079;Breuville;402;9;411
28;Normandie;50;1;03;081;Bréville-sur-Mer;779;29;808
28;Normandie;50;2;04;082;Bricquebec-en-Cotentin;5847;89;5936
28;Normandie;50;2;17;083;Bricquebosq;638;7;645
28;Normandie;50;3;10;084;Bricqueville-la-Blouette;538;19;557
28;Normandie;50;1;03;085;Bricqueville-sur-Mer;1241;43;1284
28;Normandie;50;2;26;086;Brillevast;323;8;331
28;Normandie;50;2;25;087;Brix;2152;46;2198
28;Normandie;50;1;16;088;Brouains;136;2;138
28;Normandie;50;1;21;090;Buais-Les-Monts;610;10;620
28;Normandie;50;3;10;092;Cambernon;703;16;719
28;Normandie;50;3;20;093;Cametours;425;9;434
28;Normandie;50;3;10;094;Camprond;411;9;420
28;Normandie;50;4;23;095;Canisy;1748;55;1803
28;Normandie;50;2;26;096;Canteloup;209;8;217
28;Normandie;50;2;11;097;Canville-la-Rocque;121;2;123
28;Normandie;50;4;23;098;Carantilly;619;14;633
28;Normandie;50;4;83;099;Carentan-les-Marais;10227;162;10389
28;Normandie;50;2;26;101;Carneville;232;6;238
28;Normandie;50;1;02;102;Carolles;748;16;764
28;Normandie;50;2;04;105;Catteville;96;5;101
28;Normandie;50;4;18;106;Cavigny;268;5;273
28;Normandie;50;1;19;108;Céaux;415;12;427
28;Normandie;50;1;03;109;Cérences;1771;38;1809
28;Normandie;50;4;18;110;Cerisy-la-Forêt;1035;19;1054
28;Normandie;50;3;20;111;Cerisy-la-Salle;1009;16;1025
28;Normandie;50;1;15;112;La Chaise-Baudouin;460;6;466
28;Normandie;50;1;03;115;Le Grippon;384;11;395
28;Normandie;50;1;02;117;Champeaux;347;10;357
28;Normandie;50;4;27;118;Champrepus;324;4;328
28;Normandie;50;1;03;120;Chanteloup;365;4;369
28;Normandie;50;1;27;121;La Chapelle-Cécelin;241;4;245
28;Normandie;50;1;15;124;La Chapelle-Urée;169;2;171
28;Normandie;50;1;02;126;Chavoy;135;6;141
28;Normandie;50;2;98;129;Cherbourg-en-Cotentin;77789;2293;80082
28;Normandie;50;4;27;130;Chérencé-le-Héron;432;5;437
28;Normandie;50;2;26;135;Clitourps;226;3;229
28;Normandie;50;4;27;137;La Colombe;628;15;643
28;Normandie;50;2;04;138;Colomby;554;9;563
28;Normandie;50;4;09;139;Condé-sur-Vire;4076;151;4227
28;Normandie;50;2;26;142;Vicq-sur-Mer;1064;13;1077
28;Normandie;50;1;03;143;Coudeville-sur-Mer;868;33;901
28;Normandie;50;1;27;144;Coulouvray-Boisbenâtre;530;4;534
28;Normandie;50;3;10;145;Courcy;591;13;604
28;Normandie;50;1;19;146;Courtils;237;2;239
28;Normandie;50;3;10;147;Coutances;8380;1174;9554
28;Normandie;50;4;18;148;Couvains;559;4;563
28;Normandie;50;2;08;149;Couville;1186;18;1204
28;Normandie;50;2;26;150;Crasville;226;2;228
28;Normandie;50;3;11;151;Créances;2078;30;2108
28;Normandie;50;1;15;152;Les Cresnays;227;3;230
28;Normandie;50;1;19;155;Crollon;296;13;309
28;Normandie;50;2;04;156;Crosville-sur-Douve;65;0;65
28;Normandie;50;1;15;158;Cuves;277;8;285
28;Normandie;50;4;23;159;Dangy;684;14;698
28;Normandie;50;4;18;161;Le Dézert;601;3;604
28;Normandie;50;2;24;162;Digosville;1623;43;1666
28;Normandie;50;4;09;164;Domjean;1001;26;1027
28;Normandie;50;1;13;165;Donville-les-Bains;3081;73;3154
28;Normandie;50;3;11;166;Doville;326;15;341
28;Normandie;50;1;02;167;Dragey-Ronthon;795;21;816
28;Normandie;50;1;19;168;Ducey-Les Chéris;2827;59;2886
28;Normandie;50;2;25;169;Écausseville;106;2;108
28;Normandie;50;2;25;172;Émondeville;349;8;357
28;Normandie;50;1;03;174;Équilly;195;8;203
28;Normandie;50;2;25;175;Éroudeville;190;8;198
28;Normandie;50;2;04;176;L'Étang-Bertrand;353;14;367
28;Normandie;50;2;04;177;Étienville;376;5;381
28;Normandie;50;2;26;178;Fermanville;1272;33;1305
28;Normandie;50;3;01;181;Feugères;338;13;351
28;Normandie;50;3;11;182;La Feuillie;296;6;302
28;Normandie;50;2;17;183;Fierville-les-Mines;350;6;356
28;Normandie;50;2;17;184;Flamanville;1767;22;1789
28;Normandie;50;4;27;185;Fleury;1054;24;1078
28;Normandie;50;2;25;186;Flottemanville;219;8;227
28;Normandie;50;1;03;188;Folligny;1094;27;1121
28;Normandie;50;2;25;190;Fontenay-sur-Mer;168;3;171
28;Normandie;50;4;09;192;Fourneaux;130;0;130
28;Normandie;50;1;16;193;Le Fresne-Poret;219;3;222
28;Normandie;50;2;25;194;Fresville;372;6;378
28;Normandie;50;1;16;195;Gathemo;261;2;263
28;Normandie;50;2;26;196;Gatteville-le-Phare;483;9;492
28;Normandie;50;3;20;197;Gavray-sur-Sienne;1980;26;2006
28;Normandie;50;3;01;198;Geffosses;486;11;497
28;Normandie;50;1;02;199;Genêts;453;4;457
28;Normandie;50;1;16;200;Ger;806;12;818
28;Normandie;50;1;15;205;La Godefroy;285;6;291
28;Normandie;50;2;04;207;Golleville;172;5;177
28;Normandie;50;3;01;208;Gonfreville;160;1;161
28;Normandie;50;2;26;209;Gonneville-Le Theil;1515;43;1558
28;Normandie;50;3;01;210;Gorges;341;8;349
28;Normandie;50;4;09;214;Gouvets;281;6;287
28;Normandie;50;3;01;215;Gouville-sur-Mer;3241;70;3311
28;Normandie;50;4;18;216;Graignes-Mesnil-Angot;801;94;895
28;Normandie;50;1;15;217;Le Grand-Celland;604;11;615
28;Normandie;50;1;13;218;Granville;12558;672;13230
28;Normandie;50;3;10;219;Gratot;666;12;678
28;Normandie;50;3;20;221;Grimesnil;63;0;63
28;Normandie;50;2;17;222;Grosville;790;21;811
28;Normandie;50;4;27;225;Le Guislain;146;1;147
28;Normandie;50;2;25;227;Le Ham;312;6;318
28;Normandie;50;3;20;228;Hambye;1082;31;1113
28;Normandie;50;1;21;229;Hamelin;94;0;94
28;Normandie;50;2;08;230;Hardinvast;897;29;926
28;Normandie;50;3;20;231;Hauteville-sur-Mer;693;19;712
28;Normandie;50;3;01;232;Hauteville-la-Guichard;477;17;494
28;Normandie;50;2;04;233;Hautteville-Bocage;157;5;162
28;Normandie;50;4;27;234;La Haye-Bellefond;75;0;75
28;Normandie;50;2;17;235;La Haye-d'Ectot;272;5;277
28;Normandie;50;3;11;236;La Haye;3958;120;4078
28;Normandie;50;1;03;237;La Haye-Pesnel;1266;23;1289
28;Normandie;50;2;17;238;Héauville;457;6;463
28;Normandie;50;4;22;239;Thèreval;1793;45;1838
28;Normandie;50;2;17;240;Helleville;558;8;566
28;Normandie;50;2;25;241;Hémevez;182;4;186
28;Normandie;50;3;10;243;Heugueville-sur-Sienne;473;15;488
28;Normandie;50;2;05;246;Hiesville;71;1;72
28;Normandie;50;1;03;247;Hocquigny;190;5;195
28;Normandie;50;2;25;251;Huberville;363;10;373
28;Normandie;50;1;03;252;Hudimesnil;914;19;933
28;Normandie;50;1;19;253;Huisnes-sur-Mer;169;7;176
28;Normandie;50;1;15;256;Isigny-le-Buat;3170;97;3267
28;Normandie;50;2;25;258;Joganville;103;1;104
28;Normandie;50;1;19;259;Juilley;640;25;665
28;Normandie;50;1;15;260;Juvigny les Vallées;1683;39;1722
28;Normandie;50;4;09;261;Lamberville;167;2;169
28;Normandie;50;4;27;262;La Lande-d'Airou;532;6;538
28;Normandie;50;1;21;263;Lapenty;370;10;380
28;Normandie;50;3;11;265;Laulne;193;1;194
28;Normandie;50;3;20;266;Lengronne;430;3;433
28;Normandie;50;3;11;267;Lessay;2240;54;2294
28;Normandie;50;2;25;268;Lestre;248;2;250
28;Normandie;50;2;05;269;Liesville-sur-Douve;207;6;213
28;Normandie;50;2;25;270;Lieusaint;401;12;413
28;Normandie;50;1;15;271;Lingeard;87;1;88
28;Normandie;50;3;20;272;Lingreville;1023;19;1042
28;Normandie;50;3;11;273;Montsenelle;1413;20;1433
28;Normandie;50;1;21;274;Les Loges-Marchis;1016;153;1169
28;Normandie;50;1;15;275;Les Loges-sur-Brécey;122;6;128
28;Normandie;50;1;02;276;Lolif;593;21;614
28;Normandie;50;1;03;277;Longueville;587;15;602
28;Normandie;50;1;03;278;Le Loreur;276;6;282
28;Normandie;50;4;22;279;Le Lorey;599;15;614
28;Normandie;50;1;03;281;La Lucerne-d'Outremer;781;19;800
28;Normandie;50;1;03;282;Le Luot;306;9;315
28;Normandie;50;4;23;283;La Luzerne;76;1;77
28;Normandie;50;2;04;285;Magneville;312;4;316
28;Normandie;50;1;02;288;Marcey-les-Grèves;1302;23;1325
28;Normandie;50;3;01;289;Marchésieux;723;12;735
28;Normandie;50;1;19;290;Marcilly;334;8;342
28;Normandie;50;4;27;291;Margueray;116;4;120
28;Normandie;50;4;22;292;Marigny-Le-Lozon;2723;58;2781
28;Normandie;50;2;08;294;Martinvast;1325;38;1363
28;Normandie;50;4;27;295;Maupertuis;145;2;147
28;Normandie;50;2;26;296;Maupertus-sur-Mer;221;9;230
28;Normandie;50;4;18;297;La Meauffe;1009;30;1039
28;Normandie;50;4;05;298;Méautis;644;14;658
28;Normandie;50;2;17;299;Le Mesnil;220;7;227
28;Normandie;50;1;15;300;Le Mesnil-Adelée;162;7;169
28;Normandie;50;4;22;302;Le Mesnil-Amey;286;7;293
28;Normandie;50;1;03;304;Le Mesnil-Aubert;195;4;199
28;Normandie;50;2;24;305;Le Mesnil-au-Val;727;16;743
28;Normandie;50;4;22;310;Le Mesnil-Eury;165;4;169
28;Normandie;50;3;20;311;Le Mesnil-Garnier;225;8;233
28;Normandie;50;1;15;312;Le Mesnil-Gilbert;134;4;138
28;Normandie;50;1;21;315;Le Mesnillard;247;7;254
28;Normandie;50;1;19;317;Le Mesnil-Ozenne;277;3;280
28;Normandie;50;4;18;321;Le Mesnil-Rouxelin;490;12;502
28;Normandie;50;4;18;324;Le Mesnil-Véneron;111;2;113
28;Normandie;50;3;20;326;Le Mesnil-Villeman;234;1;235
28;Normandie;50;1;03;327;La Meurdraquière;193;6;199
28;Normandie;50;3;11;328;Millières;765;13;778
28;Normandie;50;2;17;332;Les Moitiers-d'Allonne;716;15;731
28;Normandie;50;4;27;334;Montabot;273;3;276
28;Normandie;50;2;25;335;Montaigu-la-Brisette;496;9;505
28;Normandie;50;3;20;336;Montaigu-les-Bois;221;3;224
28;Normandie;50;4;27;338;Montbray;296;4;300
28;Normandie;50;3;01;340;Montcuit;188;4;192
28;Normandie;50;2;25;341;Montebourg;2051;126;2177
28;Normandie;50;2;26;342;Montfarville;799;27;826
28;Normandie;50;3;10;345;Monthuchon;696;20;716
28;Normandie;50;1;21;347;Montjoie-Saint-Martin;239;5;244
28;Normandie;50;3;20;349;Montmartin-sur-Mer;1393;35;1428
28;Normandie;50;3;20;350;Montpinchon;525;6;531
28;Normandie;50;4;09;351;Montrabot;96;2;98
28;Normandie;50;4;22;352;Montreuil-sur-Lozon;337;7;344
28;Normandie;50;1;19;353;Le Mont-Saint-Michel;27;1;28
28;Normandie;50;4;18;356;Moon-sur-Elle;785;21;806
28;Normandie;50;4;27;357;Morigny;71;1;72
28;Normandie;50;1;16;359;Mortain-Bocage;2932;207;3139
28;Normandie;50;2;04;360;Morville;279;12;291
28;Normandie;50;1;03;361;La Mouche;244;5;249
28;Normandie;50;1;21;362;Moulines;282;5;287
28;Normandie;50;4;09;363;Moyon Villages;1443;35;1478
28;Normandie;50;3;01;364;Muneville-le-Bingard;715;13;728
28;Normandie;50;1;03;365;Muneville-sur-Mer;500;11;511
28;Normandie;50;3;01;368;Nay;67;2;69
28;Normandie;50;2;04;369;Négreville;824;25;849
28;Normandie;50;2;04;370;Néhou;608;4;612
28;Normandie;50;1;16;371;Le Neufbourg;404;13;417
28;Normandie;50;3;11;372;Neufmesnil;178;3;181
28;Normandie;50;2;05;373;Neuville-au-Plain;87;4;91
28;Normandie;50;2;04;374;Neuville-en-Beaumont;26;1;27
28;Normandie;50;3;10;376;Nicorps;378;13;391
28;Normandie;50;3;20;378;Notre-Dame-de-Cenilly;630;10;640
28;Normandie;50;1;15;379;Notre-Dame-de-Livoye;161;3;164
28;Normandie;50;2;08;382;Nouainville;633;18;651
28;Normandie;50;2;26;384;Octeville-l'Avenel;225;7;232
28;Normandie;50;2;04;387;Orglandes;354;7;361
28;Normandie;50;3;10;388;Orval sur Sienne;1172;33;1205
28;Normandie;50;3;20;389;Ouville;438;12;450
28;Normandie;50;2;25;390;Ozeville;154;3;157
28;Normandie;50;1;21;391;Grandparigny;2635;74;2709
28;Normandie;50;4;27;393;Percy-en-Normandie;2605;104;2709
28;Normandie;50;3;01;394;Périers;2244;30;2274
28;Normandie;50;2;26;395;La Pernelle;277;4;281
28;Normandie;50;1;16;397;Perriers-en-Beauficel;207;6;213
28;Normandie;50;4;09;398;Le Perron;200;2;202
28;Normandie;50;1;15;399;Le Petit-Celland;176;3;179
28;Normandie;50;2;05;400;Picauville;3251;43;3294
28;Normandie;50;2;17;401;Pierreville;746;15;761
28;Normandie;50;2;17;402;Les Pieux;3244;88;3332
28;Normandie;50;3;11;403;Pirou;1429;37;1466
28;Normandie;50;3;11;405;Le Plessis-Lastelle;240;8;248
28;Normandie;50;1;19;407;Poilley;942;36;978
28;Normandie;50;1;19;408;Pontaubault;576;13;589
28;Normandie;50;4;18;409;Pont-Hébert;1915;206;2121
28;Normandie;50;1;19;410;Pontorson;4352;75;4427
28;Normandie;50;1;02;411;Ponts;680;9;689
28;Normandie;50;2;17;412;Port-Bail-sur-Mer;2545;63;2608
28;Normandie;50;1;19;413;Précey;584;5;589
28;Normandie;50;2;26;417;Quettehou;1773;29;1802
28;Normandie;50;3;20;419;Quettreville-sur-Sienne;3195;72;3267
28;Normandie;50;4;23;420;Quibou;854;23;877
28;Normandie;50;2;25;421;Quinéville;265;6;271
28;Normandie;50;3;01;422;Raids;193;0;193
28;Normandie;50;4;18;423;Rampan;210;5;215
28;Normandie;50;2;04;425;Rauville-la-Bigot;1097;26;1123
28;Normandie;50;2;04;426;Rauville-la-Place;366;6;372
28;Normandie;50;1;15;428;Reffuveille;512;6;518
28;Normandie;50;3;10;429;Regnéville-sur-Mer;739;32;771
28;Normandie;50;2;04;430;Reigneville-Bocage;41;3;44
28;Normandie;50;4;22;431;Remilly Les Marais;1059;12;1071
28;Normandie;50;2;26;433;Réville;1014;23;1037
28;Normandie;50;2;04;435;Rocheville;596;16;612
28;Normandie;50;1;16;436;Romagny Fontenay;1270;43;1313
28;Normandie;50;3;20;437;Roncey;791;12;803
28;Normandie;50;2;17;442;Le Rozel;249;5;254
28;Normandie;50;1;19;443;Sacey;516;11;527
28;Normandie;50;4;09;444;Saint-Amand-Villages;2514;58;2572
28;Normandie;50;4;05;445;Saint-André-de-Bohon;361;13;374
28;Normandie;50;4;18;446;Saint-André-de-l'Épine;548;13;561
28;Normandie;50;1;03;447;Saint-Aubin-des-Préaux;462;14;476
28;Normandie;50;1;21;448;Saint-Aubin-de-Terregatte;650;17;667
28;Normandie;50;1;16;450;Saint-Barthélemy;332;8;340
28;Normandie;50;1;15;451;Saint-Brice;129;1;130
28;Normandie;50;1;21;452;Saint-Brice-de-Landelles;664;22;686
28;Normandie;50;4;27;453;Sainte-Cécile;788;18;806
28;Normandie;50;2;17;454;Saint-Christophe-du-Foc;420;9;429
28;Normandie;50;4;18;455;Saint-Clair-sur-l'Elle;968;20;988
28;Normandie;50;1;16;456;Saint-Clément-Rancoudray;547;11;558
28;Normandie;50;2;04;457;Sainte-Colombe;189;6;195
28;Normandie;50;2;25;461;Saint-Cyr;206;9;215
28;Normandie;50;1;16;462;Saint-Cyr-du-Bailleul;354;8;362
28;Normandie;50;3;20;463;Saint-Denis-le-Gast;526;11;537
28;Normandie;50;3;20;464;Saint-Denis-le-Vêtu;636;5;641
28;Normandie;50;2;25;467;Saint-Floxel;496;13;509
28;Normandie;50;4;18;468;Saint-Fromond;762;17;779
28;Normandie;50;2;26;469;Sainte-Geneviève;308;7;315
28;Normandie;50;2;17;471;Saint-Georges-de-la-Rivière;273;5;278
28;Normandie;50;1;15;472;Saint-Georges-de-Livoye;207;8;215
28;Normandie;50;4;18;473;Saint-Georges-d'Elle;385;7;392
28;Normandie;50;1;16;474;Saint-Georges-de-Rouelley;544;12;556
28;Normandie;50;4;18;475;Saint-Georges-Montcocq;964;20;984
28;Normandie;50;4;18;476;Saint-Germain-d'Elle;220;7;227
28;Normandie;50;2;25;478;Saint-Germain-de-Tournebut;419;6;425
28;Normandie;50;2;05;479;Saint-Germain-de-Varreville;109;3;112
28;Normandie;50;2;17;480;Saint-Germain-le-Gaillard;770;15;785
28;Normandie;50;3;11;481;Saint-Germain-sur-Ay;904;18;922
28;Normandie;50;3;01;482;Saint-Germain-sur-Sèves;161;3;164
28;Normandie;50;4;22;483;Saint-Gilles;978;29;1007
28;Normandie;50;1;21;484;Saint-Hilaire-du-Harcouët;5769;308;6077
28;Normandie;50;2;04;486;Saint-Jacques-de-Néhou;625;9;634
28;Normandie;50;1;21;487;Saint-James;4896;103;4999
28;Normandie;50;4;18;488;Saint-Jean-de-Daye;636;8;644
28;Normandie;50;1;02;489;Saint-Jean-de-la-Haize;544;13;557
28;Normandie;50;2;17;490;Saint-Jean-de-la-Rivière;358;13;371
28;Normandie;50;4;18;491;Saint-Jean-de-Savigny;439;11;450
28;Normandie;50;4;09;492;Saint-Jean-d'Elle;2527;56;2583
28;Normandie;50;1;03;493;Saint-Jean-des-Champs;1471;46;1517
28;Normandie;50;1;15;495;Saint-Jean-du-Corail-des-Bois;75;5;80
28;Normandie;50;1;02;496;Saint-Jean-le-Thomas;386;9;395
28;Normandie;50;2;25;498;Saint-Joseph;801;24;825
28;Normandie;50;1;15;499;Saint-Laurent-de-Cuves;487;14;501
28;Normandie;50;1;21;500;Saint-Laurent-de-Terregatte;653;12;665
28;Normandie;50;4;99;502;Saint-Lô;19206;906;20112
28;Normandie;50;4;09;504;Saint-Louet-sur-Vire;207;5;212
28;Normandie;50;1;15;505;Saint-Loup;677;34;711
28;Normandie;50;3;01;506;Saint-Malo-de-la-Lande;476;11;487
28;Normandie;50;2;25;507;Saint-Marcouf;345;6;351
28;Normandie;50;2;05;509;Sainte-Marie-du-Mont;707;17;724
28;Normandie;50;3;01;510;Saint-Martin-d'Aubigny;606;4;610
28;Normandie;50;2;25;511;Saint-Martin-d'Audouville;136;0;136
28;Normandie;50;4;23;512;Saint-Martin-de-Bonfossé;534;9;543
28;Normandie;50;3;20;513;Saint-Martin-de-Cenilly;186;2;188
28;Normandie;50;1;16;514;Chaulieu;312;1;313
28;Normandie;50;2;05;517;Saint-Martin-de-Varreville;170;5;175
28;Normandie;50;1;27;518;Saint-Martin-le-Bouillant;333;3;336
28;Normandie;50;2;08;519;Saint-Martin-le-Gréard;587;8;595
28;Normandie;50;1;27;521;Saint-Maur-des-Bois;154;4;158
28;Normandie;50;2;17;522;Saint-Maurice-en-Cotentin;251;7;258
28;Normandie;50;2;05;523;Sainte-Mère-Église;3021;46;3067
28;Normandie;50;1;15;525;Saint-Michel-de-Montjoie;334;2;336
28;Normandie;50;3;11;528;Saint-Nicolas-de-Pierrepont;304;12;316
28;Normandie;50;1;15;529;Saint-Nicolas-des-Bois;79;2;81
28;Normandie;50;1;19;531;Saint-Ovin;767;31;798
28;Normandie;50;1;13;532;Saint-Pair-sur-Mer;4103;150;4253
28;Normandie;50;3;11;533;Saint-Patrice-de-Claids;179;3;182
28;Normandie;50;1;02;535;Le Parc;917;22;939
28;Normandie;50;2;17;536;Saint-Pierre-d'Arthéglise;161;0;161
28;Normandie;50;3;10;537;Saint-Pierre-de-Coutances;413;19;432
28;Normandie;50;4;18;538;Saint-Pierre-de-Semilly;447;12;459
28;Normandie;50;2;26;539;Saint-Pierre-Église;1824;25;1849
28;Normandie;50;1;02;540;Saint-Pierre-Langers;630;17;647
28;Normandie;50;1;03;541;Saint-Planchers;1423;48;1471
28;Normandie;50;1;27;542;Saint-Pois;480;8;488
28;Normandie;50;1;19;543;Saint-Quentin-sur-le-Homme;1357;31;1388
28;Normandie;50;4;23;546;Bourgvallées;3304;69;3373
28;Normandie;50;3;11;548;Saint-Sauveur-de-Pierrepont;118;3;121
28;Normandie;50;1;03;549;Saint-Sauveur-la-Pommeraye;408;6;414
28;Normandie;50;3;01;550;Saint-Sauveur-Villages;3474;135;3609
28;Normandie;50;2;04;551;Saint-Sauveur-le-Vicomte;2076;39;2115
28;Normandie;50;3;01;552;Saint-Sébastien-de-Raids;329;6;335
28;Normandie;50;1;21;553;Saint-Senier-de-Beuvron;336;3;339
28;Normandie;50;1;15;554;Saint-Senier-sous-Avranches;1436;31;1467
28;Normandie;50;4;23;556;Sainte-Suzanne-sur-Vire;699;10;709
28;Normandie;50;2;26;562;Saint-Vaast-la-Hougue;1700;28;1728
28;Normandie;50;4;09;563;Saint-Vigor-des-Monts;280;8;288
28;Normandie;50;4;05;564;Terre-et-Marais;1321;29;1350
28;Normandie;50;1;02;565;Sartilly-Baie-Bocage;2835;56;2891
28;Normandie;50;2;25;567;Saussemesnil;882;25;907
28;Normandie;50;3;10;568;Saussey;459;15;474
28;Normandie;50;3;20;569;Savigny;445;13;458
28;Normandie;50;1;21;570;Savigny-le-Vieux;413;8;421
28;Normandie;50;2;05;571;Sébeville;34;1;35
28;Normandie;50;2;17;572;Sénoville;189;3;192
28;Normandie;50;1;19;574;Servon;268;12;280
28;Normandie;50;2;08;575;Sideville;807;14;821
28;Normandie;50;2;17;576;Siouville-Hague;947;31;978
28;Normandie;50;2;17;577;Sortosville-en-Beaumont;311;8;319
28;Normandie;50;2;25;578;Sortosville;79;1;80
28;Normandie;50;2;04;579;Sottevast;1433;29;1462
28;Normandie;50;2;17;580;Sotteville;471;16;487
28;Normandie;50;1;16;582;Sourdeval;3113;62;3175
28;Normandie;50;1;03;584;Subligny;397;8;405
28;Normandie;50;2;17;585;Surtainville;1159;26;1185
28;Normandie;50;2;04;587;Taillepied;16;1;17
28;Normandie;50;2;25;588;Tamerville;688;18;706
28;Normandie;50;1;19;589;Tanis;283;12;295
28;Normandie;50;1;27;590;Le Tanu;410;6;416
28;Normandie;50;1;16;591;Le Teilleul;1663;27;1690
28;Normandie;50;4;09;592;Tessy-Bocage;2237;45;2282
28;Normandie;50;2;26;593;Teurthéville-Bocage;590;10;600
28;Normandie;50;2;08;594;Teurthéville-Hague;1032;23;1055
28;Normandie;50;2;26;596;Théville;329;10;339
28;Normandie;50;1;15;597;Tirepied-sur-Sée;953;13;966
28;Normandie;50;2;26;598;Tocqueville;266;3;269
28;Normandie;50;2;08;599;Tollevast;1596;36;1632
28;Normandie;50;4;09;601;Torigny-les-Villes;4434;57;4491
28;Normandie;50;3;10;603;Tourville-sur-Sienne;772;23;795
28;Normandie;50;2;17;604;Tréauville;746;19;765
28;Normandie;50;4;18;606;Tribehou;515;7;522
28;Normandie;50;4;27;607;La Trinité;396;6;402
28;Normandie;50;2;05;609;Turqueville;122;3;125
28;Normandie;50;2;25;610;Urville;208;5;213
28;Normandie;50;1;02;612;Vains;747;84;831
28;Normandie;50;2;26;613;Valcanville;395;9;404
28;Normandie;50;2;25;615;Valognes;6802;262;7064
28;Normandie;50;1;19;616;Le Val-Saint-Père;1935;65;2000
28;Normandie;50;3;11;617;Varenguebec;334;2;336
28;Normandie;50;2;26;618;Varouville;233;11;244
28;Normandie;50;2;26;619;Le Vast;328;10;338
28;Normandie;50;2;25;621;Vaudreville;71;0;71
28;Normandie;50;3;10;624;La Vendelée;474;24;498
28;Normandie;50;3;20;626;Ver;379;8;387
28;Normandie;50;1;15;628;Vernix;155;4;159
28;Normandie;50;3;11;629;Vesly;741;6;747
28;Normandie;50;2;26;633;Le Vicel;118;3;121
28;Normandie;50;2;26;634;Videcosville;88;1;89
28;Normandie;50;4;27;637;Villebaudon;320;3;323
28;Normandie;50;4;27;639;Villedieu-les-Poêles-Rouffigny;3849;64;3913
28;Normandie;50;4;18;641;Villiers-Fossard;652;20;672
28;Normandie;50;2;08;643;Virandeville;777;24;801
28;Normandie;50;1;13;647;Yquelon;1151;44;1195
28;Normandie;50;2;25;648;Yvetot-Bocage;1182;30;1212
44;Grand Est;51;4;23;001;Ablancourt;165;4;169
44;Grand Est;51;2;06;002;Saint-Martin-d'Ablois;1387;23;1410
44;Grand Est;51;1;04;003;Aigny;280;5;285
44;Grand Est;51;2;22;004;Allemanche-Launay-et-Soyer;117;4;121
44;Grand Est;51;2;21;005;Allemant;175;3;178
44;Grand Est;51;4;20;006;Alliancelles;148;4;152
44;Grand Est;51;2;07;007;Ambonnay;965;25;990
44;Grand Est;51;4;20;008;Ambrières;214;6;220
44;Grand Est;51;2;22;009;Anglure;812;10;822
44;Grand Est;51;2;22;010;Angluzelles-et-Courcelles;141;4;145
44;Grand Est;51;3;06;012;Anthenay;72;0;72
44;Grand Est;51;3;06;013;Aougny;98;5;103
44;Grand Est;51;3;09;014;Arcis-le-Ponsart;291;8;299
44;Grand Est;51;1;01;015;Argers;110;1;111
44;Grand Est;51;4;20;016;Arrigny;239;4;243
44;Grand Est;51;4;23;017;Arzillières-Neuville;326;6;332
44;Grand Est;51;2;22;018;Athis;896;11;907
44;Grand Est;51;3;10;019;Aubérive;253;7;260
44;Grand Est;51;3;09;020;Aubilly;53;3;56
44;Grand Est;51;4;23;022;Aulnay-l'Aître;192;5;197
44;Grand Est;51;1;04;023;Aulnay-sur-Marne;269;5;274
44;Grand Est;51;3;02;025;Auménancourt;1093;10;1103
44;Grand Est;51;1;01;027;Auve;300;31;331
44;Grand Est;51;2;07;028;Avenay-Val-d'Or;1008;18;1026
44;Grand Est;51;2;08;029;Avize;1752;159;1911
44;Grand Est;51;2;07;030;Aÿ-Champagne;5250;88;5338
44;Grand Est;51;1;10;031;Baconnes;275;12;287
44;Grand Est;51;2;22;032;Bagneux;416;5;421
44;Grand Est;51;2;06;033;Le Baizil;249;3;252
44;Grand Est;51;2;06;034;Bannay;21;0;21
44;Grand Est;51;2;22;035;Bannes;247;3;250
44;Grand Est;51;2;21;036;Barbonne-Fayel;498;11;509
44;Grand Est;51;3;09;037;Baslieux-lès-Fismes;347;3;350
44;Grand Est;51;2;06;038;Baslieux-sous-Châtillon;180;1;181
44;Grand Est;51;4;20;039;Bassu;92;4;96
44;Grand Est;51;4;20;040;Bassuet;247;3;250
44;Grand Est;51;2;22;041;Baudement;100;4;104
44;Grand Est;51;2;06;042;Baye;386;7;393
44;Grand Est;51;3;02;043;Bazancourt;2384;27;2411
44;Grand Est;51;3;10;044;Beaumont-sur-Vesle;782;16;798
44;Grand Est;51;2;06;045;Beaunay;102;0;102
44;Grand Est;51;3;02;046;Beine-Nauroy;992;18;1010
44;Grand Est;51;1;01;047;Belval-en-Argonne;44;3;47
44;Grand Est;51;2;06;048;Belval-sous-Châtillon;168;0;168
44;Grand Est;51;2;22;049;Bergères-lès-Vertus;579;4;583
44;Grand Est;51;2;21;050;Bergères-sous-Montmirail;138;2;140
44;Grand Est;51;3;02;051;Berméricourt;243;3;246
44;Grand Est;51;3;02;052;Berru;599;4;603
44;Grand Est;51;1;01;053;Berzieux;74;1;75
44;Grand Est;51;3;10;054;Bétheniville;1290;14;1304
44;Grand Est;51;3;15;055;Bétheny;7148;109;7257
44;Grand Est;51;2;21;056;Bethon;242;3;245
44;Grand Est;51;4;20;057;Bettancourt-la-Longue;76;0;76
44;Grand Est;51;3;14;058;Bezannes;3513;78;3591
44;Grand Est;51;4;23;059;Bignicourt-sur-Marne;370;6;376
44;Grand Est;51;4;20;060;Bignicourt-sur-Saulx;162;3;165
44;Grand Est;51;3;10;061;Billy-le-Grand;118;2;120
44;Grand Est;51;1;01;062;Binarville;94;3;97
44;Grand Est;51;2;06;063;Binson-et-Orquigny;166;2;168
44;Grand Est;51;4;23;065;Blacy;623;13;636
44;Grand Est;51;4;23;066;Blaise-sous-Arzillières;324;3;327
44;Grand Est;51;4;20;068;Blesme;199;2;201
44;Grand Est;51;3;06;069;Bligny;117;1;118
44;Grand Est;51;2;21;070;Boissy-le-Repos;230;0;230
44;Grand Est;51;2;21;071;Bouchy-Saint-Genest;199;4;203
44;Grand Est;51;3;09;072;Bouilly;225;2;227
44;Grand Est;51;3;09;073;Bouleuse;223;4;227
44;Grand Est;51;3;02;074;Boult-sur-Suippe;1780;32;1812
44;Grand Est;51;3;02;075;Bourgogne-Fresne;1432;33;1465
44;Grand Est;51;2;06;076;Boursault;435;9;444
44;Grand Est;51;3;09;077;Bouvancourt;176;3;179
44;Grand Est;51;1;10;078;Bouy;562;8;570
44;Grand Est;51;2;07;079;Bouzy;853;24;877
44;Grand Est;51;4;20;080;Brandonvillers;192;1;193
44;Grand Est;51;3;09;081;Branscourt;330;5;335
44;Grand Est;51;1;01;082;Braux-Sainte-Cohière;93;2;95
44;Grand Est;51;1;01;083;Braux-Saint-Remy;79;3;82
44;Grand Est;51;4;23;084;Bréban;80;1;81
44;Grand Est;51;2;06;085;Le Breuil;377;3;380
44;Grand Est;51;3;09;086;Breuil-sur-Vesle;331;12;343
44;Grand Est;51;1;05;087;Breuvery-sur-Coole;215;8;223
44;Grand Est;51;3;02;088;Brimont;453;8;461
44;Grand Est;51;3;06;089;Brouillet;68;3;71
44;Grand Est;51;2;22;090;Broussy-le-Grand;312;12;324
44;Grand Est;51;2;21;091;Broussy-le-Petit;137;7;144
44;Grand Est;51;2;21;092;Broyes;351;9;360
44;Grand Est;51;2;08;093;Brugny-Vaudancourt;442;11;453
44;Grand Est;51;4;20;094;Brusson;180;4;184
44;Grand Est;51;4;20;095;Le Buisson;91;0;91
44;Grand Est;51;1;01;097;Bussy-le-Château;177;4;181
44;Grand Est;51;4;20;098;Bussy-le-Repos;136;5;141
44;Grand Est;51;1;05;099;Bussy-Lettrée;320;9;329
44;Grand Est;51;2;06;100;La Caure;108;2;110
44;Grand Est;51;3;02;101;Caurel;692;9;701
44;Grand Est;51;3;02;102;Cauroy-lès-Hermonville;477;10;487
44;Grand Est;51;2;22;103;La Celle-sous-Chantemerle;139;3;142
44;Grand Est;51;1;01;104;Cernay-en-Dormois;136;4;140
44;Grand Est;51;3;18;105;Cernay-lès-Reims;1449;25;1474
44;Grand Est;51;1;05;106;Cernon;127;5;132
44;Grand Est;51;2;22;107;Chaintrix-Bierges;341;2;343
44;Grand Est;51;1;97;108;Châlons-en-Champagne;44336;1145;45481
44;Grand Est;51;3;09;109;Châlons-sur-Vesle;190;2;192
44;Grand Est;51;2;22;110;Chaltrait;57;0;57
44;Grand Est;51;3;06;111;Chambrecy;149;7;156
44;Grand Est;51;3;09;112;Chamery;438;6;444
44;Grand Est;51;2;06;113;Champaubert;122;2;124
44;Grand Est;51;3;14;115;Champfleury;583;3;586
44;Grand Est;51;2;21;116;Champguyon;282;4;286
44;Grand Est;51;1;04;117;Champigneul-Champagne;322;8;330
44;Grand Est;51;3;14;118;Champigny;1585;27;1612
44;Grand Est;51;2;07;119;Champillon;510;7;517
44;Grand Est;51;2;06;120;Champlat-et-Boujacourt;152;0;152
44;Grand Est;51;2;06;121;Champvoisy;251;3;254
44;Grand Est;51;4;20;122;Changy;117;4;121
44;Grand Est;51;2;21;124;Chantemerle;49;3;52
44;Grand Est;51;4;23;125;Chapelaine;53;1;54
44;Grand Est;51;1;01;126;La Chapelle-Felcourt;46;3;49
44;Grand Est;51;2;22;127;La Chapelle-Lasson;86;0;86
44;Grand Est;51;2;06;128;La Chapelle-sous-Orbais;54;2;56
44;Grand Est;51;2;21;129;Charleville;254;9;263
44;Grand Est;51;4;20;130;Charmont;236;5;241
44;Grand Est;51;1;01;132;Les Charmontois;116;0;116
44;Grand Est;51;1;01;133;Le Châtelier;63;0;63
44;Grand Est;51;4;23;134;Châtelraould-Saint-Louvent;244;8;252
44;Grand Est;51;4;20;135;Châtillon-sur-Broué;76;0;76
44;Grand Est;51;2;06;136;Châtillon-sur-Marne;629;16;645
44;Grand Est;51;2;21;137;Châtillon-sur-Morin;218;4;222
44;Grand Est;51;1;01;138;Châtrices;35;1;36
44;Grand Est;51;1;01;139;Chaudefontaine;313;13;326
44;Grand Est;51;3;06;140;Chaumuzy;376;8;384
44;Grand Est;51;4;23;141;La Chaussée-sur-Marne;776;15;791
44;Grand Est;51;2;08;142;Chavot-Courcourt;330;10;340
44;Grand Est;51;1;01;143;Le Chemin;59;0;59
44;Grand Est;51;4;20;144;Cheminon;601;11;612
44;Grand Est;51;3;09;145;Chenay;224;5;229
44;Grand Est;51;1;05;146;Cheniers;110;3;113
44;Grand Est;51;1;01;147;La Cheppe;327;12;339
44;Grand Est;51;1;05;148;Cheppes-la-Prairie;147;2;149
44;Grand Est;51;1;05;149;Chepy;446;14;460
44;Grand Est;51;1;04;150;Cherville;83;1;84
44;Grand Est;51;2;21;151;Chichey;173;3;176
44;Grand Est;51;3;10;152;Chigny-les-Roses;535;10;545
44;Grand Est;51;2;08;153;Chouilly;1035;22;1057
44;Grand Est;51;2;22;154;Clamanges;217;3;220
44;Grand Est;51;2;22;155;Clesles;614;9;623
44;Grand Est;51;4;20;156;Cloyes-sur-Marne;122;1;123
44;Grand Est;51;2;06;157;Coizard-Joches;78;0;78
44;Grand Est;51;2;22;158;Val-des-Marais;570;10;580
44;Grand Est;51;1;03;160;Compertrix;1353;47;1400
44;Grand Est;51;1;04;161;Condé-sur-Marne;755;14;769
44;Grand Est;51;2;22;162;Conflans-sur-Seine;638;8;646
44;Grand Est;51;2;06;163;Congy;264;4;268
44;Grand Est;51;2;22;164;Connantray-Vaurefroy;145;3;148
44;Grand Est;51;2;22;165;Connantre;1023;30;1053
44;Grand Est;51;1;01;166;Contault;67;2;69
44;Grand Est;51;4;23;167;Coole;150;3;153
44;Grand Est;51;1;03;168;Coolus;220;6;226
44;Grand Est;51;4;23;169;Corbeil;97;5;102
44;Grand Est;51;2;21;170;Corfélix;110;2;112
44;Grand Est;51;3;02;171;Cormicy;1503;26;1529
44;Grand Est;51;3;18;172;Cormontreuil;6459;78;6537
44;Grand Est;51;2;06;173;Cormoyeux;128;1;129
44;Grand Est;51;2;06;174;Corribert;62;0;62
44;Grand Est;51;2;21;175;Corrobert;213;7;220
44;Grand Est;51;2;22;176;Corroy;145;7;152
44;Grand Est;51;3;09;177;Coulommes-la-Montagne;206;3;209
44;Grand Est;51;1;05;178;Coupetz;81;2;83
44;Grand Est;51;1;05;179;Coupéville;165;0;165
44;Grand Est;51;3;09;181;Courcelles-Sapicourt;403;11;414
44;Grand Est;51;2;22;182;Courcemain;91;2;93
44;Grand Est;51;3;02;183;Courcy;1243;17;1260
44;Grand Est;51;4;23;184;Courdemanges;388;13;401
44;Grand Est;51;2;21;185;Courgivaux;285;1;286
44;Grand Est;51;2;06;186;Courjeonnet;48;0;48
44;Grand Est;51;3;09;187;Courlandon;289;7;296
44;Grand Est;51;3;09;188;Courmas;213;8;221
44;Grand Est;51;3;09;190;Courtagnon;71;0;71
44;Grand Est;51;1;01;191;Courtémont;61;3;64
44;Grand Est;51;2;06;192;Courthiézy;346;5;351
44;Grand Est;51;1;01;193;Courtisols;2361;92;2453
44;Grand Est;51;3;09;194;Courville;466;7;473
44;Grand Est;51;4;23;195;Couvrot;815;22;837
44;Grand Est;51;2;08;196;Cramant;879;12;891
44;Grand Est;51;1;01;197;La Croix-en-Champagne;81;2;83
44;Grand Est;51;3;09;198;Crugny;671;5;676
44;Grand Est;51;2;06;199;Cuchery;409;6;415
44;Grand Est;51;2;08;200;Cuis;370;12;382
44;Grand Est;51;3;06;201;Cuisles;124;4;128
44;Grand Est;51;2;07;202;Cumières;750;12;762
44;Grand Est;51;1;01;203;Cuperly;225;2;227
44;Grand Est;51;2;06;204;Damery;1346;26;1372
44;Grand Est;51;1;10;205;Dampierre-au-Temple;272;4;276
44;Grand Est;51;1;01;206;Dampierre-le-Château;114;2;116
44;Grand Est;51;1;05;208;Dampierre-sur-Moivre;116;2;118
44;Grand Est;51;2;07;210;Dizy;1492;25;1517
44;Grand Est;51;1;01;211;Dommartin-Dampierre;68;0;68
44;Grand Est;51;1;05;212;Dommartin-Lettrée;158;1;159
44;Grand Est;51;1;01;213;Dommartin-sous-Hans;55;3;58
44;Grand Est;51;1;01;214;Dommartin-Varimont;137;8;145
44;Grand Est;51;4;20;215;Dompremy;123;3;126
44;Grand Est;51;3;10;216;Dontrien;258;4;262
44;Grand Est;51;2;06;217;Dormans;2916;44;2960
44;Grand Est;51;4;20;218;Val-de-Vière;130;1;131
44;Grand Est;51;4;20;219;Drosnay;214;4;218
44;Grand Est;51;4;23;220;Drouilly;141;6;147
44;Grand Est;51;1;01;222;Éclaires;95;3;98
44;Grand Est;51;4;20;223;Écollemont;58;1;59
44;Grand Est;51;4;20;224;Écriennes;169;5;174
44;Grand Est;51;3;09;225;Écueil;320;5;325
44;Grand Est;51;2;22;226;Écury-le-Repos;58;1;59
44;Grand Est;51;1;05;227;Écury-sur-Coole;481;21;502
44;Grand Est;51;1;01;228;Élise-Daucourt;83;0;83
44;Grand Est;51;1;01;229;Épense;120;6;126
44;Grand Est;51;2;98;230;Épernay;22362;474;22836
44;Grand Est;51;1;05;231;L'Épine;657;15;672
44;Grand Est;51;3;10;232;Époye;419;6;425
44;Grand Est;51;2;21;233;Escardes;66;3;69
44;Grand Est;51;2;22;234;Esclavolles-Lurey;633;11;644
44;Grand Est;51;2;21;235;Les Essarts-lès-Sézanne;241;10;251
44;Grand Est;51;2;21;236;Les Essarts-le-Vicomte;137;5;142
44;Grand Est;51;2;21;237;Esternay;1817;30;1847
44;Grand Est;51;2;06;238;Étoges;464;3;467
44;Grand Est;51;2;22;239;Étréchy;104;1;105
44;Grand Est;51;4;20;240;Étrepy;121;3;124
44;Grand Est;51;2;22;241;Euvy;80;1;81
44;Grand Est;51;1;03;242;Fagnières;4868;108;4976
44;Grand Est;51;2;22;243;Faux-Fresnay;305;9;314
44;Grand Est;51;1;05;244;Faux-Vésigneul;240;7;247
44;Grand Est;51;3;09;245;Faverolles-et-Coëmy;578;10;588
44;Grand Est;51;4;20;246;Favresse;222;5;227
44;Grand Est;51;2;06;247;Fèrebrianges;144;3;147
44;Grand Est;51;2;22;248;Fère-Champenoise;2171;41;2212
44;Grand Est;51;2;06;249;Festigny;391;6;397
44;Grand Est;51;3;09;250;Fismes;5721;54;5775
44;Grand Est;51;2;08;251;Flavigny;174;5;179
44;Grand Est;51;2;06;252;Fleury-la-Rivière;519;6;525
44;Grand Est;51;1;01;253;Florent-en-Argonne;224;5;229
44;Grand Est;51;2;21;254;Fontaine-Denis-Nuisy;230;2;232
44;Grand Est;51;1;01;255;Fontaine-en-Dormois;12;0;12
44;Grand Est;51;2;07;256;Fontaine-sur-Ay;331;8;339
44;Grand Est;51;2;21;258;La Forestière;207;13;220
44;Grand Est;51;1;05;259;Francheville;191;6;197
44;Grand Est;51;1;05;260;Le Fresne;75;3;78
44;Grand Est;51;4;23;262;Frignicourt;1787;34;1821
44;Grand Est;51;2;21;263;Fromentières;376;7;383
44;Grand Est;51;2;21;264;Le Gault-Soigny;507;15;522
44;Grand Est;51;2;21;265;Gaye;596;12;608
44;Grand Est;51;2;07;266;Germaine;532;16;548
44;Grand Est;51;3;09;267;Germigny;176;1;177
44;Grand Est;51;2;22;268;Germinon;184;4;188
44;Grand Est;51;4;20;269;Giffaumont-Champaubert;277;1;278
44;Grand Est;51;4;20;270;Gigny-Bussy;239;5;244
44;Grand Est;51;1;01;272;Givry-en-Argonne;457;7;464
44;Grand Est;51;2;22;273;Givry-lès-Loisy;71;0;71
44;Grand Est;51;1;01;274;Gizaucourt;117;3;120
44;Grand Est;51;4;23;275;Glannes;187;2;189
44;Grand Est;51;2;22;276;Gourgançon;143;7;150
44;Grand Est;51;4;20;277;Sainte-Marie-du-Lac-Nuisement;272;7;279
44;Grand Est;51;1;04;278;Les Grandes-Loges;276;5;281
44;Grand Est;51;2;22;279;Granges-sur-Aube;184;5;189
44;Grand Est;51;1;01;280;Gratreuil;24;0;24
44;Grand Est;51;2;08;281;Grauves;619;12;631
44;Grand Est;51;3;09;282;Gueux;1850;48;1898
44;Grand Est;51;1;01;283;Hans;139;7;146
44;Grand Est;51;4;20;284;Haussignémont;303;1;304
44;Grand Est;51;1;05;285;Haussimont;139;4;143
44;Grand Est;51;4;20;286;Hauteville;240;7;247
44;Grand Est;51;2;07;287;Hautvillers;669;15;684
44;Grand Est;51;4;20;288;Heiltz-le-Hutier;238;7;245
44;Grand Est;51;4;20;289;Heiltz-le-Maurupt;434;9;443
44;Grand Est;51;4;20;290;Heiltz-l'Évêque;281;6;287
44;Grand Est;51;3;02;291;Hermonville;1392;33;1425
44;Grand Est;51;1;01;292;Herpont;122;4;126
44;Grand Est;51;3;02;293;Heutrégiville;483;7;490
44;Grand Est;51;3;09;294;Hourges;80;0;80
44;Grand Est;51;4;23;295;Huiron;303;2;305
44;Grand Est;51;4;23;296;Humbauville;77;0;77
44;Grand Est;51;2;06;298;Igny-Comblizy;433;3;436
44;Grand Est;51;3;02;299;Isles-sur-Suippe;946;13;959
44;Grand Est;51;4;20;300;Isle-sur-Marne;94;2;96
44;Grand Est;51;1;04;301;Isse;107;9;116
44;Grand Est;51;2;08;302;Les Istres-et-Bury;94;1;95
44;Grand Est;51;1;04;303;Jâlons;547;10;557
44;Grand Est;51;2;21;304;Janvilliers;172;4;176
44;Grand Est;51;3;09;305;Janvry;127;2;129
44;Grand Est;51;2;21;306;Joiselle;103;3;106
44;Grand Est;51;1;01;307;Jonchery-sur-Suippe;227;3;230
44;Grand Est;51;3;09;308;Jonchery-sur-Vesle;1843;56;1899
44;Grand Est;51;3;06;309;Jonquery;112;4;116
44;Grand Est;51;3;09;310;Jouy-lès-Reims;221;3;224
44;Grand Est;51;4;20;311;Jussecourt-Minecourt;207;2;209
44;Grand Est;51;1;04;312;Juvigny;938;29;967
44;Grand Est;51;2;21;313;Lachy;331;11;342
44;Grand Est;51;3;06;314;Lagery;235;4;239
44;Grand Est;51;4;20;315;Landricourt;145;1;146
44;Grand Est;51;4;20;316;Larzicourt;272;5;277
44;Grand Est;51;1;01;317;Laval-sur-Tourbe;52;0;52
44;Grand Est;51;3;02;318;Lavannes;568;16;584
44;Grand Est;51;1;05;319;Lenharrée;103;3;106
44;Grand Est;51;2;06;320;Leuvrigny;307;8;315
44;Grand Est;51;3;06;321;Lhéry;84;2;86
44;Grand Est;51;4;23;322;Lignon;122;1;123
44;Grand Est;51;2;21;323;Linthelles;106;6;112
44;Grand Est;51;2;21;324;Linthes;113;0;113
44;Grand Est;51;4;20;325;Lisse-en-Champagne;108;1;109
44;Grand Est;51;1;10;326;Livry-Louvercy;1093;14;1107
44;Grand Est;51;2;22;327;Loisy-en-Brie;177;2;179
44;Grand Est;51;4;23;328;Loisy-sur-Marne;1109;24;1133
44;Grand Est;51;3;02;329;Loivre;1380;19;1399
44;Grand Est;51;3;10;333;Ludes;680;15;695
44;Grand Est;51;4;20;334;Luxémont-et-Villotte;463;17;480
44;Grand Est;51;1;01;336;Maffrécourt;58;1;59
44;Grand Est;51;3;09;337;Magneux;269;2;271
44;Grand Est;51;3;10;338;Mailly-Champagne;629;16;645
44;Grand Est;51;1;05;339;Mairy-sur-Marne;562;15;577
44;Grand Est;51;4;23;340;Maisons-en-Champagne;541;14;555
44;Grand Est;51;1;01;341;Malmy;34;2;36
44;Grand Est;51;2;08;342;Mancy;243;7;250
44;Grand Est;51;2;22;343;Marcilly-sur-Seine;623;21;644
44;Grand Est;51;2;07;344;Mardeuil;1474;20;1494
44;Grand Est;51;2;06;345;Mareuil-en-Brie;286;2;288
44;Grand Est;51;2;06;346;Mareuil-le-Port;1152;18;1170
44;Grand Est;51;3;06;348;Marfaux;109;1;110
44;Grand Est;51;4;23;349;Margerie-Hancourt;170;5;175
44;Grand Est;51;2;06;350;Margny;127;5;132
44;Grand Est;51;2;22;351;Marigny;112;1;113
44;Grand Est;51;4;23;352;Marolles;852;19;871
44;Grand Est;51;2;22;353;Marsangis;47;2;49
44;Grand Est;51;1;05;354;Marson;279;9;288
44;Grand Est;51;1;01;355;Massiges;49;0;49
44;Grand Est;51;4;20;356;Matignicourt-Goncourt;153;5;158
44;Grand Est;51;1;04;357;Matougues;623;14;637
44;Grand Est;51;4;20;358;Maurupt-le-Montois;583;10;593
44;Grand Est;51;2;21;359;Mécringes;210;3;213
44;Grand Est;51;2;21;360;Le Meix-Saint-Epoing;298;2;300
44;Grand Est;51;4;23;361;Le Meix-Tiercelin;166;1;167
44;Grand Est;51;3;02;362;Merfy;603;19;622
44;Grand Est;51;4;20;363;Merlaut;263;7;270
44;Grand Est;51;3;09;364;Méry-Prémecy;67;1;68
44;Grand Est;51;3;09;365;Les Mesneux;905;16;921
44;Grand Est;51;2;22;367;Le Mesnil-sur-Oger;1028;35;1063
44;Grand Est;51;1;01;368;Minaucourt-le-Mesnil-lès-Hurlus;47;3;50
44;Grand Est;51;2;21;369;Mœurs-Verdey;312;15;327
44;Grand Est;51;1;01;370;Moiremont;191;10;201
44;Grand Est;51;1;05;371;Moivre;59;1;60
44;Grand Est;51;1;05;372;Moncetz-Longevas;542;11;553
44;Grand Est;51;4;20;373;Moncetz-l'Abbaye;90;4;94
44;Grand Est;51;2;21;374;Mondement-Montgivroux;26;0;26
44;Grand Est;51;3;10;375;Montbré;354;6;360
44;Grand Est;51;2;21;376;Montgenost;154;2;156
44;Grand Est;51;1;05;377;Montépreux;48;0;48
44;Grand Est;51;2;08;378;Monthelon;347;5;352
44;Grand Est;51;3;09;379;Montigny-sur-Vesle;509;8;517
44;Grand Est;51;2;21;380;Montmirail;3561;48;3609
44;Grand Est;51;2;06;381;Montmort-Lucy;624;10;634
44;Grand Est;51;3;09;382;Mont-sur-Courville;113;4;117
44;Grand Est;51;2;08;384;Morangis;394;12;406
44;Grand Est;51;2;21;386;Morsains;141;2;143
44;Grand Est;51;2;22;387;Moslins;291;3;294
44;Grand Est;51;1;10;388;Mourmelon-le-Grand;5163;50;5213
44;Grand Est;51;1;10;389;Mourmelon-le-Petit;813;7;820
44;Grand Est;51;2;08;390;Moussy;783;10;793
44;Grand Est;51;3;09;391;Muizon;2105;62;2167
44;Grand Est;51;2;07;392;Mutigny;193;5;198
44;Grand Est;51;2;07;393;Nanteuil-la-Forêt;299;7;306
44;Grand Est;51;2;21;395;Nesle-la-Reposte;95;1;96
44;Grand Est;51;2;06;396;Nesle-le-Repons;139;3;142
44;Grand Est;51;1;01;397;La Neuville-aux-Bois;137;2;139
44;Grand Est;51;2;06;398;La Neuville-aux-Larris;187;2;189
44;Grand Est;51;1;01;399;La Neuville-au-Pont;542;9;551
44;Grand Est;51;2;21;402;Neuvy;266;7;273
44;Grand Est;51;3;02;403;Nogent-l'Abbesse;530;9;539
44;Grand Est;51;1;01;404;Noirlieu;107;4;111
44;Grand Est;51;4;20;406;Norrois;155;1;156
44;Grand Est;51;2;21;407;La Noue;409;7;416
44;Grand Est;51;1;05;409;Nuisement-sur-Coole;375;8;383
44;Grand Est;51;2;06;410;Œuilly;657;10;667
44;Grand Est;51;2;22;412;Ognes;59;2;61
44;Grand Est;51;2;08;413;Oiry;887;18;905
44;Grand Est;51;3;06;414;Olizy;148;5;153
44;Grand Est;51;1;05;415;Omey;202;0;202
44;Grand Est;51;2;06;416;Orbais-l'Abbaye;545;3;548
44;Grand Est;51;4;20;417;Orconte;372;3;375
44;Grand Est;51;3;09;418;Ormes;460;4;464
44;Grand Est;51;4;20;419;Outines;126;1;127
44;Grand Est;51;4;20;420;Outrepont;81;0;81
44;Grand Est;51;2;21;421;Oyes;103;3;106
44;Grand Est;51;3;09;422;Pargny-lès-Reims;478;10;488
44;Grand Est;51;4;20;423;Pargny-sur-Saulx;1723;15;1738
44;Grand Est;51;1;01;424;Passavant-en-Argonne;207;1;208
44;Grand Est;51;2;06;425;Passy-Grigny;380;14;394
44;Grand Est;51;2;21;426;Péas;66;3;69
44;Grand Est;51;3;10;428;Les Petites-Loges;491;9;500
44;Grand Est;51;3;09;429;Pévy;208;3;211
44;Grand Est;51;2;22;430;Pierre-Morains;85;2;87
44;Grand Est;51;2;08;431;Pierry;1207;18;1225
44;Grand Est;51;2;22;432;Pleurs;828;19;847
44;Grand Est;51;4;20;433;Plichancourt;246;5;251
44;Grand Est;51;2;08;434;Plivot;746;20;766
44;Grand Est;51;2;22;435;Pocancy;181;2;183
44;Grand Est;51;1;05;436;Pogny;929;17;946
44;Grand Est;51;3;06;437;Poilly;94;0;94
44;Grand Est;51;1;01;438;Poix;71;1;72
44;Grand Est;51;3;02;439;Pomacle;486;6;492
44;Grand Est;51;3;10;440;Pontfaverger-Moronvilliers;1739;17;1756
44;Grand Est;51;4;20;441;Ponthion;105;2;107
44;Grand Est;51;4;20;442;Possesse;132;0;132
44;Grand Est;51;2;22;443;Potangis;116;3;119
44;Grand Est;51;3;02;444;Pouillon;505;10;515
44;Grand Est;51;3;06;445;Pourcy;198;3;201
44;Grand Est;51;4;23;446;Pringy;435;8;443
44;Grand Est;51;3;10;447;Prosnes;484;13;497
44;Grand Est;51;3;09;448;Prouilly;553;10;563
44;Grand Est;51;3;18;449;Prunay;1026;15;1041
44;Grand Est;51;3;18;450;Puisieulx;425;8;433
44;Grand Est;51;2;21;451;Queudes;85;4;89
44;Grand Est;51;1;01;452;Rapsécourt;32;0;32
44;Grand Est;51;1;04;453;Recy;1044;31;1075
44;Grand Est;51;3;99;454;Reims;180318;2969;183287
44;Grand Est;51;4;20;455;Reims-la-Brûlée;221;3;224
44;Grand Est;51;1;01;456;Remicourt;59;1;60
44;Grand Est;51;2;06;457;Reuil;281;18;299
44;Grand Est;51;2;21;458;Reuves;62;0;62
44;Grand Est;51;2;21;459;Réveillon;108;1;109
44;Grand Est;51;2;21;460;Rieux;194;5;199
44;Grand Est;51;3;10;461;Rilly-la-Montagne;1020;22;1042
44;Grand Est;51;4;23;463;Les Rivières-Henruel;162;5;167
44;Grand Est;51;3;09;464;Romain;310;17;327
44;Grand Est;51;2;06;465;Romery;162;2;164
44;Grand Est;51;3;06;466;Romigny;216;5;221
44;Grand Est;51;3;09;468;Rosnay;362;12;374
44;Grand Est;51;2;22;469;Rouffy;111;5;116
44;Grand Est;51;1;01;470;Rouvroy-Ripont;3;0;3
44;Grand Est;51;3;09;471;Sacy;372;3;375
44;Grand Est;51;4;20;472;Saint-Amand-sur-Fion;1028;26;1054
44;Grand Est;51;2;21;473;Saint-Bon;100;6;106
44;Grand Est;51;3;15;474;Saint-Brice-Courcelles;3392;39;3431
44;Grand Est;51;4;23;475;Saint-Chéron;61;1;62
44;Grand Est;51;1;05;476;Saint-Étienne-au-Temple;821;13;834
44;Grand Est;51;3;02;477;Saint-Étienne-sur-Suippe;335;4;339
44;Grand Est;51;4;20;478;Saint-Eulien;422;12;434
44;Grand Est;51;3;09;479;Saint-Euphraise-et-Clairizet;243;5;248
44;Grand Est;51;2;06;480;Sainte-Gemme;137;3;140
44;Grand Est;51;1;05;482;Saint-Germain-la-Ville;683;13;696
44;Grand Est;51;1;04;483;Saint-Gibrien;539;7;546
44;Grand Est;51;3;09;484;Saint-Gilles;272;5;277
44;Grand Est;51;1;10;485;Saint-Hilaire-au-Temple;332;9;341
44;Grand Est;51;1;01;486;Saint-Hilaire-le-Grand;378;4;382
44;Grand Est;51;3;10;487;Saint-Hilaire-le-Petit;347;6;353
44;Grand Est;51;2;07;488;Saint-Imoges;316;35;351
44;Grand Est;51;4;20;489;Saint-Jean-devant-Possesse;31;3;34
44;Grand Est;51;1;05;490;Saint-Jean-sur-Moivre;199;2;201
44;Grand Est;51;1;01;491;Saint-Jean-sur-Tourbe;88;3;91
44;Grand Est;51;2;22;492;Saint-Just-Sauvage;1414;35;1449
44;Grand Est;51;3;18;493;Saint-Léonard;109;4;113
44;Grand Est;51;2;21;495;Saint-Loup;74;0;74
44;Grand Est;51;4;20;496;Saint-Lumier-en-Champagne;267;8;275
44;Grand Est;51;4;20;497;Saint-Lumier-la-Populeuse;41;0;41
44;Grand Est;51;1;01;498;Saint-Mard-sur-Auve;64;1;65
44;Grand Est;51;2;22;499;Saint-Mard-lès-Rouffy;159;7;166
44;Grand Est;51;1;01;500;Saint-Mard-sur-le-Mont;117;2;119
44;Grand Est;51;1;01;501;Sainte-Marie-à-Py;194;8;202
44;Grand Est;51;1;05;502;Saint-Martin-aux-Champs;115;0;115
44;Grand Est;51;3;10;503;Saint-Martin-l'Heureux;84;1;85
44;Grand Est;51;1;04;504;Saint-Martin-sur-le-Pré;801;13;814
44;Grand Est;51;3;10;505;Saint-Masmes;500;5;505
44;Grand Est;51;1;05;506;Saint-Memmie;5448;75;5523
44;Grand Est;51;1;01;507;Sainte-Menehould;4166;111;4277
44;Grand Est;51;4;23;508;Saint-Ouen-Domprot;203;3;206
44;Grand Est;51;1;04;509;Saint-Pierre;308;9;317
44;Grand Est;51;4;20;510;Saint-Quentin-les-Marais;124;0;124
44;Grand Est;51;2;22;511;Saint-Quentin-le-Verger;117;2;119
44;Grand Est;51;1;05;512;Saint-Quentin-sur-Coole;101;2;103
44;Grand Est;51;4;20;513;Saint-Remy-en-Bouzemont-Saint-Genest-et-Isson;508;9;517
44;Grand Est;51;2;21;514;Saint-Remy-sous-Broyes;108;1;109
44;Grand Est;51;1;01;515;Saint-Remy-sur-Bussy;336;8;344
44;Grand Est;51;2;22;516;Saint-Saturnin;47;0;47
44;Grand Est;51;3;10;517;Saint-Souplet-sur-Py;118;4;122
44;Grand Est;51;3;02;518;Saint-Thierry;611;24;635
44;Grand Est;51;1;01;519;Saint-Thomas-en-Argonne;38;2;40
44;Grand Est;51;4;23;520;Saint-Utin;76;1;77
44;Grand Est;51;4;20;521;Saint-Vrain;223;3;226
44;Grand Est;51;4;20;522;Sapignicourt;431;5;436
44;Grand Est;51;3;06;523;Sarcy;269;4;273
44;Grand Est;51;2;22;524;Saron-sur-Aube;289;3;292
44;Grand Est;51;1;05;525;Sarry;2023;86;2109
44;Grand Est;51;2;21;526;Saudoy;387;10;397
44;Grand Est;51;3;09;527;Savigny-sur-Ardres;270;4;274
44;Grand Est;51;4;20;528;Scrupt;127;0;127
44;Grand Est;51;3;10;529;Selles;427;5;432
44;Grand Est;51;3;10;530;Sept-Saulx;686;12;698
44;Grand Est;51;4;20;531;Sermaize-les-Bains;1779;31;1810
44;Grand Est;51;3;09;532;Sermiers;568;15;583
44;Grand Est;51;1;01;533;Servon-Melzicourt;100;6;106
44;Grand Est;51;3;09;534;Serzy-et-Prin;211;4;215
44;Grand Est;51;2;21;535;Sézanne;4775;106;4881
44;Grand Est;51;3;18;536;Sillery;1796;38;1834
44;Grand Est;51;1;01;537;Sivry-Ante;178;4;182
44;Grand Est;51;1;05;538;Sogny-aux-Moulins;111;0;111
44;Grand Est;51;4;20;539;Sogny-en-l'Angle;74;0;74
44;Grand Est;51;2;21;542;Soizy-aux-Bois;193;0;193
44;Grand Est;51;1;01;543;Somme-Bionne;69;7;76
44;Grand Est;51;1;01;544;Sommepy-Tahure;646;18;664
44;Grand Est;51;1;05;545;Sommesous;487;16;503
44;Grand Est;51;1;01;546;Somme-Suippe;510;150;660
44;Grand Est;51;1;01;547;Somme-Tourbe;140;2;142
44;Grand Est;51;1;01;548;Somme-Vesle;357;242;599
44;Grand Est;51;1;01;549;Somme-Yèvre;123;3;126
44;Grand Est;51;4;23;550;Sompuis;267;11;278
44;Grand Est;51;4;23;551;Somsois;200;6;206
44;Grand Est;51;4;23;552;Songy;270;4;274
44;Grand Est;51;1;01;553;Souain-Perthes-lès-Hurlus;250;5;255
44;Grand Est;51;1;05;555;Soudé;157;0;157
44;Grand Est;51;1;05;556;Soudron;293;4;297
44;Grand Est;51;4;23;557;Soulanges;464;9;473
44;Grand Est;51;2;22;558;Soulières;141;3;144
44;Grand Est;51;1;01;559;Suippes;3881;36;3917
44;Grand Est;51;2;06;560;Suizy-le-Franc;107;3;110
44;Grand Est;51;3;18;562;Taissy;2180;36;2216
44;Grand Est;51;2;06;563;Talus-Saint-Prix;105;2;107
44;Grand Est;51;2;07;564;Val de Livre;603;17;620
44;Grand Est;51;2;22;565;Thaas;102;0;102
44;Grand Est;51;1;04;566;Thibie;293;2;295
44;Grand Est;51;4;20;567;Thiéblemont-Farémont;518;6;524
44;Grand Est;51;3;02;568;Thil;307;7;314
44;Grand Est;51;3;09;569;Thillois;506;69;575
44;Grand Est;51;2;21;570;Le Thoult-Trosnay;106;2;108
44;Grand Est;51;3;10;571;Val-de-Vesle;951;10;961
44;Grand Est;51;1;01;572;Tilloy-et-Bellay;233;11;244
44;Grand Est;51;3;14;573;Tinqueux;10456;135;10591
44;Grand Est;51;1;05;574;Togny-aux-Bœufs;138;2;140
44;Grand Est;51;2;07;576;Tours-sur-Marne;1386;13;1399
44;Grand Est;51;3;06;577;Tramery;154;3;157
44;Grand Est;51;2;22;578;Trécon;91;1;92
44;Grand Est;51;2;21;579;Tréfols;177;3;180
44;Grand Est;51;3;10;580;Trépail;440;5;445
44;Grand Est;51;3;09;581;Treslon;255;2;257
44;Grand Est;51;3;09;582;Trigny;566;10;576
44;Grand Est;51;4;20;583;Trois-Fontaines-l'Abbaye;192;0;192
44;Grand Est;51;3;18;584;Trois-Puits;144;2;146
44;Grand Est;51;2;06;585;Troissy;786;62;848
44;Grand Est;51;3;09;586;Unchair;183;5;188
44;Grand Est;51;1;10;587;Vadenay;232;5;237
44;Grand Est;51;1;01;588;Valmy;282;6;288
44;Grand Est;51;4;20;589;Vanault-le-Châtel;172;1;173
44;Grand Est;51;4;20;590;Vanault-les-Dames;368;9;377
44;Grand Est;51;3;09;591;Vandeuil;172;3;175
44;Grand Est;51;2;06;592;Vandières;298;6;304
44;Grand Est;51;1;05;594;Vassimont-et-Chapelaine;64;0;64
44;Grand Est;51;1;05;595;Vatry;153;2;155
44;Grand Est;51;2;21;596;Vauchamps;358;2;360
44;Grand Est;51;2;06;597;Vauciennes;331;7;338
44;Grand Est;51;4;20;598;Vauclerc;489;9;498
44;Grand Est;51;3;10;599;Vaudemange;334;5;339
44;Grand Est;51;3;10;600;Vaudesincourt;98;1;99
44;Grand Est;51;4;20;601;Vavray-le-Grand;158;3;161
44;Grand Est;51;4;20;602;Vavray-le-Petit;64;0;64
44;Grand Est;51;2;22;603;Vélye;210;2;212
44;Grand Est;51;3;09;604;Ventelay;257;3;260
44;Grand Est;51;2;06;605;Venteuil;525;10;535
44;Grand Est;51;2;21;607;Verdon;202;2;204
44;Grand Est;51;4;20;608;Vernancourt;84;5;89
44;Grand Est;51;2;06;609;Verneuil;844;14;858
44;Grand Est;51;1;01;610;Verrières;388;6;394
44;Grand Est;51;2;22;611;Vert-Toulon;286;4;290
44;Grand Est;51;2;22;612;Blancs-Coteaux;3244;200;3444
44;Grand Est;51;3;10;613;Verzenay;1031;16;1047
44;Grand Est;51;3;10;614;Verzy;953;21;974
44;Grand Est;51;1;05;616;Vésigneul-sur-Marne;230;3;233
44;Grand Est;51;1;04;617;La Veuve;599;17;616
44;Grand Est;51;2;21;618;Le Vézier;190;3;193
44;Grand Est;51;1;01;619;Le Vieil-Dampierre;111;3;114
44;Grand Est;51;1;01;620;Vienne-la-Ville;169;5;174
44;Grand Est;51;1;01;621;Vienne-le-Château;516;8;524
44;Grand Est;51;3;09;622;Ville-Dommange;402;9;411
44;Grand Est;51;3;10;623;Ville-en-Selve;287;46;333
44;Grand Est;51;3;06;624;Ville-en-Tardenois;642;7;649
44;Grand Est;51;2;21;625;Villeneuve-la-Lionne;280;4;284
44;Grand Est;51;2;21;626;La Villeneuve-lès-Charleville;121;5;126
44;Grand Est;51;2;22;627;Villeneuve-Renneville-Chevigny;326;11;337
44;Grand Est;51;2;21;628;Villeneuve-Saint-Vistre-et-Villevotte;122;4;126
44;Grand Est;51;3;10;629;Villers-Allerand;925;23;948
44;Grand Est;51;2;22;630;Villers-aux-Bois;330;5;335
44;Grand Est;51;3;14;631;Villers-aux-Nœuds;271;4;275
44;Grand Est;51;1;01;632;Villers-en-Argonne;230;7;237
44;Grand Est;51;3;02;633;Villers-Franqueux;296;15;311
44;Grand Est;51;1;04;634;Villers-le-Château;281;9;290
44;Grand Est;51;4;20;635;Villers-le-Sec;109;0;109
44;Grand Est;51;3;10;636;Villers-Marmery;538;12;550
44;Grand Est;51;2;06;637;Villers-sous-Châtillon;210;3;213
44;Grand Est;51;2;22;638;Villeseneux;204;6;210
44;Grand Est;51;2;06;639;La Ville-sous-Orbais;42;1;43
44;Grand Est;51;1;01;640;Ville-sur-Tourbe;211;1;212
44;Grand Est;51;2;06;641;Villevenard;197;5;202
44;Grand Est;51;2;22;642;Villiers-aux-Corneilles;110;4;114
44;Grand Est;51;2;08;643;Vinay;549;5;554
44;Grand Est;51;2;06;644;Vincelles;317;9;326
44;Grand Est;51;2;21;645;Vindey;109;2;111
44;Grand Est;51;1;01;646;Virginy;82;3;85
44;Grand Est;51;4;20;647;Vitry-en-Perthois;826;24;850
44;Grand Est;51;1;05;648;Vitry-la-Ville;383;9;392
44;Grand Est;51;4;23;649;Vitry-le-François;11458;220;11678
44;Grand Est;51;1;01;650;Voilemont;47;1;48
44;Grand Est;51;2;22;652;Vouarces;57;0;57
44;Grand Est;51;4;20;654;Vouillers;258;2;260
44;Grand Est;51;2;22;655;Vouzy;291;5;296
44;Grand Est;51;1;04;656;Vraux;456;19;475
44;Grand Est;51;3;09;657;Vrigny;252;0;252
44;Grand Est;51;4;20;658;Vroil;104;0;104
44;Grand Est;51;1;01;659;Wargemoulin-Hurlus;48;1;49
44;Grand Est;51;3;02;660;Warmeriville;2644;28;2672
44;Grand Est;51;3;02;662;Witry-lès-Reims;4951;71;5022
44;Grand Est;51;2;07;663;Magenta;1694;15;1709
44;Grand Est;52;1;11;001;Ageville;313;8;321
44;Grand Est;52;2;02;002;Aigremont;23;0;23
44;Grand Est;52;1;12;003;Aillianville;148;2;150
44;Grand Est;52;3;12;004;Aingoulaincourt;13;0;13
44;Grand Est;52;1;04;005;Aizanville;34;4;38
44;Grand Est;52;3;13;006;Allichamps;357;4;361
44;Grand Est;52;3;09;007;Ambonville;88;2;90
44;Grand Est;52;1;01;008;Andelot-Blancheville;867;11;878
44;Grand Est;52;2;11;009;Andilly-en-Bassigny;103;1;104
44;Grand Est;52;1;01;011;Annéville-la-Prairie;93;0;93
44;Grand Est;52;3;12;012;Annonville;29;2;31
44;Grand Est;52;2;03;013;Anrosey;125;2;127
44;Grand Est;52;2;16;014;Aprey;189;5;194
44;Grand Est;52;2;03;015;Arbigny-sous-Varennes;85;0;85
44;Grand Est;52;2;16;016;Arbot;68;2;70
44;Grand Est;52;1;04;017;Arc-en-Barrois;723;13;736
44;Grand Est;52;3;09;019;Arnancourt;88;4;92
44;Grand Est;52;3;17;021;Attancourt;270;3;273
44;Grand Est;52;1;04;022;Aubepierre-sur-Aube;185;3;188
44;Grand Est;52;2;16;023;Auberive;151;5;156
44;Grand Est;52;1;12;025;Audeloncourt;87;2;89
44;Grand Est;52;2;16;027;Aujeurres;71;2;73
44;Grand Est;52;2;16;028;Aulnoy-sur-Aube;55;0;55
44;Grand Est;52;3;09;029;Autigny-le-Grand;132;4;136
44;Grand Est;52;3;09;030;Autigny-le-Petit;52;3;55
44;Grand Est;52;1;04;031;Autreville-sur-la-Renne;367;10;377
44;Grand Est;52;2;02;033;Avrecourt;104;4;108
44;Grand Est;52;3;17;034;Bailly-aux-Forges;145;5;150
44;Grand Est;52;2;16;035;Baissey;183;3;186
44;Grand Est;52;2;11;037;Bannes;368;8;376
44;Grand Est;52;1;12;038;Bassoncourt;64;0;64
44;Grand Est;52;3;09;039;Baudrecourt;87;0;87
44;Grand Est;52;2;16;040;Bay-sur-Aube;51;0;51
44;Grand Est;52;2;10;042;Beauchemin;108;6;114
44;Grand Est;52;2;03;043;Belmont;54;1;55
44;Grand Est;52;3;01;044;Roches-Bettaincourt;544;11;555
44;Grand Est;52;3;15;045;Bettancourt-la-Ferrée;1794;31;1825
44;Grand Est;52;3;09;047;Beurville;103;0;103
44;Grand Est;52;1;11;050;Biesles;1332;31;1363
44;Grand Est;52;2;03;051;Bize;82;4;86
44;Grand Est;52;1;04;053;Blaisy;68;0;68
44;Grand Est;52;3;09;055;Blécourt;116;1;117
44;Grand Est;52;1;04;056;Blessonville;183;8;191
44;Grand Est;52;3;09;057;Blumeray;102;4;106
44;Grand Est;52;1;01;058;Bologne;1827;32;1859
44;Grand Est;52;2;11;059;Bonnecourt;145;0;145
44;Grand Est;52;2;02;060;Bourbonne-les-Bains;1971;53;2024
44;Grand Est;52;1;01;061;Bourdons-sur-Rognon;294;2;296
44;Grand Est;52;2;16;062;Bourg;159;3;162
44;Grand Est;52;1;12;063;Bourg-Sainte-Marie;94;0;94
44;Grand Est;52;1;12;064;Bourmont-entre-Meuse-et-Mouzon;770;34;804
44;Grand Est;52;3;09;065;Bouzancourt;65;2;67
44;Grand Est;52;3;09;066;Brachay;63;3;66
44;Grand Est;52;1;12;067;Brainville-sur-Meuse;72;0;72
44;Grand Est;52;1;04;069;Braux-le-Châtel;138;2;140
44;Grand Est;52;2;16;070;Brennes;120;3;123
44;Grand Est;52;1;05;072;Brethenay;379;11;390
44;Grand Est;52;1;12;074;Breuvannes-en-Bassigny;670;20;690
44;Grand Est;52;1;01;075;Briaucourt;175;6;181
44;Grand Est;52;1;04;076;Bricon;436;6;442
44;Grand Est;52;3;17;079;Brousseval;642;9;651
44;Grand Est;52;1;04;082;Bugnières;155;5;160
44;Grand Est;52;2;03;083;Champsevraine;738;14;752
44;Grand Est;52;1;12;084;Busson;43;0;43
44;Grand Est;52;1;02;085;Buxières-lès-Clefmont;26;2;28
44;Grand Est;52;1;06;087;Buxières-lès-Villiers;198;20;218
44;Grand Est;52;3;17;088;Ceffonds;650;16;666
44;Grand Est;52;2;02;089;Celles-en-Bassigny;72;0;72
44;Grand Est;52;2;03;090;Celsoy;101;1;102
44;Grand Est;52;3;01;091;Cerisières;85;6;91
44;Grand Est;52;2;16;092;Chalancey;106;2;108
44;Grand Est;52;2;03;093;Chalindrey;2406;55;2461
44;Grand Est;52;2;16;094;Vals-des-Tilles;179;2;181
44;Grand Est;52;1;12;095;Chalvraines;192;2;194
44;Grand Est;52;1;12;097;Chambroncourt;49;1;50
44;Grand Est;52;3;08;099;Chamouilley;764;7;771
44;Grand Est;52;1;12;101;Champigneulles-en-Bassigny;40;1;41
44;Grand Est;52;2;10;102;Champigny-lès-Langres;416;6;422
44;Grand Est;52;2;03;103;Champigny-sous-Varennes;119;2;121
44;Grand Est;52;3;15;104;Chancenay;1024;24;1048
44;Grand Est;52;2;11;105;Changey;296;6;302
44;Grand Est;52;2;10;106;Chanoy;119;2;121
44;Grand Est;52;1;01;107;Chantraines;218;4;222
44;Grand Est;52;2;11;108;Charmes;147;4;151
44;Grand Est;52;3;09;109;Charmes-en-l'Angle;6;0;6
44;Grand Est;52;3;09;110;Charmes-la-Grande;156;3;159
44;Grand Est;52;2;16;113;Chassigny;256;5;261
44;Grand Est;52;1;04;114;Châteauvillain;1573;19;1592
44;Grand Est;52;2;10;115;Chatenay-Mâcheron;98;2;100
44;Grand Est;52;2;10;116;Chatenay-Vaudin;48;2;50
44;Grand Est;52;3;09;118;Chatonrupt-Sommermont;276;6;282
44;Grand Est;52;2;03;119;Chaudenay;345;9;354
44;Grand Est;52;2;02;120;Chauffourt;182;7;189
44;Grand Est;52;1;98;121;Chaumont;21770;1196;22966
44;Grand Est;52;1;12;122;Chaumont-la-Ville;115;1;116
44;Grand Est;52;3;08;123;Chevillon;1305;25;1330
44;Grand Est;52;2;03;124;Chézeaux;76;0;76
44;Grand Est;52;1;06;125;Chamarandes-Choignes;1046;174;1220
44;Grand Est;52;2;16;126;Choilley-Dardenay;157;4;161
44;Grand Est;52;1;02;127;Choiseul;78;4;82
44;Grand Est;52;1;01;128;Cirey-lès-Mareilles;146;3;149
44;Grand Est;52;3;09;129;Cirey-sur-Blaise;117;0;117
44;Grand Est;52;1;04;130;Cirfontaines-en-Azois;190;2;192
44;Grand Est;52;3;12;131;Cirfontaines-en-Ornois;79;2;81
44;Grand Est;52;1;02;132;Clefmont;164;3;167
44;Grand Est;52;1;12;133;Clinchamp;70;0;70
44;Grand Est;52;2;16;134;Cohons;218;1;219
44;Grand Est;52;2;03;135;Coiffy-le-Bas;87;2;89
44;Grand Est;52;2;02;136;Coiffy-le-Haut;108;0;108
44;Grand Est;52;2;16;137;Colmier-le-Bas;21;0;21
44;Grand Est;52;2;16;138;Colmier-le-Haut;64;1;65
44;Grand Est;52;1;04;140;Colombey les Deux Églises;693;16;709
44;Grand Est;52;1;05;141;Condes;295;6;301
44;Grand Est;52;1;01;142;Consigny;73;1;74
44;Grand Est;52;2;16;145;Coublanc;119;5;124
44;Grand Est;52;1;04;146;Coupray;160;3;163
44;Grand Est;52;2;16;147;Courcelles-en-Montagne;90;2;92
44;Grand Est;52;3;09;149;Courcelles-sur-Blaise;90;2;92
44;Grand Est;52;1;04;151;Cour-l'Évêque;148;2;150
44;Grand Est;52;2;03;155;Culmont;522;12;534
44;Grand Est;52;3;08;156;Curel;407;8;415
44;Grand Est;52;1;04;157;Curmont;12;1;13
44;Grand Est;52;2;16;158;Cusey;281;3;284
44;Grand Est;52;1;11;159;Cuves;26;1;27
44;Grand Est;52;1;01;160;Daillancourt;63;3;66
44;Grand Est;52;1;02;161;Daillecourt;72;0;72
44;Grand Est;52;2;02;162;Dammartin-sur-Meuse;197;2;199
44;Grand Est;52;2;11;163;Dampierre;387;4;391
44;Grand Est;52;2;02;164;Damrémont;197;5;202
44;Grand Est;52;1;04;165;Dancevoir;196;5;201
44;Grand Est;52;1;01;167;Darmannes;263;3;266
44;Grand Est;52;1;04;168;Dinteville;62;3;65
44;Grand Est;52;3;08;169;Domblain;77;2;79
44;Grand Est;52;2;16;170;Dommarien;168;7;175
44;Grand Est;52;3;17;171;Dommartin-le-Franc;241;2;243
44;Grand Est;52;3;09;172;Dommartin-le-Saint-Père;282;7;289
44;Grand Est;52;3;01;173;Domremy-Landéville;76;2;78
44;Grand Est;52;1;12;174;Doncourt-sur-Meuse;37;1;38
44;Grand Est;52;3;09;175;Donjeux;392;4;396
44;Grand Est;52;3;01;177;Doulaincourt-Saucourt;780;34;814
44;Grand Est;52;3;09;178;Doulevant-le-Château;361;9;370
44;Grand Est;52;3;17;179;Doulevant-le-Petit;19;2;21
44;Grand Est;52;3;12;181;Échenay;91;1;92
44;Grand Est;52;3;13;182;Éclaron-Braucourt-Sainte-Livière;2017;49;2066
44;Grand Est;52;1;01;183;Ecot-la-Combe;39;1;40
44;Grand Est;52;3;12;184;Effincourt;58;5;63
44;Grand Est;52;2;02;185;Enfonvelle;64;0;64
44;Grand Est;52;3;12;187;Épizon;159;4;163
44;Grand Est;52;2;16;189;Le Val-d'Esnoms;407;11;418
44;Grand Est;52;1;11;190;Esnouveaux;291;7;298
44;Grand Est;52;1;05;193;Euffigneix;298;12;310
44;Grand Est;52;3;08;194;Eurville-Bienville;2029;37;2066
44;Grand Est;52;2;03;195;Farincourt;36;0;36
44;Grand Est;52;2;10;196;Faverolles;96;4;100
44;Grand Est;52;2;03;197;Fayl-Billot;1285;80;1365
44;Grand Est;52;3;08;198;Fays;67;2;69
44;Grand Est;52;3;09;199;Ferrière-et-Lafolie;51;2;53
44;Grand Est;52;2;16;200;Flagey;74;5;79
44;Grand Est;52;3;09;201;Flammerécourt;69;0;69
44;Grand Est;52;3;08;203;Fontaines-sur-Marne;146;2;148
44;Grand Est;52;1;11;204;Forcey;63;4;67
44;Grand Est;52;1;07;205;Foulain;688;17;705
44;Grand Est;52;3;17;206;Frampas;154;4;158
44;Grand Est;52;2;02;207;Frécourt;95;3;98
44;Grand Est;52;2;02;208;Fresnes-sur-Apance;151;3;154
44;Grand Est;52;1;01;211;Froncles;1406;24;1430
44;Grand Est;52;3;09;212;Fronville;306;4;310
44;Grand Est;52;2;03;213;Genevrières;129;4;133
44;Grand Est;52;1;01;214;La Genevroye;31;1;32
44;Grand Est;52;2;16;216;Germaines;50;1;51
44;Grand Est;52;1;12;217;Germainvilliers;86;4;90
44;Grand Est;52;3;12;218;Germay;50;0;50
44;Grand Est;52;3;12;219;Germisay;18;0;18
44;Grand Est;52;1;04;220;Giey-sur-Aujon;142;1;143
44;Grand Est;52;1;04;221;Gillancourt;121;2;123
44;Grand Est;52;3;12;222;Gillaumé;34;0;34
44;Grand Est;52;2;03;223;Gilley;66;2;68
44;Grand Est;52;1;12;227;Graffigny-Chemin;206;10;216
44;Grand Est;52;2;03;228;Grandchamp;75;1;76
44;Grand Est;52;2;03;229;Grenant;153;1;154
44;Grand Est;52;3;09;230;Gudmont-Villiers;283;5;288
44;Grand Est;52;3;09;231;Guindrecourt-aux-Ormes;89;2;91
44;Grand Est;52;1;01;232;Guindrecourt-sur-Blaise;64;0;64
44;Grand Est;52;2;03;233;Guyonvelle;103;2;105
44;Grand Est;52;1;12;234;Hâcourt;41;3;44
44;Grand Est;52;3;13;235;Hallignicourt;248;4;252
44;Grand Est;52;1;12;237;Harréville-les-Chanteurs;274;9;283
44;Grand Est;52;2;03;240;Heuilley-le-Grand;190;7;197
44;Grand Est;52;2;03;242;Haute-Amance;964;16;980
44;Grand Est;52;1;12;243;Huilliécourt;122;1;123
44;Grand Est;52;3;13;244;Humbécourt;753;11;764
44;Grand Est;52;1;12;245;Humberville;61;5;66
44;Grand Est;52;2;10;246;Humes-Jorquenay;583;12;595
44;Grand Est;52;1;12;247;Illoud;204;8;212
44;Grand Est;52;1;02;248;Is-en-Bassigny;547;17;564
44;Grand Est;52;2;16;249;Isômes;147;0;147
44;Grand Est;52;3;09;250;Joinville;3001;69;3070
44;Grand Est;52;1;05;251;Jonchery;983;35;1018
44;Grand Est;52;1;04;253;Juzennecourt;210;3;213
44;Grand Est;52;1;04;254;Lachapelle-en-Blaisy;86;1;87
44;Grand Est;52;1;12;256;Lafauche;75;2;77
44;Grand Est;52;2;03;257;Laferté-sur-Amance;105;2;107
44;Grand Est;52;1;04;258;Laferté-sur-Aube;309;2;311
44;Grand Est;52;1;01;260;Lamancine;123;2;125
44;Grand Est;52;2;02;264;Laneuvelle;61;2;63
44;Grand Est;52;3;08;265;Bayard-sur-Marne;1286;27;1313
44;Grand Est;52;3;17;266;Laneuville-à-Rémy;65;1;66
44;Grand Est;52;3;13;267;Laneuville-au-Pont;222;3;225
44;Grand Est;52;2;10;269;Langres;7682;399;8081
44;Grand Est;52;1;11;271;Lanques-sur-Rognon;203;6;209
44;Grand Est;52;1;04;272;Lanty-sur-Aube;114;1;115
44;Grand Est;52;2;02;273;Larivière-Arnoncourt;122;1;123
44;Grand Est;52;1;04;274;Latrecey-Ormoy-sur-Aube;289;9;298
44;Grand Est;52;2;02;275;Lavernoy;71;2;73
44;Grand Est;52;1;06;276;Laville-aux-Bois;232;8;240
44;Grand Est;52;2;02;277;Lavilleneuve;58;1;59
44;Grand Est;52;1;04;278;Lavilleneuve-au-Roi;69;0;69
44;Grand Est;52;2;10;280;Lecey;197;3;200
44;Grand Est;52;1;04;282;Leffonds;335;5;340
44;Grand Est;52;3;09;284;Leschères-sur-le-Blaiseron;90;1;91
44;Grand Est;52;2;16;285;Leuchey;75;2;77
44;Grand Est;52;1;12;286;Leurville;75;0;75
44;Grand Est;52;1;12;287;Levécourt;89;2;91
44;Grand Est;52;3;12;288;Lezéville;117;3;120
44;Grand Est;52;1;12;289;Liffol-le-Petit;314;12;326
44;Grand Est;52;2;03;290;Les Loges;129;2;131
44;Grand Est;52;1;12;291;Longchamp;61;0;61
44;Grand Est;52;2;16;292;Longeau-Percey;712;10;722
44;Grand Est;52;3;13;294;Louvemont;694;11;705
44;Grand Est;52;1;11;295;Louvières;94;0;94
44;Grand Est;52;1;07;297;Luzy-sur-Marne;276;10;286
44;Grand Est;52;2;16;298;Maâtz;72;1;73
44;Grand Est;52;3;08;300;Magneux;161;2;163
44;Grand Est;52;1;12;301;Maisoncelles;61;1;62
44;Grand Est;52;3;08;302;Maizières;185;3;188
44;Grand Est;52;2;03;303;Maizières-sur-Amance;96;1;97
44;Grand Est;52;1;12;304;Malaincourt-sur-Meuse;52;1;53
44;Grand Est;52;1;11;305;Mandres-la-Côte;555;5;560
44;Grand Est;52;1;12;306;Manois;449;10;459
44;Grand Est;52;2;10;307;Marac;213;9;222
44;Grand Est;52;1;04;308;Maranville;400;4;404
44;Grand Est;52;1;01;310;Marbéville;99;2;101
44;Grand Est;52;2;02;311;Marcilly-en-Bassigny;224;4;228
44;Grand Est;52;2;10;312;Mardor;56;3;59
44;Grand Est;52;1;01;313;Mareilles;141;1;142
44;Grand Est;52;1;11;315;Marnay-sur-Marne;339;1;340
44;Grand Est;52;3;09;316;Mathons;70;2;72
44;Grand Est;52;2;02;318;Melay;244;6;250
44;Grand Est;52;1;12;319;Mennouveaux;69;1;70
44;Grand Est;52;1;12;320;Merrey;92;3;95
44;Grand Est;52;3;09;321;Mertrud;180;3;183
44;Grand Est;52;1;01;322;Meures;132;4;136
44;Grand Est;52;1;12;325;Millières;117;5;122
44;Grand Est;52;1;01;326;Mirbel;41;0;41
44;Grand Est;52;3;13;327;Moëslains;453;9;462
44;Grand Est;52;2;02;328;Montcharvot;32;1;33
44;Grand Est;52;1;04;330;Montheries;67;2;69
44;Grand Est;52;3;17;331;La Porte du Der;2225;56;2281
44;Grand Est;52;2;02;332;Val-de-Meuse;1819;54;1873
44;Grand Est;52;1;01;335;Montot-sur-Rognon;114;1;115
44;Grand Est;52;3;17;336;Montreuil-sur-Blaise;138;3;141
44;Grand Est;52;3;12;337;Montreuil-sur-Thonnance;56;0;56
44;Grand Est;52;3;17;341;Morancourt;131;2;133
44;Grand Est;52;1;12;342;Morionvilliers;26;1;27
44;Grand Est;52;2;16;344;Mouilleron;30;1;31
44;Grand Est;52;3;09;346;Mussey-sur-Marne;385;6;391
44;Grand Est;52;3;08;347;Narcy;231;4;235
44;Grand Est;52;2;11;348;Neuilly-l'Évêque;571;21;592
44;Grand Est;52;1;07;349;Neuilly-sur-Suize;302;8;310
44;Grand Est;52;2;02;350;Neuvelle-lès-Voisey;66;0;66
44;Grand Est;52;1;11;352;Ninville;65;5;70
44;Grand Est;52;1;11;353;Nogent;3567;61;3628
44;Grand Est;52;2;03;354;Noidant-Chatenoy;83;0;83
44;Grand Est;52;2;16;355;Noidant-le-Rocheux;151;4;155
44;Grand Est;52;3;09;356;Nomécourt;108;4;112
44;Grand Est;52;3;12;357;Noncourt-sur-le-Rongeant;175;1;176
44;Grand Est;52;1;02;358;Noyers;94;0;94
44;Grand Est;52;3;09;359;Nully;145;2;147
44;Grand Est;52;2;16;360;Occey;166;4;170
44;Grand Est;52;2;11;362;Orbigny-au-Mont;137;2;139
44;Grand Est;52;2;11;363;Orbigny-au-Val;98;7;105
44;Grand Est;52;2;16;364;Orcevaux;102;3;105
44;Grand Est;52;1;04;365;Orges;343;3;346
44;Grand Est;52;2;10;366;Ormancey;76;1;77
44;Grand Est;52;1;01;367;Ormoy-lès-Sexfontaines;41;1;42
44;Grand Est;52;1;12;369;Orquevaux;69;0;69
44;Grand Est;52;3;08;370;Osne-le-Val;255;5;260
44;Grand Est;52;1;01;371;Oudincourt;138;2;140
44;Grand Est;52;1;12;372;Outremécourt;83;6;89
44;Grand Est;52;1;12;373;Ozières;32;1;33
44;Grand Est;52;2;03;374;Le Pailly;272;5;277
44;Grand Est;52;2;03;375;Palaiseul;54;0;54
44;Grand Est;52;3;12;376;Pansey;108;2;110
44;Grand Est;52;2;02;377;Parnoy-en-Bassigny;287;8;295
44;Grand Est;52;3;12;378;Paroy-sur-Saulx;45;2;47
44;Grand Est;52;2;10;380;Peigney;387;4;391
44;Grand Est;52;2;10;383;Perrancey-les-Vieux-Moulins;292;7;299
44;Grand Est;52;2;16;384;Perrogney-les-Fontaines;112;0;112
44;Grand Est;52;1;02;385;Perrusse;30;1;31
44;Grand Est;52;3;13;386;Perthes;507;5;512
44;Grand Est;52;2;03;388;Pierremont-sur-Amance;152;2;154
44;Grand Est;52;2;03;390;Pisseloup;59;1;60
44;Grand Est;52;3;17;391;Planrupt;307;9;316
44;Grand Est;52;2;11;392;Plesnoy;116;2;118
44;Grand Est;52;2;16;393;Poinsenot;56;0;56
44;Grand Est;52;2;03;394;Poinson-lès-Fayl;211;9;220
44;Grand Est;52;2;16;395;Poinson-lès-Grancey;56;0;56
44;Grand Est;52;1;11;396;Poinson-lès-Nogent;137;3;140
44;Grand Est;52;2;11;397;Poiseul;68;1;69
44;Grand Est;52;3;12;398;Poissons;622;13;635
44;Grand Est;52;1;04;399;Pont-la-Ville;101;7;108
44;Grand Est;52;2;02;400;Le Châtelet-sur-Meuse;157;0;157
44;Grand Est;52;1;11;401;Poulangy;359;12;371
44;Grand Est;52;2;16;403;Praslay;80;1;81
44;Grand Est;52;2;16;405;Le Montsaugeonnais;1149;19;1168
44;Grand Est;52;2;03;406;Pressigny;199;5;204
44;Grand Est;52;1;12;407;Prez-sous-Lafauche;276;7;283
44;Grand Est;52;3;17;411;Rives Dervoises;1327;40;1367
44;Grand Est;52;3;17;413;Rachecourt-Suzémont;106;2;108
44;Grand Est;52;3;08;414;Rachecourt-sur-Marne;760;11;771
44;Grand Est;52;2;02;415;Rançonnières;120;0;120
44;Grand Est;52;1;02;416;Rangecourt;62;1;63
44;Grand Est;52;1;04;419;Rennepont;127;4;131
44;Grand Est;52;1;01;420;Reynel;129;0;129
44;Grand Est;52;1;05;421;Riaucourt;454;15;469
44;Grand Est;52;1;04;422;Richebourg;259;5;264
44;Grand Est;52;1;01;423;Rimaucourt;652;13;665
44;Grand Est;52;2;03;424;Rivières-le-Bois;69;0;69
44;Grand Est;52;2;16;425;Rivière-les-Fosses;192;2;194
44;Grand Est;52;1;04;426;Rizaucourt-Buchey;130;1;131
44;Grand Est;52;1;01;428;Rochefort-sur-la-Côte;64;1;65
44;Grand Est;52;3;08;429;Roches-sur-Marne;565;11;576
44;Grand Est;52;2;16;431;Rochetaillée;166;2;168
44;Grand Est;52;2;11;432;Rolampont;1398;29;1427
44;Grand Est;52;1;12;433;Romain-sur-Meuse;89;1;90
44;Grand Est;52;3;01;436;Rouécourt;50;1;51
44;Grand Est;52;2;16;437;Rouelles;25;0;25
44;Grand Est;52;2;03;438;Rougeux;108;2;110
44;Grand Est;52;2;16;439;Rouvres-sur-Aube;73;1;74
44;Grand Est;52;3;09;440;Rouvroy-sur-Marne;375;6;381
44;Grand Est;52;3;09;442;Rupt;345;10;355
44;Grand Est;52;3;12;443;Sailly;33;0;33
44;Grand Est;52;1;12;444;Saint-Blin;347;9;356
44;Grand Est;52;2;03;445;Saint-Broingt-le-Bois;68;2;70
44;Grand Est;52;2;16;446;Saint-Broingt-les-Fosses;234;2;236
44;Grand Est;52;2;10;447;Saint-Ciergues;182;2;184
44;Grand Est;52;3;99;448;Saint-Dizier;23085;481;23566
44;Grand Est;52;2;10;449;Saints-Geosmes;1115;31;1146
44;Grand Est;52;2;16;450;Saint-Loup-sur-Aujon;129;4;133
44;Grand Est;52;2;10;452;Saint-Martin-lès-Langres;108;0;108
44;Grand Est;52;2;10;453;Saint-Maurice;130;1;131
44;Grand Est;52;1;12;455;Saint-Thiébault;235;6;241
44;Grand Est;52;3;09;456;Saint-Urbain-Maconcourt;627;17;644
44;Grand Est;52;2;03;457;Saint-Vallier-sur-Marne;172;2;174
44;Grand Est;52;1;11;459;Sarcey;108;2;110
44;Grand Est;52;2;02;461;Sarrey;382;10;392
44;Grand Est;52;3;12;463;Saudron;44;1;45
44;Grand Est;52;2;03;464;Saulles;49;2;51
44;Grand Est;52;2;02;465;Saulxures;129;0;129
44;Grand Est;52;2;03;467;Savigny;58;2;60
44;Grand Est;52;1;12;468;Semilly;110;4;114
44;Grand Est;52;1;07;469;Semoutiers-Montsaon;733;16;749
44;Grand Est;52;2;02;470;Serqueux;368;14;382
44;Grand Est;52;1;01;472;Sexfontaines;142;0;142
44;Grand Est;52;1;01;473;Signéville;91;1;92
44;Grand Est;52;1;04;474;Silvarouvres;34;0;34
44;Grand Est;52;3;08;475;Sommancourt;56;6;62
44;Grand Est;52;1;12;476;Sommerécourt;82;3;85
44;Grand Est;52;3;17;479;Sommevoire;653;16;669
44;Grand Est;52;1;01;480;Soncourt-sur-Marne;351;7;358
44;Grand Est;52;1;12;482;Soulaucourt-sur-Mouzon;97;2;99
44;Grand Est;52;2;03;483;Soyers;68;1;69
44;Grand Est;52;3;09;484;Suzannecourt;361;15;376
44;Grand Est;52;2;16;486;Ternat;62;2;64
44;Grand Est;52;3;17;487;Thilleux;65;3;68
44;Grand Est;52;1;11;488;Thivet;273;2;275
44;Grand Est;52;1;12;489;Thol-lès-Millières;35;1;36
44;Grand Est;52;3;09;490;Thonnance-lès-Joinville;668;20;688
44;Grand Est;52;3;12;491;Thonnance-les-Moulins;116;5;121
44;Grand Est;52;2;03;492;Torcenay;554;12;566
44;Grand Est;52;2;03;493;Tornay;29;0;29
44;Grand Est;52;1;05;494;Treix;216;8;224
44;Grand Est;52;3;09;495;Trémilly;84;1;85
44;Grand Est;52;3;08;497;Troisfontaines-la-Ville;434;10;444
44;Grand Est;52;2;16;499;Vaillant;44;0;44
44;Grand Est;52;3;13;500;Valcourt;620;8;628
44;Grand Est;52;3;08;502;Valleret;66;0;66
44;Grand Est;52;2;03;503;Valleroy;25;0;25
44;Grand Est;52;2;03;504;Varennes-sur-Amance;260;5;265
44;Grand Est;52;1;12;505;Vaudrecourt;34;0;34
44;Grand Est;52;1;04;506;Vaudrémont;92;1;93
44;Grand Est;52;2;16;507;Vauxbons;55;0;55
44;Grand Est;52;3;17;510;Vaux-sur-Blaise;368;10;378
44;Grand Est;52;3;09;511;Vaux-sur-Saint-Urbain;55;2;57
44;Grand Est;52;3;09;512;Vecqueville;510;13;523
44;Grand Est;52;2;03;513;Velles;61;1;62
44;Grand Est;52;1;07;514;Verbiesles;345;11;356
44;Grand Est;52;2;16;515;Verseilles-le-Bas;106;3;109
44;Grand Est;52;2;16;516;Verseilles-le-Haut;50;4;54
44;Grand Est;52;1;12;517;Vesaignes-sous-Lafauche;134;1;135
44;Grand Est;52;1;11;518;Vesaignes-sur-Marne;102;2;104
44;Grand Est;52;2;16;519;Vesvres-sous-Chalancey;46;0;46
44;Grand Est;52;2;02;520;Vicq;153;3;156
44;Grand Est;52;1;01;522;Viéville;336;10;346
44;Grand Est;52;1;01;523;Vignes-la-Côte;68;4;72
44;Grand Est;52;1;01;524;Vignory;228;3;231
44;Grand Est;52;1;04;525;Villars-en-Azois;71;1;72
44;Grand Est;52;2;16;526;Villars-Santenoge;78;1;79
44;Grand Est;52;3;17;528;Ville-en-Blaisois;145;1;146
44;Grand Est;52;2;16;529;Villegusien-le-Lac;980;16;996
44;Grand Est;52;3;13;534;Villiers-en-Lieu;1482;32;1514
44;Grand Est;52;1;06;535;Villiers-le-Sec;722;12;734
44;Grand Est;52;2;16;536;Villiers-lès-Aprey;46;0;46
44;Grand Est;52;1;04;538;Villiers-sur-Suize;265;3;268
44;Grand Est;52;2;03;539;Violot;67;0;67
44;Grand Est;52;2;16;540;Vitry-en-Montagne;21;0;21
44;Grand Est;52;1;11;541;Vitry-lès-Nogent;210;4;214
44;Grand Est;52;2;16;542;Vivey;51;2;53
44;Grand Est;52;3;17;543;Voillecomte;515;10;525
44;Grand Est;52;2;02;544;Voisey;277;2;279
44;Grand Est;52;2;16;545;Voisines;107;2;109
44;Grand Est;52;2;03;546;Voncourt;16;0;16
44;Grand Est;52;1;01;547;Vouécourt;204;9;213
44;Grand Est;52;1;01;548;Vraincourt;91;2;93
44;Grand Est;52;1;12;549;Vroncourt-la-Côte;27;0;27
44;Grand Est;52;3;17;550;Wassy;2780;105;2885
52;Pays de la Loire;53;2;08;001;Ahuillé;1844;59;1903
52;Pays de la Loire;53;3;14;002;Alexain;608;14;622
52;Pays de la Loire;53;3;07;003;Ambrières-les-Vallées;2625;68;2693
52;Pays de la Loire;53;3;05;005;Andouillé;2321;60;2381
52;Pays de la Loire;53;2;02;007;Argentré;2831;74;2905
52;Pays de la Loire;53;3;09;008;Aron;1827;51;1878
52;Pays de la Loire;53;1;15;009;Arquenay;670;14;684
52;Pays de la Loire;53;3;06;010;Assé-le-Bérenger;466;12;478
52;Pays de la Loire;53;1;04;011;Astillé;884;19;903
52;Pays de la Loire;53;1;04;012;Athée;466;24;490
52;Pays de la Loire;53;3;17;013;Averton;558;15;573
52;Pays de la Loire;53;3;05;015;La Baconnière;1941;42;1983
52;Pays de la Loire;53;3;06;016;Bais;1217;17;1234
52;Pays de la Loire;53;1;15;017;Val-du-Maine;959;28;987
52;Pays de la Loire;53;1;04;018;Ballots;1305;32;1337
52;Pays de la Loire;53;1;15;019;Bannes;118;3;121
52;Pays de la Loire;53;3;09;021;La Bazoge-Montpinçon;1020;35;1055
52;Pays de la Loire;53;1;15;022;La Bazouge-de-Chemeré;509;13;522
52;Pays de la Loire;53;3;06;023;La Bazouge-des-Alleux;557;12;569
52;Pays de la Loire;53;1;15;025;Bazougers;1095;11;1106
52;Pays de la Loire;53;2;13;026;Beaulieu-sur-Oudon;535;9;544
52;Pays de la Loire;53;1;15;027;Beaumont-Pied-de-Bœuf;204;3;207
52;Pays de la Loire;53;3;09;028;Belgeard;569;11;580
52;Pays de la Loire;53;1;01;029;Bierné-les-Villages;1254;31;1285
52;Pays de la Loire;53;1;15;030;Le Bignon-du-Maine;320;4;324
52;Pays de la Loire;53;3;05;031;La Bigottière;493;2;495
52;Pays de la Loire;53;1;04;033;La Boissière;115;4;119
52;Pays de la Loire;53;2;02;034;Bonchamp-lès-Laval;6187;194;6381
52;Pays de la Loire;53;1;03;035;Bouchamps-lès-Craon;592;9;601
52;Pays de la Loire;53;1;15;036;Bouère;1062;21;1083
52;Pays de la Loire;53;1;15;037;Bouessay;725;27;752
52;Pays de la Loire;53;3;17;038;Boulay-les-Ifs;139;4;143
52;Pays de la Loire;53;2;13;039;Le Bourgneuf-la-Forêt;1732;33;1765
52;Pays de la Loire;53;2;13;040;Bourgon;628;12;640
52;Pays de la Loire;53;1;04;041;Brains-sur-les-Marches;278;5;283
52;Pays de la Loire;53;3;07;042;Brecé;842;11;853
52;Pays de la Loire;53;3;06;043;Brée;564;11;575
52;Pays de la Loire;53;2;13;045;La Brûlatte;677;19;696
52;Pays de la Loire;53;1;15;046;Le Buret;306;3;309
52;Pays de la Loire;53;3;07;047;Carelles;269;4;273
52;Pays de la Loire;53;3;05;048;Chailland;1144;32;1176
52;Pays de la Loire;53;2;02;049;Châlons-du-Maine;708;8;716
52;Pays de la Loire;53;3;09;051;Champéon;607;8;615
52;Pays de la Loire;53;3;17;052;Champfrémont;285;7;292
52;Pays de la Loire;53;3;06;053;Champgenéteux;500;19;519
52;Pays de la Loire;53;2;16;054;Changé;6313;162;6475
52;Pays de la Loire;53;3;07;055;Chantrigné;600;15;615
52;Pays de la Loire;53;2;02;056;La Chapelle-Anthenaise;967;25;992
52;Pays de la Loire;53;3;09;057;La Chapelle-au-Riboul;506;8;514
52;Pays de la Loire;53;1;04;058;La Chapelle-Craonnaise;328;13;341
52;Pays de la Loire;53;3;15;059;La Chapelle-Rainsouin;416;6;422
52;Pays de la Loire;53;3;09;061;Charchigné;458;6;464
52;Pays de la Loire;53;1;88;062;Château-Gontier-sur-Mayenne;16845;690;17535
52;Pays de la Loire;53;1;01;063;Châtelain;451;15;466
52;Pays de la Loire;53;3;07;064;Châtillon-sur-Colmont;973;25;998
52;Pays de la Loire;53;1;01;066;Chemazé;1386;33;1419
52;Pays de la Loire;53;1;15;067;Chémeré-le-Roi;407;12;419
52;Pays de la Loire;53;1;03;068;Chérancé;150;0;150
52;Pays de la Loire;53;3;17;069;Chevaigné-du-Maine;154;4;158
52;Pays de la Loire;53;3;07;071;Colombiers-du-Plessis;484;23;507
52;Pays de la Loire;53;3;09;072;Commer;1279;28;1307
52;Pays de la Loire;53;1;04;073;Congrier;888;22;910
52;Pays de la Loire;53;3;14;074;Contest;843;36;879
52;Pays de la Loire;53;1;04;075;Cosmes;283;3;286
52;Pays de la Loire;53;1;15;076;Cossé-en-Champagne;323;10;333
52;Pays de la Loire;53;1;04;077;Cossé-le-Vivien;3229;73;3302
52;Pays de la Loire;53;1;01;078;Coudray;860;18;878
52;Pays de la Loire;53;3;07;079;Couesmes-Vaucé;378;8;386
52;Pays de la Loire;53;3;17;080;Couptrain;135;1;136
52;Pays de la Loire;53;1;04;082;Courbeveille;638;13;651
52;Pays de la Loire;53;3;17;083;Courcité;828;28;856
52;Pays de la Loire;53;1;03;084;Craon;4456;155;4611
52;Pays de la Loire;53;3;17;085;Crennes-sur-Fraubée;195;2;197
52;Pays de la Loire;53;3;05;086;La Croixille;635;13;648
52;Pays de la Loire;53;1;15;087;La Cropte;208;5;213
52;Pays de la Loire;53;1;04;088;Cuillé;827;28;855
52;Pays de la Loire;53;1;01;089;Daon;513;5;518
52;Pays de la Loire;53;1;03;090;Denazé;164;5;169
52;Pays de la Loire;53;3;07;091;Désertines;447;15;462
52;Pays de la Loire;53;3;07;093;La Dorée;278;1;279
52;Pays de la Loire;53;2;08;094;Entrammes;2251;40;2291
52;Pays de la Loire;53;3;05;096;Ernée;5641;105;5746
52;Pays de la Loire;53;3;06;097;Évron;8667;229;8896
52;Pays de la Loire;53;1;04;098;Fontaine-Couverte;427;9;436
52;Pays de la Loire;53;2;08;099;Forcé;1089;33;1122
52;Pays de la Loire;53;3;07;100;Fougerolles-du-Plessis;1167;14;1181
52;Pays de la Loire;53;1;01;101;Fromentières;835;11;846
52;Pays de la Loire;53;1;04;102;Gastines;167;1;168
52;Pays de la Loire;53;2;13;103;Le Genest-Saint-Isle;2122;59;2181
52;Pays de la Loire;53;1;01;104;Gennes-Longuefuye;1337;29;1366
52;Pays de la Loire;53;3;02;105;Gesnes;230;6;236
52;Pays de la Loire;53;3;17;106;Gesvres;518;12;530
52;Pays de la Loire;53;3;07;107;Gorron;2543;53;2596
52;Pays de la Loire;53;2;13;108;La Gravelle;571;6;577
52;Pays de la Loire;53;3;09;109;Grazay;621;17;638
52;Pays de la Loire;53;1;15;110;Grez-en-Bouère;990;19;1009
52;Pays de la Loire;53;3;09;111;La Haie-Traversaine;463;14;477
52;Pays de la Loire;53;3;17;112;Le Ham;376;10;386
52;Pays de la Loire;53;3;06;113;Hambers;616;11;627
52;Pays de la Loire;53;3;09;114;Hardanges;193;2;195
52;Pays de la Loire;53;3;07;115;Hercé;312;10;322
52;Pays de la Loire;53;3;09;116;Le Horps;720;17;737
52;Pays de la Loire;53;1;01;117;Houssay;502;5;507
52;Pays de la Loire;53;3;09;118;Le Housseau-Brétignolles;229;2;231
52;Pays de la Loire;53;2;08;119;L'Huisserie;4415;160;4575
52;Pays de la Loire;53;3;06;120;Izé;456;10;466
52;Pays de la Loire;53;3;17;121;Javron-les-Chapelles;1375;29;1404
52;Pays de la Loire;53;3;09;122;Jublains;758;16;774
52;Pays de la Loire;53;3;05;123;Juvigné;1421;25;1446
52;Pays de la Loire;53;1;03;124;Prée-d'Anjou;1389;43;1432
52;Pays de la Loire;53;3;07;125;Landivy;1137;27;1164
52;Pays de la Loire;53;3;05;126;Larchamp;1080;23;1103
52;Pays de la Loire;53;3;09;127;Lassay-les-Châteaux;2239;57;2296
52;Pays de la Loire;53;1;04;128;Laubrières;349;11;360
52;Pays de la Loire;53;2;13;129;Launay-Villiers;375;10;385
52;Pays de la Loire;53;2;99;130;Laval;49617;2552;52169
52;Pays de la Loire;53;3;07;131;Lesbois;194;2;196
52;Pays de la Loire;53;3;07;132;Levaré;283;11;294
52;Pays de la Loire;53;3;17;133;Lignières-Orgères;710;17;727
52;Pays de la Loire;53;3;06;134;Livet;179;1;180
52;Pays de la Loire;53;1;04;135;Livré-la-Touche;731;23;754
52;Pays de la Loire;53;1;01;136;La Roche-Neuville;1201;39;1240
52;Pays de la Loire;53;2;13;137;Loiron-Ruillé;2740;52;2792
52;Pays de la Loire;53;3;17;139;Loupfougères;411;8;419
52;Pays de la Loire;53;2;02;140;Louverné;4365;116;4481
52;Pays de la Loire;53;2;08;141;Louvigné;1152;32;1184
52;Pays de la Loire;53;3;17;142;Madré;291;5;296
52;Pays de la Loire;53;1;15;143;Maisoncelles-du-Maine;514;13;527
52;Pays de la Loire;53;3;09;144;Marcillé-la-Ville;755;25;780
52;Pays de la Loire;53;1;03;145;Marigné-Peuton;544;14;558
52;Pays de la Loire;53;3;09;146;Martigné-sur-Mayenne;1902;36;1938
52;Pays de la Loire;53;3;14;147;Mayenne;12805;690;13495
52;Pays de la Loire;53;1;03;148;Mée;237;1;238
52;Pays de la Loire;53;1;01;150;Ménil;894;29;923
52;Pays de la Loire;53;1;04;151;Méral;1120;16;1136
52;Pays de la Loire;53;1;15;152;Meslay-du-Maine;2788;74;2862
52;Pays de la Loire;53;3;06;153;Mézangers;629;11;640
52;Pays de la Loire;53;3;07;154;Montaudin;903;21;924
52;Pays de la Loire;53;3;05;155;Montenay;1347;23;1370
52;Pays de la Loire;53;2;02;156;Montflours;252;7;259
52;Pays de la Loire;53;2;08;157;Montigné-le-Brillant;1337;55;1392
52;Pays de la Loire;53;2;13;158;Montjean;1036;13;1049
52;Pays de la Loire;53;3;09;160;Montreuil-Poulay;375;7;382
52;Pays de la Loire;53;3;06;161;Montsûrs;3191;59;3250
52;Pays de la Loire;53;3;09;162;Moulay;986;18;1004
52;Pays de la Loire;53;3;06;163;Neau;779;4;783
52;Pays de la Loire;53;3;17;164;Neuilly-le-Vendin;345;8;353
52;Pays de la Loire;53;1;03;165;Niafles;353;7;360
52;Pays de la Loire;53;2;08;168;Nuillé-sur-Vicoin;1220;26;1246
52;Pays de la Loire;53;2;13;169;Olivet;412;9;421
52;Pays de la Loire;53;3;07;170;Oisseau;1151;22;1173
52;Pays de la Loire;53;1;01;172;Origné;402;8;410
52;Pays de la Loire;53;3;17;173;La Pallu;180;6;186
52;Pays de la Loire;53;3;14;174;Parigné-sur-Braye;836;24;860
52;Pays de la Loire;53;2;08;175;Parné-sur-Roc;1383;48;1431
52;Pays de la Loire;53;3;07;176;Le Pas;539;8;547
52;Pays de la Loire;53;3;05;177;La Pellerine;302;6;308
52;Pays de la Loire;53;1;03;178;Peuton;231;10;241
52;Pays de la Loire;53;3;14;179;Placé;352;5;357
52;Pays de la Loire;53;1;03;180;Pommerieux;642;24;666
52;Pays de la Loire;53;3;07;181;Pontmain;806;10;816
52;Pays de la Loire;53;2;13;182;Port-Brillet;1795;28;1823
52;Pays de la Loire;53;1;15;184;Préaux;163;5;168
52;Pays de la Loire;53;3;17;185;Pré-en-Pail-Saint-Samson;2295;84;2379
52;Pays de la Loire;53;1;04;186;Quelaines-Saint-Gault;2131;61;2192
52;Pays de la Loire;53;3;17;187;Ravigny;228;13;241
52;Pays de la Loire;53;1;04;188;Renazé;2521;59;2580
52;Pays de la Loire;53;3;09;189;Rennes-en-Grenouilles;106;0;106
52;Pays de la Loire;53;3;09;190;Le Ribay;468;10;478
52;Pays de la Loire;53;1;04;191;La Roë;251;2;253
52;Pays de la Loire;53;1;04;192;La Rouaudière;315;5;320
52;Pays de la Loire;53;1;15;193;Ruillé-Froid-Fonds;565;11;576
52;Pays de la Loire;53;3;02;195;Sacé;509;10;519
52;Pays de la Loire;53;3;17;196;Saint-Aignan-de-Couptrain;351;12;363
52;Pays de la Loire;53;1;04;197;Saint-Aignan-sur-Roë;903;23;926
52;Pays de la Loire;53;3;17;198;Saint-Aubin-du-Désert;227;7;234
52;Pays de la Loire;53;3;07;199;Saint-Aubin-Fosse-Louvain;216;4;220
52;Pays de la Loire;53;3;14;200;Saint-Baudelle;1159;57;1216
52;Pays de la Loire;53;2;16;201;Saint-Berthevin;7381;259;7640
52;Pays de la Loire;53;3;07;202;Saint-Berthevin-la-Tannière;303;4;307
52;Pays de la Loire;53;1;15;203;Saint-Brice;526;13;539
52;Pays de la Loire;53;3;17;204;Saint-Calais-du-Désert;388;12;400
52;Pays de la Loire;53;1;15;206;Saint-Charles-la-Forêt;196;10;206
52;Pays de la Loire;53;3;17;208;Saint-Cyr-en-Pail;497;14;511
52;Pays de la Loire;53;2;13;209;Saint-Cyr-le-Gravelais;557;14;571
52;Pays de la Loire;53;1;01;210;Saint-Denis-d'Anjou;1545;30;1575
52;Pays de la Loire;53;3;05;211;Saint-Denis-de-Gastines;1429;32;1461
52;Pays de la Loire;53;1;15;212;Saint-Denis-du-Maine;437;8;445
52;Pays de la Loire;53;3;07;213;Saint-Ellier-du-Maine;490;9;499
52;Pays de la Loire;53;1;04;214;Saint-Erblon;163;4;167
52;Pays de la Loire;53;3;09;216;Saint-Fraimbault-de-Prières;987;25;1012
52;Pays de la Loire;53;3;06;218;Sainte-Gemmes-le-Robert;791;25;816
52;Pays de la Loire;53;3;14;219;Saint-Georges-Buttavent;1396;38;1434
52;Pays de la Loire;53;3;15;220;Saint-Georges-le-Fléchard;380;8;388
52;Pays de la Loire;53;3;06;221;Saint-Georges-sur-Erve;396;9;405
52;Pays de la Loire;53;3;14;222;Saint-Germain-d'Anxure;365;8;373
52;Pays de la Loire;53;3;17;223;Saint-Germain-de-Coulamer;328;9;337
52;Pays de la Loire;53;2;16;224;Saint-Germain-le-Fouilloux;1186;31;1217
52;Pays de la Loire;53;3;05;225;Saint-Germain-le-Guillaume;517;9;526
52;Pays de la Loire;53;3;05;226;Saint-Hilaire-du-Maine;817;31;848
52;Pays de la Loire;53;3;15;228;Blandouet-Saint Jean;561;13;574
52;Pays de la Loire;53;2;16;229;Saint-Jean-sur-Mayenne;1650;47;1697
52;Pays de la Loire;53;3;09;230;Saint-Julien-du-Terroux;235;6;241
52;Pays de la Loire;53;3;15;232;Saint-Léger;312;3;315
52;Pays de la Loire;53;1;15;233;Saint-Loup-du-Dorat;339;2;341
52;Pays de la Loire;53;3;07;234;Saint-Loup-du-Gast;353;8;361
52;Pays de la Loire;53;3;09;235;Sainte-Marie-du-Bois;228;4;232
52;Pays de la Loire;53;3;17;236;Saint-Mars-du-Désert;170;1;171
52;Pays de la Loire;53;3;07;237;Saint-Mars-sur-Colmont;452;12;464
52;Pays de la Loire;53;3;07;238;Saint-Mars-sur-la-Futaie;519;9;528
52;Pays de la Loire;53;1;04;240;Saint-Martin-du-Limet;434;6;440
52;Pays de la Loire;53;1;04;242;Saint-Michel-de-la-Roë;258;3;261
52;Pays de la Loire;53;2;13;243;Saint-Ouën-des-Toits;1782;39;1821
52;Pays de la Loire;53;3;05;245;Saint-Pierre-des-Landes;923;23;946
52;Pays de la Loire;53;3;17;246;Saint-Pierre-des-Nids;1785;35;1820
52;Pays de la Loire;53;2;13;247;Saint-Pierre-la-Cour;2298;48;2346
52;Pays de la Loire;53;3;15;248;Saint-Pierre-sur-Erve;140;3;143
52;Pays de la Loire;53;3;06;249;Vimartin-sur-Orthe;1120;13;1133
52;Pays de la Loire;53;1;04;250;Saint-Poix;407;5;412
52;Pays de la Loire;53;1;03;251;Saint-Quentin-les-Anges;466;8;474
52;Pays de la Loire;53;1;04;253;Saint-Saturnin-du-Limet;519;4;523
52;Pays de la Loire;53;3;15;255;Sainte-Suzanne-et-Chammes;1251;16;1267
52;Pays de la Loire;53;3;06;256;Saint-Thomas-de-Courceriers;169;4;173
52;Pays de la Loire;53;3;15;257;Saulges;316;8;324
52;Pays de la Loire;53;1;04;258;La Selle-Craonnaise;908;27;935
52;Pays de la Loire;53;1;04;259;Senonnes;345;7;352
52;Pays de la Loire;53;1;04;260;Simplé;397;1;398
52;Pays de la Loire;53;3;07;261;Soucé;168;3;171
52;Pays de la Loire;53;2;08;262;Soulgé-sur-Ouette;1093;31;1124
52;Pays de la Loire;53;3;09;263;Thubœuf;274;8;282
52;Pays de la Loire;53;3;15;264;Thorigné-en-Charnie;191;3;194
52;Pays de la Loire;53;3;15;265;Torcé-Viviers-en-Charnie;767;15;782
52;Pays de la Loire;53;3;06;266;Trans;226;4;230
52;Pays de la Loire;53;3;15;267;Vaiges;1165;32;1197
52;Pays de la Loire;53;3;05;269;Vautorte;613;5;618
52;Pays de la Loire;53;3;07;270;Vieuvy;108;9;117
52;Pays de la Loire;53;3;17;271;Villaines-la-Juhel;2713;42;2755
52;Pays de la Loire;53;3;17;272;Villepail;188;1;189
52;Pays de la Loire;53;1;15;273;Villiers-Charlemagne;1083;22;1105
52;Pays de la Loire;53;3;06;276;Voutré;930;16;946
44;Grand Est;54;3;02;001;Abaucourt;306;5;311
44;Grand Est;54;1;17;002;Abbéville-lès-Conflans;229;4;233
44;Grand Est;54;4;10;003;Aboncourt;92;5;97
44;Grand Est;54;1;17;004;Affléville;178;2;180
44;Grand Est;54;3;10;005;Affracourt;110;1;111
44;Grand Est;54;3;03;006;Agincourt;445;7;452
44;Grand Est;54;4;16;007;Aingeray;531;4;535
44;Grand Est;54;4;10;008;Allain;470;13;483
44;Grand Est;54;1;04;009;Allamont;166;3;169
44;Grand Est;54;4;10;010;Allamps;500;12;512
44;Grand Est;54;1;11;011;Allondrelle-la-Malmaison;647;10;657
44;Grand Est;54;3;03;012;Amance;354;5;359
44;Grand Est;54;2;01;013;Amenoncourt;86;2;88
44;Grand Est;54;2;01;014;Ancerviller;255;14;269
44;Grand Est;54;1;17;015;Anderny;258;6;264
44;Grand Est;54;4;16;016;Andilly;287;8;295
44;Grand Est;54;2;01;017;Angomont;75;1;76
44;Grand Est;54;1;17;018;Anoux;273;7;280
44;Grand Est;54;4;16;019;Ansauville;78;1;79
44;Grand Est;54;2;08;020;Anthelupt;447;8;455
44;Grand Est;54;3;02;021;Armaucourt;233;1;234
44;Grand Est;54;4;18;022;Arnaville;563;11;574
44;Grand Est;54;2;01;023;Arracourt;248;2;250
44;Grand Est;54;3;02;024;Arraye-et-Han;363;6;369
44;Grand Est;54;3;03;025;Art-sur-Meurthe;1620;208;1828
44;Grand Est;54;2;01;026;Athienville;176;3;179
44;Grand Est;54;3;18;027;Atton;878;13;891
44;Grand Est;54;1;04;028;Auboué;2669;19;2688
44;Grand Est;54;1;17;029;Audun-le-Roman;2465;47;2512
44;Grand Est;54;2;01;030;Autrepierre;81;0;81
44;Grand Est;54;3;02;031;Autreville-sur-Moselle;260;4;264
44;Grand Est;54;3;10;032;Autrey;188;4;192
44;Grand Est;54;1;17;033;Avillers;134;0;134
44;Grand Est;54;4;16;034;Avrainville;215;4;219
44;Grand Est;54;2;01;035;Avricourt;388;4;392
44;Grand Est;54;1;17;036;Avril;1174;29;1203
44;Grand Est;54;3;05;037;Azelot;424;4;428
44;Grand Est;54;2;01;038;Azerailles;750;18;768
44;Grand Est;54;2;01;039;Baccarat;4160;61;4221
44;Grand Est;54;2;01;040;Badonviller;1559;32;1591
44;Grand Est;54;4;10;041;Bagneux;138;7;145
44;Grand Est;54;3;10;042;Bainville-aux-Miroirs;279;2;281
44;Grand Est;54;3;15;043;Bainville-sur-Madon;1442;17;1459
44;Grand Est;54;2;01;044;Barbas;197;2;199
44;Grand Est;54;2;09;045;Barbonville;427;8;435
44;Grand Est;54;4;10;046;Barisey-au-Plain;394;7;401
44;Grand Est;54;4;10;047;Barisey-la-Côte;260;5;265
44;Grand Est;54;1;17;048;Les Baroches;344;3;347
44;Grand Est;54;1;11;049;Baslieux;529;14;543
44;Grand Est;54;2;01;050;Bathelémont;66;0;66
44;Grand Est;54;1;04;051;Batilly;1284;28;1312
44;Grand Est;54;4;10;052;Battigny;149;2;151
44;Grand Est;54;2;08;053;Bauzemont;156;6;162
44;Grand Est;54;2;09;054;Bayon;1530;18;1548
44;Grand Est;54;4;18;055;Bayonville-sur-Mad;330;4;334
44;Grand Est;54;1;11;056;Bazailles;144;3;147
44;Grand Est;54;4;16;057;Beaumont;73;1;74
44;Grand Est;54;1;17;058;Béchamps;87;0;87
44;Grand Est;54;3;02;059;Belleau;752;10;762
44;Grand Est;54;3;02;060;Belleville;1484;19;1503
44;Grand Est;54;2;01;061;Bénaménil;586;10;596
44;Grand Est;54;3;10;062;Benney;652;10;662
44;Grand Est;54;4;16;063;Bernécourt;174;4;178
44;Grand Est;54;2;01;064;Bertrambois;318;5;323
44;Grand Est;54;2;01;065;Bertrichamps;1086;19;1105
44;Grand Est;54;1;17;066;Bettainvillers;410;2;412
44;Grand Est;54;1;11;067;Beuveille;765;17;782
44;Grand Est;54;4;10;068;Beuvezin;92;3;95
44;Grand Est;54;1;17;069;Beuvillers;471;9;480
44;Grand Est;54;3;02;070;Bey-sur-Seille;179;0;179
44;Grand Est;54;2;01;071;Bezange-la-Grande;161;1;162
44;Grand Est;54;3;02;072;Bezaumont;262;5;267
44;Grand Est;54;4;20;073;Bicqueley;923;16;939
44;Grand Est;54;2;08;074;Bienville-la-Petite;37;0;37
44;Grand Est;54;2;01;075;Bionville;119;2;121
44;Grand Est;54;2;09;076;Blainville-sur-l'Eau;3944;47;3991
44;Grand Est;54;2;01;077;Blâmont;1053;12;1065
44;Grand Est;54;2;01;078;Blémerey;56;1;57
44;Grand Est;54;3;18;079;Blénod-lès-Pont-à-Mousson;4642;27;4669
44;Grand Est;54;4;10;080;Blénod-lès-Toul;1031;17;1048
44;Grand Est;54;1;11;081;Boismont;419;6;425
44;Grand Est;54;1;04;082;Boncourt;169;3;172
44;Grand Est;54;2;08;083;Bonviller;175;3;178
44;Grand Est;54;1;17;084;Mont-Bonvillers;943;15;958
44;Grand Est;54;2;09;085;Borville;88;2;90
44;Grand Est;54;4;16;086;Boucq;354;10;364
44;Grand Est;54;4;16;087;Bouillonville;149;0;149
44;Grand Est;54;4;16;088;Bouvron;242;2;244
44;Grand Est;54;3;03;089;Bouxières-aux-Chênes;1406;20;1426
44;Grand Est;54;3;02;090;Bouxières-aux-Dames;4147;43;4190
44;Grand Est;54;3;18;091;Bouxières-sous-Froidmont;400;4;404
44;Grand Est;54;3;10;092;Bouzanville;65;1;66
44;Grand Est;54;1;04;093;Brainville;170;2;172
44;Grand Est;54;3;10;094;Bralleville;171;3;174
44;Grand Est;54;3;02;095;Bratte;46;0;46
44;Grand Est;54;1;23;096;Bréhain-la-Ville;438;9;447
44;Grand Est;54;2;01;097;Bréménil;98;3;101
44;Grand Est;54;2;09;098;Brémoncourt;167;3;170
44;Grand Est;54;1;17;099;Val de Briey;8041;228;8269
44;Grand Est;54;3;02;100;Brin-sur-Seille;776;12;788
44;Grand Est;54;2;01;101;Brouville;128;1;129
44;Grand Est;54;4;16;102;Bruley;609;16;625
44;Grand Est;54;1;04;103;Bruville;222;2;224
44;Grand Est;54;3;03;104;Buissoncourt;257;2;259
44;Grand Est;54;4;10;105;Bulligny;525;15;540
44;Grand Est;54;2;01;106;Bures;63;1;64
44;Grand Est;54;2;01;107;Buriville;74;4;78
44;Grand Est;54;3;05;108;Burthecourt-aux-Chênes;144;6;150
44;Grand Est;54;3;10;109;Ceintrey;931;13;944
44;Grand Est;54;3;03;110;Cerville;560;12;572
44;Grand Est;54;3;15;111;Chaligny;2803;18;2821
44;Grand Est;54;1;04;112;Chambley-Bussières;718;8;726
44;Grand Est;54;3;03;113;Champenoux;1528;16;1544
44;Grand Est;54;3;18;114;Champey-sur-Moselle;326;5;331
44;Grand Est;54;3;21;115;Champigneulles;6633;60;6693
44;Grand Est;54;2;09;116;Chanteheux;2148;39;2187
44;Grand Est;54;3;10;117;Chaouilley;116;3;119
44;Grand Est;54;1;11;118;Charency-Vezin;605;10;615
44;Grand Est;54;4;16;119;Charey;89;2;91
44;Grand Est;54;4;20;120;Charmes-la-Côte;328;7;335
44;Grand Est;54;2;09;121;Charmois;190;3;193
44;Grand Est;54;4;20;122;Chaudeney-sur-Moselle;726;17;743
44;Grand Est;54;3;15;123;Chavigny;1719;12;1731
44;Grand Est;54;2;01;124;Chazelles-sur-Albe;46;3;49
44;Grand Est;54;2;01;125;Chenevières;489;7;496
44;Grand Est;54;3;02;126;Chenicourt;223;1;224
44;Grand Est;54;1;07;127;Chenières;621;21;642
44;Grand Est;54;4;20;128;Choloy-Ménillot;708;8;716
44;Grand Est;54;2;01;129;Cirey-sur-Vezouze;1600;25;1625
44;Grand Est;54;2;09;130;Clayeures;179;1;180
44;Grand Est;54;3;02;131;Clémery;496;10;506
44;Grand Est;54;3;10;132;Clérey-sur-Brenon;59;1;60
44;Grand Est;54;2;01;133;Coincourt;117;4;121
44;Grand Est;54;1;11;134;Colmey;242;7;249
44;Grand Est;54;4;10;135;Colombey-les-Belles;1443;20;1463
44;Grand Est;54;1;04;136;Conflans-en-Jarnisy;2377;33;2410
44;Grand Est;54;1;11;137;Cons-la-Grandville;513;15;528
44;Grand Est;54;1;11;138;Cosnes-et-Romain;2773;56;2829
44;Grand Est;54;2;08;139;Courbesseaux;373;5;378
44;Grand Est;54;4;10;140;Courcelles;92;0;92
44;Grand Est;54;3;05;141;Coyviller;153;2;155
44;Grand Est;54;3;10;142;Crantenoy;154;3;157
44;Grand Est;54;4;10;143;Crépey;385;6;391
44;Grand Est;54;3;10;144;Crévéchamps;382;6;388
44;Grand Est;54;2;08;145;Crévic;939;12;951
44;Grand Est;54;4;10;146;Crézilles;292;3;295
44;Grand Est;54;2;08;147;Crion;108;2;110
44;Grand Est;54;2;08;148;Croismare;645;9;654
44;Grand Est;54;1;23;149;Crusnes;1565;23;1588
44;Grand Est;54;3;02;150;Custines;3106;30;3136
44;Grand Est;54;1;07;151;Cutry;1051;28;1079
44;Grand Est;54;2;09;152;Damelevières;3124;41;3165
44;Grand Est;54;1;04;153;Dampvitoux;56;2;58
44;Grand Est;54;2;01;154;Deneuvre;476;21;497
44;Grand Est;54;2;08;155;Deuxville;402;8;410
44;Grand Est;54;3;10;156;Diarville;484;16;500
44;Grand Est;54;3;02;157;Dieulouard;4712;38;4750
44;Grand Est;54;4;10;158;Dolcourt;141;2;143
44;Grand Est;54;3;08;159;Dombasle-sur-Meurthe;9733;190;9923
44;Grand Est;54;4;16;160;Domèvre-en-Haye;404;8;412
44;Grand Est;54;2;01;161;Domèvre-sur-Vezouze;314;10;324
44;Grand Est;54;4;20;162;Domgermain;1158;17;1175
44;Grand Est;54;2;01;163;Domjevin;260;1;261
44;Grand Est;54;3;10;164;Dommarie-Eulmont;88;2;90
44;Grand Est;54;3;19;165;Dommartemont;572;11;583
44;Grand Est;54;4;16;166;Dommartin-la-Chaussée;30;2;32
44;Grand Est;54;4;20;167;Dommartin-lès-Toul;1943;43;1986
44;Grand Est;54;3;03;168;Dommartin-sous-Amance;302;2;304
44;Grand Est;54;1;17;169;Domprix;97;3;100
44;Grand Est;54;2;09;170;Domptail-en-l'Air;72;1;73
44;Grand Est;54;1;04;171;Doncourt-lès-Conflans;1141;20;1161
44;Grand Est;54;1;11;172;Doncourt-lès-Longuyon;288;6;294
44;Grand Est;54;2;08;173;Drouville;218;4;222
44;Grand Est;54;4;20;174;Écrouves;4454;58;4512
44;Grand Est;54;2;09;175;Einvaux;373;3;376
44;Grand Est;54;2;08;176;Einville-au-Jard;1098;24;1122
44;Grand Est;54;2;01;177;Emberménil;254;3;257
44;Grand Est;54;1;11;178;Épiez-sur-Chiers;198;3;201
44;Grand Est;54;3;02;179;Éply;303;4;307
44;Grand Est;54;3;03;180;Erbéviller-sur-Amezule;70;2;72
44;Grand Est;54;1;23;181;Errouville;690;17;707
44;Grand Est;54;4;16;182;Essey-et-Maizerais;324;11;335
44;Grand Est;54;2;09;183;Essey-la-Côte;74;0;74
44;Grand Est;54;3;19;184;Essey-lès-Nancy;8841;196;9037
44;Grand Est;54;3;10;185;Étreval;59;1;60
44;Grand Est;54;3;03;186;Eulmont;1109;21;1130
44;Grand Est;54;4;16;187;Euvezin;111;0;111
44;Grand Est;54;3;02;188;Faulx;1365;10;1375
44;Grand Est;54;4;10;189;Favières;600;7;607
44;Grand Est;54;4;10;190;Fécocourt;111;3;114
44;Grand Est;54;2;01;191;Fenneviller;102;2;104
44;Grand Est;54;3;09;192;Ferrières;313;4;317
44;Grand Est;54;3;18;193;Fey-en-Haye;71;2;73
44;Grand Est;54;1;23;194;Fillières;510;9;519
44;Grand Est;54;2;08;195;Flainval;189;4;193
44;Grand Est;54;3;15;196;Flavigny-sur-Moselle;1724;108;1832
44;Grand Est;54;3;05;197;Fléville-devant-Nancy;2205;21;2226
44;Grand Est;54;1;17;198;Fléville-Lixières;303;4;307
44;Grand Est;54;2;01;199;Flin;384;10;394
44;Grand Est;54;4;16;200;Flirey;160;1;161
44;Grand Est;54;2;01;201;Fontenoy-la-Joûte;306;3;309
44;Grand Est;54;4;16;202;Fontenoy-sur-Moselle;373;10;383
44;Grand Est;54;3;10;203;Forcelles-Saint-Gorgon;140;3;143
44;Grand Est;54;3;10;204;Forcelles-sous-Gugney;92;2;94
44;Grand Est;54;4;20;205;Foug;2619;29;2648
44;Grand Est;54;2;09;206;Fraimbois;394;5;399
44;Grand Est;54;3;10;207;Fraisnes-en-Saintois;95;6;101
44;Grand Est;54;4;16;208;Francheville;289;5;294
44;Grand Est;54;2;09;209;Franconville;64;0;64
44;Grand Est;54;2;01;210;Fréménil;215;2;217
44;Grand Est;54;2;01;211;Frémonville;196;3;199
44;Grand Est;54;1;11;212;Fresnois-la-Montagne;411;13;424
44;Grand Est;54;1;04;213;Friauville;371;5;376
44;Grand Est;54;3;15;214;Frolois;705;9;714
44;Grand Est;54;3;21;215;Frouard;6543;67;6610
44;Grand Est;54;2;09;216;Froville;124;0;124
44;Grand Est;54;2;01;217;Gélacourt;170;2;172
44;Grand Est;54;4;10;218;Gélaucourt;53;1;54
44;Grand Est;54;3;03;219;Gellenoncourt;82;0;82
44;Grand Est;54;4;10;220;Gémonville;77;0;77
44;Grand Est;54;3;10;221;Gerbécourt-et-Haplemont;230;1;231
44;Grand Est;54;2;09;222;Gerbéviller;1330;23;1353
44;Grand Est;54;4;10;223;Germiny;208;1;209
44;Grand Est;54;3;10;224;Germonville;123;1;124
44;Grand Est;54;4;16;225;Gézoncourt;180;3;183
44;Grand Est;54;4;10;226;Gibeaumeix;172;2;174
44;Grand Est;54;1;04;227;Giraumont;1349;16;1365
44;Grand Est;54;2;09;228;Giriviller;70;3;73
44;Grand Est;54;2;01;229;Glonville;367;6;373
44;Grand Est;54;2;01;230;Gogney;52;0;52
44;Grand Est;54;1;17;231;Gondrecourt-Aix;179;3;182
44;Grand Est;54;4;16;232;Gondreville;2672;50;2722
44;Grand Est;54;2;01;233;Gondrexon;34;2;36
44;Grand Est;54;1;11;234;Gorcy;2907;43;2950
44;Grand Est;54;3;10;235;Goviller;420;9;429
44;Grand Est;54;1;11;236;Grand-Failly;360;8;368
44;Grand Est;54;4;10;237;Grimonviller;95;1;96
44;Grand Est;54;3;10;238;Gripport;268;1;269
44;Grand Est;54;4;16;239;Griscourt;141;1;142
44;Grand Est;54;4;16;240;Grosrouvres;54;0;54
44;Grand Est;54;3;10;241;Gugney;75;3;78
44;Grand Est;54;4;20;242;Gye;274;3;277
44;Grand Est;54;2;01;243;Hablainville;217;7;224
44;Grand Est;54;1;04;244;Hagéville;110;3;113
44;Grand Est;54;2;09;245;Haigneville;62;0;62
44;Grand Est;54;2;01;246;Halloville;65;6;71
44;Grand Est;54;3;10;247;Hammeville;178;4;182
44;Grand Est;54;4;16;248;Hamonville;100;0;100
44;Grand Est;54;1;04;249;Hannonville-Suzémont;253;3;256
44;Grand Est;54;3;03;250;Haraucourt;736;6;742
44;Grand Est;54;2;01;251;Harbouey;129;1;130
44;Grand Est;54;3;10;252;Haroué;507;6;513
44;Grand Est;54;1;04;253;Hatrize;775;12;787
44;Grand Est;54;1;07;254;Haucourt-Moulaine;3416;42;3458
44;Grand Est;54;2;09;255;Haudonville;83;6;89
44;Grand Est;54;2;09;256;Haussonville;307;8;315
44;Grand Est;54;3;05;257;Heillecourt;5346;82;5428
44;Grand Est;54;2;08;258;Hénaménil;146;2;148
44;Grand Est;54;2;01;259;Herbéviller;231;3;234
44;Grand Est;54;2;09;260;Hériménil;937;15;952
44;Grand Est;54;1;07;261;Herserange;4330;56;4386
44;Grand Est;54;2;08;262;Hoéville;196;0;196
44;Grand Est;54;1;04;263;Homécourt;6245;57;6302
44;Grand Est;54;3;10;264;Houdelmont;320;0;320
44;Grand Est;54;3;05;265;Houdemont;2091;40;2131
44;Grand Est;54;3;10;266;Houdreville;404;10;414
44;Grand Est;54;3;10;268;Housséville;138;4;142
44;Grand Est;54;2;08;269;Hudiviller;345;7;352
44;Grand Est;54;1;23;270;Hussigny-Godbrange;3860;65;3925
44;Grand Est;54;2;01;271;Igney;121;6;127
44;Grand Est;54;4;16;272;Jaillon;464;3;467
44;Grand Est;54;1;04;273;Jarny;8190;179;8369
44;Grand Est;54;3;05;274;Jarville-la-Malgrange;9396;224;9620
44;Grand Est;54;4;16;275;Jaulny;184;6;190
44;Grand Est;54;3;02;276;Jeandelaincourt;787;7;794
44;Grand Est;54;1;04;277;Jeandelize;372;2;374
44;Grand Est;54;3;10;278;Jevoncourt;101;1;102
44;Grand Est;54;3;18;279;Jezainville;990;20;1010
44;Grand Est;54;1;17;280;Jœuf;6583;53;6636
44;Grand Est;54;2;08;281;Jolivet;894;16;910
44;Grand Est;54;1;17;282;Joppécourt;161;4;165
44;Grand Est;54;1;04;283;Jouaville;286;6;292
44;Grand Est;54;1;17;284;Joudreville;1121;21;1142
44;Grand Est;54;2;01;285;Juvrecourt;55;1;56
44;Grand Est;54;1;04;286;Labry;1580;32;1612
44;Grand Est;54;2;01;287;Lachapelle;268;1;269
44;Grand Est;54;4;16;288;Lagney;495;4;499
44;Grand Est;54;3;03;289;Laître-sous-Amance;362;10;372
44;Grand Est;54;1;23;290;Laix;210;4;214
44;Grand Est;54;3;10;291;Lalœuf;294;2;296
44;Grand Est;54;2;09;292;Lamath;184;3;187
44;Grand Est;54;2;09;293;Landécourt;84;4;88
44;Grand Est;54;3;02;294;Landremont;144;2;146
44;Grand Est;54;1;17;295;Landres;971;110;1081
44;Grand Est;54;3;03;296;Laneuvelotte;432;3;435
44;Grand Est;54;2;01;297;Laneuveville-aux-Bois;304;3;307
44;Grand Est;54;4;20;298;Laneuveville-derrière-Foug;155;1;156
44;Grand Est;54;3;10;299;Laneuveville-devant-Bayon;227;6;233
44;Grand Est;54;3;03;300;Laneuveville-devant-Nancy;6548;109;6657
44;Grand Est;54;3;02;301;Lanfroicourt;127;1;128
44;Grand Est;54;1;17;302;Lantéfontaine;737;17;754
44;Grand Est;54;2;01;303;Laronxe;366;3;369
44;Grand Est;54;3;06;304;Laxou;14445;186;14631
44;Grand Est;54;3;02;305;Lay-Saint-Christophe;2380;48;2428
44;Grand Est;54;4;20;306;Lay-Saint-Remy;339;5;344
44;Grand Est;54;3;10;307;Lebeuville;167;4;171
44;Grand Est;54;2;01;308;Leintrey;147;3;150
44;Grand Est;54;3;10;309;Lemainville;393;3;396
44;Grand Est;54;3;10;310;Leménil-Mitry;3;0;3
44;Grand Est;54;3;03;311;Lenoncourt;593;8;601
44;Grand Est;54;3;18;312;Lesménils;487;4;491
44;Grand Est;54;3;02;313;Létricourt;231;1;232
44;Grand Est;54;1;07;314;Lexy;3845;61;3906
44;Grand Est;54;3;02;315;Leyr;905;11;916
44;Grand Est;54;4;16;316;Limey-Remenauville;303;5;308
44;Grand Est;54;4;16;317;Lironville;132;6;138
44;Grand Est;54;4;16;318;Liverdun;5749;70;5819
44;Grand Est;54;3;18;320;Loisy;325;4;329
44;Grand Est;54;1;23;321;Longlaville;2367;27;2394
44;Grand Est;54;1;11;322;Longuyon;5223;62;5285
44;Grand Est;54;1;07;323;Longwy;15117;240;15357
44;Grand Est;54;2;09;324;Lorey;87;1;88
44;Grand Est;54;2;09;325;Loromontzey;79;8;87
44;Grand Est;54;1;17;326;Lubey;219;10;229
44;Grand Est;54;4;16;327;Lucey;628;14;642
44;Grand Est;54;3;05;328;Ludres;6128;91;6219
44;Grand Est;54;2;98;329;Lunéville;17858;302;18160
44;Grand Est;54;3;05;330;Lupcourt;423;9;432
44;Grand Est;54;2;09;331;Magnières;279;6;285
44;Grand Est;54;3;18;332;Maidières;1530;16;1546
44;Grand Est;54;3;02;333;Mailly-sur-Seille;250;14;264
44;Grand Est;54;1;17;334;Mairy-Mainville;560;11;571
44;Grand Est;54;2;08;335;Maixe;408;4;412
44;Grand Est;54;3;15;336;Maizières;915;11;926
44;Grand Est;54;1;17;337;Malavillers;129;3;132
44;Grand Est;54;3;02;338;Malleloy;992;13;1005
44;Grand Est;54;3;19;339;Malzéville;8036;294;8330
44;Grand Est;54;4;16;340;Mamey;340;4;344
44;Grand Est;54;4;16;343;Mandres-aux-Quatre-Tours;188;6;194
44;Grand Est;54;3;10;344;Mangonville;215;4;219
44;Grand Est;54;3;05;345;Manoncourt-en-Vermois;341;5;346
44;Grand Est;54;4;16;346;Manoncourt-en-Woëvre;249;3;252
44;Grand Est;54;4;16;348;Manonville;237;9;246
44;Grand Est;54;2;01;349;Manonviller;166;2;168
44;Grand Est;54;2;01;350;Marainviller;700;8;708
44;Grand Est;54;3;21;351;Marbache;1685;15;1700
44;Grand Est;54;3;15;352;Maron;824;9;833
44;Grand Est;54;1;04;353;Mars-la-Tour;901;15;916
44;Grand Est;54;3;10;354;Marthemont;48;0;48
44;Grand Est;54;4;16;355;Martincourt;92;1;93
44;Grand Est;54;2;09;356;Mattexey;67;2;69
44;Grand Est;54;3;21;357;Maxéville;9816;115;9931
44;Grand Est;54;3;03;358;Mazerulles;279;5;284
44;Grand Est;54;2;09;359;Méhoncourt;244;3;247
44;Grand Est;54;4;16;360;Ménil-la-Tour;337;8;345
44;Grand Est;54;1;17;362;Mercy-le-Bas;1282;7;1289
44;Grand Est;54;1;17;363;Mercy-le-Haut;274;6;280
44;Grand Est;54;3;15;364;Méréville;1288;19;1307
44;Grand Est;54;2;01;365;Merviller;325;10;335
44;Grand Est;54;3;15;366;Messein;1982;18;2000
44;Grand Est;54;1;07;367;Mexy;2265;66;2331
44;Grand Est;54;2;01;368;Mignéville;174;3;177
44;Grand Est;54;3;02;369;Millery;611;8;619
44;Grand Est;54;4;16;370;Minorville;225;2;227
44;Grand Est;54;1;04;371;Moineville;1065;20;1085
44;Grand Est;54;3;02;372;Moivrons;516;3;519
44;Grand Est;54;2;09;373;Moncel-lès-Lunéville;611;4;615
44;Grand Est;54;3;03;374;Moncel-sur-Seille;521;9;530
44;Grand Est;54;3;18;375;Montauville;1087;16;1103
44;Grand Est;54;3;02;376;Montenoy;407;7;414
44;Grand Est;54;2;01;377;Montigny;160;0;160
44;Grand Est;54;1;11;378;Montigny-sur-Chiers;470;7;477
44;Grand Est;54;4;10;379;Mont-l'Étroit;96;0;96
44;Grand Est;54;4;10;380;Mont-le-Vignoble;403;10;413
44;Grand Est;54;2;01;381;Montreux;54;2;56
44;Grand Est;54;1;11;382;Mont-Saint-Martin;9020;110;9130
44;Grand Est;54;2;09;383;Mont-sur-Meurthe;1122;11;1133
44;Grand Est;54;1;23;385;Morfontaine;1081;24;1105
44;Grand Est;54;2;09;386;Moriviller;93;1;94
44;Grand Est;54;3;02;387;Morville-sur-Seille;153;0;153
44;Grand Est;54;2;01;388;Mouacourt;74;2;76
44;Grand Est;54;1;17;389;Mouaville;101;2;103
44;Grand Est;54;3;18;390;Mousson;101;2;103
44;Grand Est;54;1;04;391;Moutiers;1568;25;1593
44;Grand Est;54;4;10;392;Moutrot;312;2;314
44;Grand Est;54;2;09;393;Moyen;533;9;542
44;Grand Est;54;1;17;394;Murville;246;5;251
44;Grand Est;54;3;99;395;Nancy;104403;1482;105885
44;Grand Est;54;2;01;396;Neufmaisons;224;8;232
44;Grand Est;54;3;15;397;Neuves-Maisons;6629;55;6684
44;Grand Est;54;2;01;398;Neuviller-lès-Badonviller;97;1;98
44;Grand Est;54;3;10;399;Neuviller-sur-Moselle;250;1;251
44;Grand Est;54;3;02;400;Nomeny;1139;22;1161
44;Grand Est;54;2;01;401;Nonhigny;121;5;126
44;Grand Est;54;1;17;402;Norroy-le-Sec;413;11;424
44;Grand Est;54;3;18;403;Norroy-lès-Pont-à-Mousson;1188;35;1223
44;Grand Est;54;4;16;404;Noviant-aux-Prés;267;5;272
44;Grand Est;54;4;10;405;Ochey;524;0;524
44;Grand Est;54;2;01;406;Ogéviller;278;7;285
44;Grand Est;54;3;10;407;Ognéville;95;3;98
44;Grand Est;54;1;04;408;Olley;228;3;231
44;Grand Est;54;3;10;409;Omelmont;190;3;193
44;Grand Est;54;1;18;410;Onville;516;3;519
44;Grand Est;54;3;10;411;Ormes-et-Ville;219;6;225
44;Grand Est;54;1;11;412;Othe;39;3;42
44;Grand Est;54;1;17;413;Ozerailles;151;1;152
44;Grand Est;54;4;20;414;Pagney-derrière-Barine;653;8;661
44;Grand Est;54;3;18;415;Pagny-sur-Moselle;4053;56;4109
44;Grand Est;54;4;16;416;Pannes;179;1;180
44;Grand Est;54;3;10;417;Parey-Saint-Césaire;239;6;245
44;Grand Est;54;2;01;418;Parroy;171;1;172
44;Grand Est;54;2;01;419;Parux;74;0;74
44;Grand Est;54;1;11;420;Petit-Failly;87;1;88
44;Grand Est;54;2;01;421;Petitmont;313;5;318
44;Grand Est;54;2;01;422;Pettonville;69;1;70
44;Grand Est;54;2;01;423;Pexonne;339;10;349
44;Grand Est;54;3;02;424;Phlin;44;1;45
44;Grand Est;54;1;17;425;Piennes;2476;20;2496
44;Grand Est;54;4;20;426;Pierre-la-Treiche;474;6;480
44;Grand Est;54;2;01;427;Pierre-Percée;95;1;96
44;Grand Est;54;1;11;428;Pierrepont;851;11;862
44;Grand Est;54;3;10;429;Pierreville;297;2;299
44;Grand Est;54;3;21;430;Pompey;4857;51;4908
44;Grand Est;54;3;18;431;Pont-à-Mousson;14357;193;14550
44;Grand Est;54;3;15;432;Pont-Saint-Vincent;1813;39;1852
44;Grand Est;54;3;02;433;Port-sur-Seille;228;7;235
44;Grand Est;54;3;10;434;Praye;250;2;252
44;Grand Est;54;3;18;435;Prény;365;5;370
44;Grand Est;54;1;17;436;Preutin-Higny;152;4;156
44;Grand Est;54;3;15;437;Pulligny;1149;19;1168
44;Grand Est;54;4;10;438;Pulney;55;0;55
44;Grand Est;54;3;03;439;Pulnoy;5135;65;5200
44;Grand Est;54;1;04;440;Puxe;122;0;122
44;Grand Est;54;1;04;441;Puxieux;231;5;236
44;Grand Est;54;3;10;442;Quevilloncourt;96;2;98
44;Grand Est;54;2;01;443;Raon-lès-Leau;38;0;38
44;Grand Est;54;3;02;444;Raucourt;224;3;227
44;Grand Est;54;2;08;445;Raville-sur-Sânon;101;0;101
44;Grand Est;54;2;01;446;Réchicourt-la-Petite;64;2;66
44;Grand Est;54;2;01;447;Réclonville;74;3;77
44;Grand Est;54;2;09;449;Rehainviller;1049;16;1065
44;Grand Est;54;2;01;450;Reherrey;144;1;145
44;Grand Est;54;1;07;451;Réhon;3799;73;3872
44;Grand Est;54;2;01;452;Reillon;73;2;75
44;Grand Est;54;4;16;453;Rembercourt-sur-Mad;159;1;160
44;Grand Est;54;2;09;455;Remenoville;156;4;160
44;Grand Est;54;3;03;456;Réméréville;604;10;614
44;Grand Est;54;2;01;457;Remoncourt;43;0;43
44;Grand Est;54;2;01;458;Repaix;109;1;110
44;Grand Est;54;3;15;459;Richardménil;2308;25;2333
44;Grand Est;54;4;16;460;Rogéville;151;3;154
44;Grand Est;54;2;09;461;Romain;69;2;71
44;Grand Est;54;3;09;462;Rosières-aux-Salines;2851;34;2885
44;Grand Est;54;4;16;463;Rosières-en-Haye;229;2;231
44;Grand Est;54;3;02;464;Rouves;106;0;106
44;Grand Est;54;3;10;465;Roville-devant-Bayon;761;11;772
44;Grand Est;54;4;16;466;Royaumeix;402;5;407
44;Grand Est;54;2;09;467;Rozelieures;188;3;191
44;Grand Est;54;3;09;468;Saffais;111;2;113
44;Grand Est;54;1;04;469;Saint-Ail;414;5;419
44;Grand Est;54;4;16;470;Saint-Baussant;75;2;77
44;Grand Est;54;2;09;471;Saint-Boingt;72;1;73
44;Grand Est;54;2;01;472;Saint-Clément;853;12;865
44;Grand Est;54;3;10;473;Saint-Firmin;285;6;291
44;Grand Est;54;3;02;474;Sainte-Geneviève;198;0;198
44;Grand Est;54;2;09;475;Saint-Germain;154;6;160
44;Grand Est;54;1;11;476;Saint-Jean-lès-Longuyon;414;10;424
44;Grand Est;54;1;04;477;Saint-Julien-lès-Gorze;162;3;165
44;Grand Est;54;1;04;478;Saint-Marcel;150;1;151
44;Grand Est;54;2;09;479;Saint-Mard;99;1;100
44;Grand Est;54;2;01;480;Saint-Martin;56;1;57
44;Grand Est;54;2;01;481;Saint-Maurice-aux-Forges;98;3;101
44;Grand Est;54;3;19;482;Saint-Max;10046;93;10139
44;Grand Est;54;3;05;483;Saint-Nicolas-de-Port;7383;69;7452
44;Grand Est;54;2;01;484;Sainte-Pôle;183;7;190
44;Grand Est;54;1;11;485;Saint-Pancré;309;5;314
44;Grand Est;54;3;10;486;Saint-Remimont;345;6;351
44;Grand Est;54;2;09;487;Saint-Rémy-aux-Bois;63;0;63
44;Grand Est;54;2;01;488;Saint-Sauveur;34;0;34
44;Grand Est;54;1;11;489;Saint-Supplet;152;4;156
44;Grand Est;54;3;16;490;Saizerais;1464;23;1487
44;Grand Est;54;1;17;491;Sancy;335;4;339
44;Grand Est;54;4;16;492;Sanzey;154;3;157
44;Grand Est;54;1;23;493;Saulnes;2362;37;2399
44;Grand Est;54;4;10;494;Saulxerotte;101;0;101
44;Grand Est;54;3;03;495;Saulxures-lès-Nancy;4220;59;4279
44;Grand Est;54;4;10;496;Saulxures-lès-Vannes;374;4;378
44;Grand Est;54;3;10;497;Saxon-Sion;107;3;110
44;Grand Est;54;3;03;498;Seichamps;5111;66;5177
44;Grand Est;54;4;16;499;Seicheprey;110;4;114
44;Grand Est;54;4;10;500;Selaincourt;182;3;185
44;Grand Est;54;2;09;501;Seranville;101;0;101
44;Grand Est;54;2;08;502;Serres;242;1;243
44;Grand Est;54;1;23;504;Serrouville;657;15;672
44;Grand Est;54;4;15;505;Sexey-aux-Forges;724;8;732
44;Grand Est;54;2;08;507;Sionviller;102;2;104
44;Grand Est;54;3;02;508;Sivry;239;5;244
44;Grand Est;54;2;08;509;Sommerviller;996;5;1001
44;Grand Est;54;3;03;510;Sornéville;305;6;311
44;Grand Est;54;1;04;511;Sponville;111;4;115
44;Grand Est;54;2;01;512;Tanconville;106;2;108
44;Grand Est;54;3;10;513;Tantonville;646;3;649
44;Grand Est;54;1;11;514;Tellancourt;622;15;637
44;Grand Est;54;3;10;515;Thélod;250;0;250
44;Grand Est;54;3;10;516;They-sous-Vaudemont;18;1;19
44;Grand Est;54;3;02;517;Thézey-Saint-Martin;202;2;204
44;Grand Est;54;4;16;518;Thiaucourt-Regniéville;1113;6;1119
44;Grand Est;54;2;01;519;Thiaville-sur-Meurthe;594;8;602
44;Grand Est;54;2;01;520;Thiébauménil;382;8;390
44;Grand Est;54;1;23;521;Thil;1968;19;1987
44;Grand Est;54;3;10;522;Thorey-Lyautey;135;2;137
44;Grand Est;54;4;10;523;Thuilley-aux-Groseilles;423;1;424
44;Grand Est;54;1;17;524;Thumeréville;90;2;92
44;Grand Est;54;1;23;525;Tiercelet;654;9;663
44;Grand Est;54;3;19;526;Tomblaine;8941;283;9224
44;Grand Est;54;3;09;527;Tonnoy;664;25;689
44;Grand Est;54;4;20;528;Toul;15857;250;16107
44;Grand Est;54;4;10;529;Tramont-Émy;28;0;28
44;Grand Est;54;4;10;530;Tramont-Lassus;88;4;92
44;Grand Est;54;4;10;531;Tramont-Saint-André;59;0;59
44;Grand Est;54;4;16;532;Tremblecourt;163;3;166
44;Grand Est;54;1;17;533;Trieux;2620;31;2651
44;Grand Est;54;4;16;534;Trondes;523;20;543
44;Grand Est;54;1;04;535;Tronville;198;6;204
44;Grand Est;54;1;17;536;Tucquegnieux;2422;24;2446
44;Grand Est;54;1;11;537;Ugny;692;30;722
44;Grand Est;54;4;10;538;Uruffe;371;3;374
44;Grand Est;54;2;01;539;Vacqueville;230;13;243
44;Grand Est;54;2;01;540;Val-et-Châtillon;569;5;574
44;Grand Est;54;2;08;541;Valhey;165;2;167
44;Grand Est;54;1;04;542;Valleroy;2315;36;2351
44;Grand Est;54;2;09;543;Vallois;147;4;151
44;Grand Est;54;4;18;544;Vandelainville;139;2;141
44;Grand Est;54;4;10;545;Vandeléville;211;4;215
44;Grand Est;54;3;18;546;Vandières;929;8;937
44;Grand Est;54;3;22;547;Vandœuvre-lès-Nancy;29723;316;30039
44;Grand Est;54;4;10;548;Vannes-le-Châtel;523;10;533
44;Grand Est;54;3;08;549;Varangéville;3600;41;3641
44;Grand Est;54;2;09;550;Vathiménil;320;8;328
44;Grand Est;54;2;01;551;Vaucourt;59;2;61
44;Grand Est;54;3;10;552;Vaudémont;65;1;66
44;Grand Est;54;3;10;553;Vaudeville;146;4;150
44;Grand Est;54;3;10;554;Vaudigny;78;1;79
44;Grand Est;54;2;01;555;Vaxainville;87;0;87
44;Grand Est;54;2;01;556;Vého;108;3;111
44;Grand Est;54;4;16;557;Bois-de-Haye;2318;97;2415
44;Grand Est;54;3;03;558;Velaine-sous-Amance;280;5;285
44;Grand Est;54;2;09;559;Velle-sur-Moselle;311;2;313
44;Grand Est;54;2;01;560;Veney;52;0;52
44;Grand Est;54;2;09;561;Vennezey;44;3;47
44;Grand Est;54;2;01;562;Verdenal;147;2;149
44;Grand Est;54;3;10;563;Vézelise;1361;18;1379
44;Grand Est;54;4;16;564;Viéville-en-Haye;141;4;145
44;Grand Est;54;2;09;565;Vigneulles;235;2;237
44;Grand Est;54;4;16;566;Vilcey-sur-Trey;150;1;151
44;Grand Est;54;2;09;567;Villacourt;356;11;367
44;Grand Est;54;1;11;568;Ville-au-Montois;263;12;275
44;Grand Est;54;3;02;569;Ville-au-Val;191;4;195
44;Grand Est;54;1;18;570;Villecey-sur-Mad;340;5;345
44;Grand Est;54;3;05;571;Ville-en-Vermois;592;7;599
44;Grand Est;54;1;11;572;Ville-Houdlémont;690;5;695
44;Grand Est;54;4;16;573;Villers-en-Haye;165;0;165
44;Grand Est;54;1;11;574;Villers-la-Chèvre;549;19;568
44;Grand Est;54;1;23;575;Villers-la-Montagne;1538;31;1569
44;Grand Est;54;1;11;576;Villers-le-Rond;121;1;122
44;Grand Est;54;3;02;577;Villers-lès-Moivrons;141;1;142
44;Grand Est;54;3;06;578;Villers-lès-Nancy;14305;298;14603
44;Grand Est;54;3;18;579;Villers-sous-Prény;333;7;340
44;Grand Est;54;1;23;580;Villerupt;10098;108;10206
44;Grand Est;54;1;04;581;Ville-sur-Yron;298;9;307
44;Grand Est;54;1;11;582;Villette;185;1;186
44;Grand Est;54;4;20;583;Villey-le-Sec;420;8;428
44;Grand Est;54;4;16;584;Villey-Saint-Étienne;1021;22;1043
44;Grand Est;54;2;09;585;Virecourt;494;7;501
44;Grand Est;54;3;10;586;Viterne;741;11;752
44;Grand Est;54;3;10;587;Vitrey;190;3;193
44;Grand Est;54;2;08;588;Vitrimont;393;9;402
44;Grand Est;54;3;18;589;Vittonville;127;5;132
44;Grand Est;54;1;11;590;Viviers-sur-Chiers;660;19;679
44;Grand Est;54;3;10;591;Voinémont;332;12;344
44;Grand Est;54;3;10;592;Vroncourt;262;3;265
44;Grand Est;54;1;18;593;Waville;431;9;440
44;Grand Est;54;4;16;594;Xammes;166;1;167
44;Grand Est;54;2;09;595;Xermaménil;564;6;570
44;Grand Est;54;3;10;596;Xeuilley;969;7;976
44;Grand Est;54;3;10;597;Xirocourt;443;3;446
44;Grand Est;54;1;17;598;Xivry-Circourt;270;7;277
44;Grand Est;54;1;04;599;Xonville;109;0;109
44;Grand Est;54;2;01;600;Xousse;124;2;126
44;Grand Est;54;2;01;601;Xures;101;3;104
44;Grand Est;54;1;11;602;Han-devant-Pierrepont;148;0;148
44;Grand Est;55;2;10;001;Abainville;285;9;294
44;Grand Est;55;3;04;002;Abaucourt-Hautecourt;101;3;104
44;Grand Est;55;3;14;004;Aincreville;81;0;81
44;Grand Est;55;2;10;005;Amanty;36;1;37
44;Grand Est;55;3;08;007;Ambly-sur-Meuse;242;2;244
44;Grand Est;55;3;05;008;Amel-sur-l'Étang;144;5;149
44;Grand Est;55;3;08;009;Ancemont;536;19;555
44;Grand Est;55;1;01;010;Ancerville;2617;71;2688
44;Grand Est;55;1;12;011;Andernay;256;3;259
44;Grand Est;55;2;13;012;Apremont-la-Forêt;422;8;430
44;Grand Est;55;3;05;013;Arrancy-sur-Crusnes;466;8;474
44;Grand Est;55;3;06;014;Aubréville;360;7;367
44;Grand Est;55;1;01;015;Aulnois-en-Perthois;489;11;500
44;Grand Est;55;1;08;017;Autrécourt-sur-Aire;118;5;123
44;Grand Est;55;3;14;018;Autréville-Saint-Lambert;40;2;42
44;Grand Est;55;3;09;021;Avillers-Sainte-Croix;68;5;73
44;Grand Est;55;3;11;022;Avioth;141;7;148
44;Grand Est;55;3;06;023;Avocourt;120;1;121
44;Grand Est;55;3;11;024;Azannes-et-Soumazannes;161;3;164
44;Grand Est;55;3;14;025;Baâlon;276;2;278
44;Grand Est;55;2;10;026;Badonvilliers-Gérauvilliers;129;5;134
44;Grand Est;55;2;08;027;Bannoncourt;160;3;163
44;Grand Est;55;3;06;028;Bantheville;110;4;114
44;Grand Est;55;1;98;029;Bar-le-Duc;14592;543;15135
44;Grand Est;55;1;01;031;Baudonvilliers;378;5;383
44;Grand Est;55;2;08;032;Baudrémont;44;0;44
44;Grand Est;55;3;06;033;Baulny;19;1;20
44;Grand Est;55;3;11;034;Bazeilles-sur-Othain;113;1;114
44;Grand Est;55;1;01;035;Bazincourt-sur-Saulx;145;6;151
44;Grand Est;55;3;14;036;Beauclair;93;1;94
44;Grand Est;55;3;14;037;Beaufort-en-Argonne;139;3;142
44;Grand Est;55;1;08;038;Beaulieu-en-Argonne;38;2;40
44;Grand Est;55;3;04;039;Beaumont-en-Verdunois;0;0;0
44;Grand Est;55;1;08;040;Beausite;253;6;259
44;Grand Est;55;1;03;041;Behonne;607;16;623
44;Grand Est;55;3;17;042;Belleray;527;12;539
44;Grand Est;55;3;04;043;Belleville-sur-Meuse;3020;53;3073
44;Grand Est;55;2;08;044;Belrain;31;3;34
44;Grand Est;55;3;17;045;Belrupt-en-Verdunois;551;9;560
44;Grand Est;55;2;13;046;Beney-en-Woëvre;131;4;135
44;Grand Est;55;3;06;047;Béthelainville;159;6;165
44;Grand Est;55;3;06;048;Béthincourt;38;0;38
44;Grand Est;55;1;12;049;Beurey-sur-Saulx;422;1;423
44;Grand Est;55;3;04;050;Bezonvaux;0;0;0
44;Grand Est;55;1;10;051;Biencourt-sur-Orge;121;0;121
44;Grand Est;55;3;05;053;Billy-sous-Mangiennes;368;2;370
44;Grand Est;55;2;13;054;Bislée;61;4;65
44;Grand Est;55;3;04;055;Blanzée;13;1;14
44;Grand Est;55;3;09;057;Boinville-en-Woëvre;77;2;79
44;Grand Est;55;2;07;058;Boncourt-sur-Meuse;326;10;336
44;Grand Est;55;2;10;059;Bonnet;190;7;197
44;Grand Est;55;3;09;060;Bonzée;353;13;366
44;Grand Est;55;1;10;061;Le Bouchon-sur-Saulx;237;6;243
44;Grand Est;55;2;13;062;Bouconville-sur-Madt;109;1;110
44;Grand Est;55;3;05;063;Bouligny;2448;40;2488
44;Grand Est;55;2;08;064;Bouquemont;109;0;109
44;Grand Est;55;3;06;065;Boureuilles;117;0;117
44;Grand Est;55;2;15;066;Bovée-sur-Barboure;129;2;131
44;Grand Est;55;2;15;067;Boviolles;99;1;100
44;Grand Est;55;3;06;068;Brabant-en-Argonne;107;0;107
44;Grand Est;55;1;12;069;Brabant-le-Roi;227;7;234
44;Grand Est;55;3;06;070;Brabant-sur-Meuse;119;6;125
44;Grand Est;55;3;11;071;Brandeville;181;3;184
44;Grand Est;55;3;09;072;Braquis;107;1;108
44;Grand Est;55;3;04;073;Bras-sur-Meuse;683;51;734
44;Grand Est;55;1;10;075;Brauvilliers;175;4;179
44;Grand Est;55;3;11;076;Bréhéville;174;4;178
44;Grand Est;55;3;11;077;Breux;263;9;272
44;Grand Est;55;3;14;078;Brieulles-sur-Meuse;296;8;304
44;Grand Est;55;1;01;079;Brillon-en-Barrois;698;21;719
44;Grand Est;55;2;15;080;Brixey-aux-Chanoines;79;4;83
44;Grand Est;55;1;08;081;Brizeaux;59;0;59
44;Grand Est;55;3;06;082;Brocourt-en-Argonne;46;0;46
44;Grand Est;55;3;14;083;Brouennes;155;4;159
44;Grand Est;55;2;15;084;Broussey-en-Blois;56;2;58
44;Grand Est;55;2;13;085;Broussey-Raulecourt;287;4;291
44;Grand Est;55;1;10;087;Bure;79;6;85
44;Grand Est;55;2;15;088;Burey-en-Vaux;152;4;156
44;Grand Est;55;2;15;089;Burey-la-Côte;88;1;89
44;Grand Est;55;2;13;093;Buxières-sous-les-Côtes;282;7;289
44;Grand Est;55;3;09;094;Buzy-Darmont;541;9;550
44;Grand Est;55;3;14;095;Cesse;102;4;106
44;Grand Est;55;2;13;096;Chaillon;110;1;111
44;Grand Est;55;2;15;097;Chalaines;310;7;317
44;Grand Est;55;3;04;099;Champneuville;123;1;124
44;Grand Est;55;2;15;100;Champougny;75;7;82
44;Grand Est;55;1;03;101;Chardogne;297;8;305
44;Grand Est;55;3;04;102;Charny-sur-Meuse;527;20;547
44;Grand Est;55;3;06;103;Charpentry;21;2;23
44;Grand Est;55;2;10;104;Chassey-Beaupré;79;3;82
44;Grand Est;55;3;04;105;Châtillon-sous-les-Côtes;177;4;181
44;Grand Est;55;3;06;106;Chattancourt;177;5;182
44;Grand Est;55;3;11;107;Chaumont-devant-Damvillers;47;0;47
44;Grand Est;55;1;12;108;Chaumont-sur-Aire;122;4;126
44;Grand Est;55;3;11;109;Chauvency-le-Château;231;7;238
44;Grand Est;55;3;11;110;Chauvency-Saint-Hubert;224;6;230
44;Grand Est;55;2;13;111;Chauvoncourt;437;20;457
44;Grand Est;55;3;06;113;Cheppy;155;4;159
44;Grand Est;55;2;07;114;Chonville-Malaumont;205;4;209
44;Grand Est;55;3;06;115;Cierges-sous-Montfaucon;46;0;46
44;Grand Est;55;3;06;116;Le Claon;53;2;55
44;Grand Est;55;3;06;117;Clermont-en-Argonne;1449;35;1484
44;Grand Est;55;3;14;118;Cléry-le-Grand;94;2;96
44;Grand Est;55;3;14;119;Cléry-le-Petit;189;1;190
44;Grand Est;55;1;02;120;Combles-en-Barrois;778;23;801
44;Grand Est;55;3;09;121;Combres-sous-les-Côtes;116;3;119
44;Grand Est;55;2;07;122;Commercy;5352;226;5578
44;Grand Est;55;1;12;123;Les Hauts-de-Chée;711;14;725
44;Grand Est;55;3;06;124;Consenvoye;308;4;312
44;Grand Est;55;1;12;125;Contrisson;787;18;805
44;Grand Est;55;2;08;127;Courcelles-en-Barrois;42;0;42
44;Grand Est;55;1;12;128;Courcelles-sur-Aire;41;1;42
44;Grand Est;55;2;08;129;Courouvre;37;1;38
44;Grand Est;55;1;01;132;Cousances-les-Forges;1675;28;1703
44;Grand Est;55;1;10;133;Couvertpuis;85;4;89
44;Grand Est;55;1;12;134;Couvonges;152;4;156
44;Grand Est;55;3;06;137;Cuisy;47;0;47
44;Grand Est;55;1;15;138;Culey;127;3;130
44;Grand Est;55;3;04;139;Cumières-le-Mort-Homme;0;0;0
44;Grand Est;55;3;06;140;Cunel;18;0;18
44;Grand Est;55;2;15;141;Dagonville;83;0;83
44;Grand Est;55;2;10;142;Dainville-Bertheléville;123;6;129
44;Grand Est;55;3;04;143;Damloup;125;8;133
44;Grand Est;55;1;10;144;Dammarie-sur-Saulx;379;11;390
44;Grand Est;55;3;11;145;Damvillers;618;75;693
44;Grand Est;55;3;06;146;Dannevoux;197;10;207
44;Grand Est;55;2;10;148;Delouze-Rosières;114;2;116
44;Grand Est;55;3;11;149;Delut;120;0;120
44;Grand Est;55;2;10;150;Demange-Baudignécourt;512;12;524
44;Grand Est;55;3;04;153;Dieppe-sous-Douaumont;194;2;196
44;Grand Est;55;3;08;154;Dieue-sur-Meuse;1441;47;1488
44;Grand Est;55;3;06;155;Dombasle-en-Argonne;393;7;400
44;Grand Est;55;3;11;156;Dombras;137;4;141
44;Grand Est;55;3;09;157;Dommartin-la-Montagne;52;0;52
44;Grand Est;55;3;05;158;Dommary-Baroncourt;723;8;731
44;Grand Est;55;2;08;159;Dompcevrin;353;3;356
44;Grand Est;55;2;13;160;Dompierre-aux-Bois;38;0;38
44;Grand Est;55;3;05;162;Domremy-la-Canne;33;0;33
44;Grand Est;55;3;09;163;Doncourt-aux-Templiers;54;3;57
44;Grand Est;55;3;14;165;Doulcon;429;9;438
44;Grand Est;55;3;17;166;Dugny-sur-Meuse;1313;26;1339
44;Grand Est;55;3;14;167;Dun-sur-Meuse;637;19;656
44;Grand Est;55;3;05;168;Duzey;45;0;45
44;Grand Est;55;3;11;169;Écouviez;515;5;520
44;Grand Est;55;3;11;170;Écurey-en-Verdunois;115;1;116
44;Grand Est;55;3;04;171;Eix;259;4;263
44;Grand Est;55;3;09;172;Les Éparges;61;1;62
44;Grand Est;55;2;15;173;Épiez-sur-Meuse;39;3;42
44;Grand Est;55;3;06;174;Épinonville;78;0;78
44;Grand Est;55;1;02;175;Érize-la-Brûlée;184;4;188
44;Grand Est;55;1;12;177;Érize-la-Petite;45;4;49
44;Grand Est;55;1;02;178;Érize-Saint-Dizier;187;4;191
44;Grand Est;55;2;15;179;Erneville-aux-Bois;145;2;147
44;Grand Est;55;3;06;180;Esnes-en-Argonne;136;11;147
44;Grand Est;55;3;09;181;Étain;3492;72;3564
44;Grand Est;55;3;05;182;Éton;207;3;210
44;Grand Est;55;3;11;183;Étraye;37;1;38
44;Grand Est;55;2;07;184;Euville;1644;31;1675
44;Grand Est;55;1;08;185;Èvres;89;5;94
44;Grand Est;55;1;03;186;Fains-Véel;2093;50;2143
44;Grand Est;55;3;11;188;Flassigny;44;1;45
44;Grand Est;55;3;04;189;Fleury-devant-Douaumont;0;0;0
44;Grand Est;55;3;05;191;Foameix-Ornel;225;5;230
44;Grand Est;55;3;14;192;Fontaines-Saint-Clair;39;1;40
44;Grand Est;55;3;06;193;Forges-sur-Meuse;124;2;126
44;Grand Est;55;1;08;194;Foucaucourt-sur-Thabas;60;0;60
44;Grand Est;55;1;10;195;Fouchères-aux-Bois;123;3;126
44;Grand Est;55;2;07;196;Frémeréville-sous-les-Côtes;126;1;127
44;Grand Est;55;2;08;197;Fresnes-au-Mont;166;4;170
44;Grand Est;55;3;09;198;Fresnes-en-Woëvre;657;13;670
44;Grand Est;55;3;06;199;Froidos;88;2;90
44;Grand Est;55;3;06;200;Fromeréville-les-Vallons;207;4;211
44;Grand Est;55;3;09;201;Fromezey;61;0;61
44;Grand Est;55;3;06;202;Futeau;145;3;148
44;Grand Est;55;3;08;204;Génicourt-sur-Meuse;292;5;297
44;Grand Est;55;3;06;206;Gercourt-et-Drillancourt;107;6;113
44;Grand Est;55;1;02;207;Géry;53;1;54
44;Grand Est;55;3;06;208;Gesnes-en-Argonne;57;2;59
44;Grand Est;55;2;08;210;Gimécourt;40;2;42
44;Grand Est;55;3;04;211;Gincrey;64;0;64
44;Grand Est;55;2;07;212;Girauvoisin;82;0;82
44;Grand Est;55;1;10;214;Givrauval;278;16;294
44;Grand Est;55;2;10;215;Gondrecourt-le-Château;1065;17;1082
44;Grand Est;55;3;05;216;Gouraincourt;64;0;64
44;Grand Est;55;2;15;217;Goussaincourt;115;4;119
44;Grand Est;55;3;11;218;Gremilly;41;0;41
44;Grand Est;55;3;04;219;Grimaucourt-en-Woëvre;101;2;103
44;Grand Est;55;2;07;220;Grimaucourt-près-Sampigny;83;2;85
44;Grand Est;55;1;01;221;Guerpont;243;5;248
44;Grand Est;55;3;09;222;Gussainville;31;2;33
44;Grand Est;55;1;01;224;Haironville;578;13;591
44;Grand Est;55;3;14;225;Halles-sous-les-Côtes;139;6;145
44;Grand Est;55;3;11;226;Han-lès-Juvigny;123;1;124
44;Grand Est;55;3;09;228;Hannonville-sous-les-Côtes;542;10;552
44;Grand Est;55;2;13;229;Han-sur-Meuse;269;3;272
44;Grand Est;55;3;09;232;Harville;112;0;112
44;Grand Est;55;3;17;236;Haudainville;935;24;959
44;Grand Est;55;3;09;237;Haudiomont;232;1;233
44;Grand Est;55;3;04;239;Haumont-près-Samogneux;0;0;0
44;Grand Est;55;3;08;241;Heippes;77;4;81
44;Grand Est;55;3;09;242;Hennemont;110;4;114
44;Grand Est;55;3;09;243;Herbeuville;181;5;186
44;Grand Est;55;3;09;244;Herméville-en-Woëvre;228;3;231
44;Grand Est;55;2;13;245;Heudicourt-sous-les-Côtes;164;2;166
44;Grand Est;55;1;10;246;Hévilliers;152;0;152
44;Grand Est;55;2;10;247;Horville-en-Ornois;48;5;53
44;Grand Est;55;2;10;248;Houdelaincourt;279;5;284
44;Grand Est;55;3;14;250;Inor;181;8;189
44;Grand Est;55;1;08;251;Ippécourt;105;3;108
44;Grand Est;55;3;11;252;Iré-le-Sec;155;2;157
44;Grand Est;55;3;06;253;Les Islettes;708;11;719
44;Grand Est;55;1;08;254;Les Trois-Domaines;123;3;126
44;Grand Est;55;3;11;255;Jametz;260;6;266
44;Grand Est;55;2;13;256;Jonville-en-Woëvre;147;2;149
44;Grand Est;55;3;06;257;Jouy-en-Argonne;42;0;42
44;Grand Est;55;2;07;258;Geville;619;15;634
44;Grand Est;55;3;08;260;Julvécourt;53;2;55
44;Grand Est;55;1;01;261;Juvigny-en-Perthois;143;2;145
44;Grand Est;55;3;11;262;Juvigny-sur-Loison;267;2;269
44;Grand Est;55;2;08;263;Kœur-la-Grande;160;1;161
44;Grand Est;55;2;08;264;Kœur-la-Petite;261;6;267
44;Grand Est;55;3;09;265;Labeuville;139;5;144
44;Grand Est;55;3;06;266;Lachalade;48;1;49
44;Grand Est;55;2;13;267;Lachaussée;276;8;284
44;Grand Est;55;2;13;268;Lacroix-sur-Meuse;691;16;707
44;Grand Est;55;2;08;269;Lahaymeix;74;0;74
44;Grand Est;55;2;13;270;Lahayville;30;0;30
44;Grand Est;55;1;12;271;Laheycourt;365;5;370
44;Grand Est;55;1;12;272;Laimont;431;18;449
44;Grand Est;55;2;13;274;Lamorville;290;6;296
44;Grand Est;55;3;14;275;Lamouilly;85;4;89
44;Grand Est;55;3;08;276;Landrecourt-Lempire;217;2;219
44;Grand Est;55;2;15;278;Laneuville-au-Rupt;194;3;197
44;Grand Est;55;3;14;279;Laneuville-sur-Meuse;445;7;452
44;Grand Est;55;3;05;280;Lanhères;58;1;59
44;Grand Est;55;3;09;281;Latour-en-Woëvre;94;0;94
44;Grand Est;55;2;08;282;Lavallée;96;3;99
44;Grand Est;55;1;01;284;Lavincourt;73;0;73
44;Grand Est;55;1;08;285;Lavoye;151;4;155
44;Grand Est;55;3;08;286;Lemmes;237;1;238
44;Grand Est;55;2;07;288;Lérouville;1410;17;1427
44;Grand Est;55;2;08;289;Levoncourt;59;1;60
44;Grand Est;55;2;08;290;Lignières-sur-Aire;55;2;57
44;Grand Est;55;1;10;291;Ligny-en-Barrois;3909;129;4038
44;Grand Est;55;3;14;292;Liny-devant-Dun;189;6;195
44;Grand Est;55;3;14;293;Lion-devant-Dun;172;3;175
44;Grand Est;55;1;12;295;Lisle-en-Barrois;31;1;32
44;Grand Est;55;1;01;296;L'Isle-en-Rigault;475;7;482
44;Grand Est;55;3;11;297;Lissey;113;1;114
44;Grand Est;55;1;15;298;Loisey;294;9;303
44;Grand Est;55;3;05;299;Loison;118;2;120
44;Grand Est;55;1;10;300;Longeaux;221;6;227
44;Grand Est;55;2;08;301;Longchamps-sur-Aire;119;8;127
44;Grand Est;55;1;02;302;Longeville-en-Barrois;1114;31;1145
44;Grand Est;55;2;13;303;Loupmont;72;4;76
44;Grand Est;55;1;12;304;Louppy-le-Château;160;6;166
44;Grand Est;55;3;11;306;Louppy-sur-Loison;113;1;114
44;Grand Est;55;3;04;307;Louvemont-Côte-du-Poivre;0;0;0
44;Grand Est;55;3;14;310;Luzy-Saint-Martin;112;4;116
44;Grand Est;55;3;09;311;Maizeray;27;1;28
44;Grand Est;55;2;13;312;Maizey;167;6;173
44;Grand Est;55;3;06;313;Malancourt;68;2;70
44;Grand Est;55;1;10;315;Mandres-en-Barrois;117;4;121
44;Grand Est;55;3;05;316;Mangiennes;406;7;413
44;Grand Est;55;3;09;317;Manheulles;144;7;151
44;Grand Est;55;3;09;320;Marchéville-en-Woëvre;66;2;68
44;Grand Est;55;3;06;321;Marre;168;2;170
44;Grand Est;55;2;15;322;Marson-sur-Barboure;50;1;51
44;Grand Est;55;3;14;323;Martincourt-sur-Meuse;69;1;70
44;Grand Est;55;3;11;324;Marville;517;13;530
44;Grand Est;55;3;04;325;Maucourt-sur-Orne;50;1;51
44;Grand Est;55;1;01;326;Maulan;108;3;111
44;Grand Est;55;2;10;327;Mauvages;248;2;250
44;Grand Est;55;2;15;328;Maxey-sur-Vaise;285;5;290
44;Grand Est;55;2;07;329;Mécrin;211;5;216
44;Grand Est;55;2;15;330;Méligny-le-Grand;90;2;92
44;Grand Est;55;2;15;331;Méligny-le-Petit;77;1;78
44;Grand Est;55;1;10;332;Menaucourt;238;1;239
44;Grand Est;55;2;08;333;Ménil-aux-Bois;43;1;44
44;Grand Est;55;2;15;334;Ménil-la-Horgne;164;1;165
44;Grand Est;55;1;10;335;Ménil-sur-Saulx;250;8;258
44;Grand Est;55;3;11;336;Merles-sur-Loison;151;2;153
44;Grand Est;55;3;14;338;Milly-sur-Bradon;148;4;152
44;Grand Est;55;3;04;339;Mogeville;75;1;76
44;Grand Est;55;1;12;340;Mognéville;371;8;379
44;Grand Est;55;3;11;341;Moirey-Flabas-Crépion;122;4;126
44;Grand Est;55;3;06;343;Montblainville;58;2;60
44;Grand Est;55;2;15;344;Montbras;22;0;22
44;Grand Est;55;3;14;345;Mont-devant-Sassey;101;2;103
44;Grand Est;55;3;06;346;Montfaucon-d'Argonne;293;7;300
44;Grand Est;55;3;08;347;Les Monthairons;339;3;342
44;Grand Est;55;1;10;348;Montiers-sur-Saulx;368;3;371
44;Grand Est;55;3;14;349;Montigny-devant-Sassey;118;0;118
44;Grand Est;55;2;15;350;Montigny-lès-Vaucouleurs;76;0;76
44;Grand Est;55;3;11;351;Montmédy;2040;84;2124
44;Grand Est;55;1;01;352;Montplonne;143;17;160
44;Grand Est;55;2;13;353;Montsec;79;1;80
44;Grand Est;55;3;06;355;Montzéville;155;1;156
44;Grand Est;55;3;04;356;Moranville;104;1;105
44;Grand Est;55;3;05;357;Morgemoulin;108;3;111
44;Grand Est;55;1;10;358;Chanteraine;188;4;192
44;Grand Est;55;1;10;359;Morley;206;2;208
44;Grand Est;55;3;09;360;Mouilly;109;1;110
44;Grand Est;55;3;04;361;Moulainville;128;0;128
44;Grand Est;55;3;14;362;Moulins-Saint-Hubert;181;3;184
44;Grand Est;55;3;09;363;Moulotte;90;1;91
44;Grand Est;55;3;14;364;Mouzay;660;28;688
44;Grand Est;55;3;14;365;Murvaux;141;3;144
44;Grand Est;55;1;12;366;Val-d'Ornain;1008;34;1042
44;Grand Est;55;3;05;367;Muzeray;137;4;141
44;Grand Est;55;2;15;368;Naives-en-Blois;148;7;155
44;Grand Est;55;1;02;369;Naives-Rosières;805;16;821
44;Grand Est;55;1;10;370;Naix-aux-Forges;227;2;229
44;Grand Est;55;2;15;371;Nançois-le-Grand;76;3;79
44;Grand Est;55;1;15;372;Nançois-sur-Ornain;367;9;376
44;Grand Est;55;1;01;373;Nant-le-Grand;82;5;87
44;Grand Est;55;1;01;374;Nant-le-Petit;75;1;76
44;Grand Est;55;3;06;375;Nantillois;63;1;64
44;Grand Est;55;1;10;376;Nantois;86;4;90
44;Grand Est;55;3;14;377;Nepvant;93;1;94
44;Grand Est;55;1;12;378;Nettancourt;241;2;243
44;Grand Est;55;3;06;379;Le Neufour;66;2;68
44;Grand Est;55;2;08;380;Neuville-en-Verdunois;52;1;53
44;Grand Est;55;2;15;381;Neuville-lès-Vaucouleurs;165;0;165
44;Grand Est;55;1;12;382;Neuville-sur-Ornain;366;8;374
44;Grand Est;55;3;06;383;Neuvilly-en-Argonne;216;1;217
44;Grand Est;55;2;08;384;Nicey-sur-Aire;126;4;130
44;Grand Est;55;3;08;385;Nixéville-Blercourt;493;16;509
44;Grand Est;55;2;13;386;Nonsard-Lamarche;221;3;224
44;Grand Est;55;3;05;387;Nouillonpont;241;4;245
44;Grand Est;55;1;12;388;Noyers-Auzécourt;276;4;280
44;Grand Est;55;1;08;389;Nubécourt;247;6;253
44;Grand Est;55;3;14;391;Olizy-sur-Chiers;198;6;204
44;Grand Est;55;3;04;394;Ornes;7;0;7
44;Grand Est;55;3;08;395;Osches;59;3;62
44;Grand Est;55;2;15;396;Ourches-sur-Meuse;224;4;228
44;Grand Est;55;2;15;397;Pagny-la-Blanche-Côte;234;4;238
44;Grand Est;55;2;15;398;Pagny-sur-Meuse;1006;16;1022
44;Grand Est;55;3;09;399;Pareid;115;4;119
44;Grand Est;55;3;09;400;Parfondrupt;43;0;43
44;Grand Est;55;2;13;401;Les Paroches;415;10;425
44;Grand Est;55;3;11;403;Peuvillers;63;1;64
44;Grand Est;55;2;08;404;Pierrefitte-sur-Aire;319;6;325
44;Grand Est;55;3;05;405;Pillon;252;4;256
44;Grand Est;55;3;09;406;Pintheville;110;4;114
44;Grand Est;55;2;07;407;Pont-sur-Meuse;129;6;135
44;Grand Est;55;3;14;408;Pouilly-sur-Meuse;171;8;179
44;Grand Est;55;1;08;409;Pretz-en-Argonne;64;2;66
44;Grand Est;55;3;11;410;Quincy-Landzécourt;133;5;138
44;Grand Est;55;3;08;411;Rambluzin-et-Benoite-Vaux;99;1;100
44;Grand Est;55;2;13;412;Rambucourt;185;5;190
44;Grand Est;55;1;12;414;Rancourt-sur-Ornain;180;1;181
44;Grand Est;55;2;13;415;Ranzières;87;1;88
44;Grand Est;55;3;06;416;Rarécourt;225;8;233
44;Grand Est;55;3;06;419;Récicourt;157;2;159
44;Grand Est;55;3;08;420;Récourt-le-Creux;77;0;77
44;Grand Est;55;2;15;421;Reffroy;75;5;80
44;Grand Est;55;3;06;422;Regnéville-sur-Meuse;51;1;52
44;Grand Est;55;1;12;423;Rembercourt-Sommaisne;318;8;326
44;Grand Est;55;1;12;424;Remennecourt;47;1;48
44;Grand Est;55;3;11;425;Remoiville;133;0;133
44;Grand Est;55;1;02;426;Resson;384;13;397
44;Grand Est;55;1;12;427;Revigny-sur-Ornain;2794;44;2838
44;Grand Est;55;3;11;428;Réville-aux-Bois;126;1;127
44;Grand Est;55;3;09;429;Riaville;49;0;49
44;Grand Est;55;1;10;430;Ribeaucourt;67;1;68
44;Grand Est;55;2;13;431;Richecourt;57;0;57
44;Grand Est;55;2;15;433;Rigny-la-Salle;362;5;367
44;Grand Est;55;2;15;434;Rigny-Saint-Martin;49;2;51
44;Grand Est;55;1;12;435;Robert-Espagne;771;23;794
44;Grand Est;55;2;10;436;Les Roises;28;0;28
44;Grand Est;55;3;11;437;Romagne-sous-les-Côtes;122;3;125
44;Grand Est;55;3;06;438;Romagne-sous-Montfaucon;186;4;190
44;Grand Est;55;3;09;439;Ronvaux;95;7;102
44;Grand Est;55;1;02;442;Raival;245;5;250
44;Grand Est;55;3;05;443;Rouvres-en-Woëvre;591;6;597
44;Grand Est;55;2;13;444;Rouvrois-sur-Meuse;210;2;212
44;Grand Est;55;3;05;445;Rouvrois-sur-Othain;190;8;198
44;Grand Est;55;1;02;446;Rumont;86;4;90
44;Grand Est;55;1;01;447;Rupt-aux-Nonains;370;7;377
44;Grand Est;55;2;08;448;Rupt-devant-Saint-Mihiel;44;1;45
44;Grand Est;55;3;08;449;Rupt-en-Woëvre;284;4;288
44;Grand Est;55;3;11;450;Rupt-sur-Othain;45;2;47
44;Grand Est;55;1;10;452;Saint-Amand-sur-Ornain;53;0;53
44;Grand Est;55;3;08;453;Saint-André-en-Barrois;64;2;66
44;Grand Est;55;2;15;454;Saint-Aubin-sur-Aire;169;9;178
44;Grand Est;55;2;15;456;Saint-Germain-sur-Meuse;225;6;231
44;Grand Est;55;3;09;457;Saint-Hilaire-en-Woëvre;185;6;191
44;Grand Est;55;3;09;458;Saint-Jean-lès-Buzy;380;0;380
44;Grand Est;55;2;10;459;Saint-Joire;237;2;239
44;Grand Est;55;2;07;460;Saint-Julien-sous-les-Côtes;140;2;142
44;Grand Est;55;3;05;461;Saint-Laurent-sur-Othain;455;15;470
44;Grand Est;55;2;13;462;Saint-Maurice-sous-les-Côtes;335;11;346
44;Grand Est;55;2;13;463;Saint-Mihiel;4000;70;4070
44;Grand Est;55;3;05;464;Saint-Pierrevillers;153;2;155
44;Grand Est;55;3;09;465;Saint-Remy-la-Calonne;102;0;102
44;Grand Est;55;1;15;466;Salmagne;290;4;294
44;Grand Est;55;2;08;467;Sampigny;696;13;709
44;Grand Est;55;3;04;468;Samogneux;99;0;99
44;Grand Est;55;3;14;469;Sassey-sur-Meuse;91;0;91
44;Grand Est;55;1;01;470;Saudrupt;193;2;195
44;Grand Est;55;3;14;471;Saulmory-Villefranche;81;1;82
44;Grand Est;55;2;15;472;Saulvaux;116;5;121
44;Grand Est;55;3;09;473;Saulx-lès-Champlon;111;12;123
44;Grand Est;55;2;15;474;Sauvigny;226;4;230
44;Grand Est;55;2;15;475;Sauvoy;64;1;65
44;Grand Est;55;1;02;476;Savonnières-devant-Bar;469;13;482
44;Grand Est;55;1;01;477;Savonnières-en-Perthois;402;15;417
44;Grand Est;55;1;02;479;Seigneulles;160;3;163
44;Grand Est;55;3;05;481;Senon;324;5;329
44;Grand Est;55;3;08;482;Senoncourt-les-Maujouy;103;2;105
44;Grand Est;55;3;06;484;Septsarges;47;0;47
44;Grand Est;55;2;15;485;Sepvigny;70;1;71
44;Grand Est;55;2;13;487;Seuzey;88;2;90
44;Grand Est;55;1;01;488;Silmont;146;5;151
44;Grand Est;55;3;16;489;Sivry-la-Perche;276;5;281
44;Grand Est;55;3;06;490;Sivry-sur-Meuse;333;5;338
44;Grand Est;55;3;08;492;Sommedieue;988;11;999
44;Grand Est;55;1;12;493;Sommeilles;183;6;189
44;Grand Est;55;1;01;494;Sommelonne;419;20;439
44;Grand Est;55;3;05;495;Sorbey;242;1;243
44;Grand Est;55;2;15;496;Sorcy-Saint-Martin;1047;27;1074
44;Grand Est;55;3;08;497;Les Souhesmes-Rampont;319;3;322
44;Grand Est;55;3;08;498;Souilly;452;5;457
44;Grand Est;55;3;05;500;Spincourt;825;12;837
44;Grand Est;55;1;01;501;Stainville;382;10;392
44;Grand Est;55;3;14;502;Stenay;2492;131;2623
44;Grand Est;55;2;15;503;Taillancourt;124;2;126
44;Grand Est;55;1;01;504;Tannois;405;5;410
44;Grand Est;55;3;04;505;Thierville-sur-Meuse;3167;96;3263
44;Grand Est;55;2;08;506;Thillombois;31;0;31
44;Grand Est;55;3;09;507;Thillot;214;2;216
44;Grand Est;55;3;11;508;Thonne-la-Long;351;13;364
44;Grand Est;55;3;11;509;Thonne-le-Thil;276;5;281
44;Grand Est;55;3;11;510;Thonne-les-Près;129;3;132
44;Grand Est;55;3;11;511;Thonnelle;118;3;121
44;Grand Est;55;3;08;512;Tilly-sur-Meuse;279;4;283
44;Grand Est;55;1;02;514;Trémont-sur-Saulx;605;10;615
44;Grand Est;55;3;09;515;Trésauvaux;68;1;69
44;Grand Est;55;2;10;516;Tréveray;552;7;559
44;Grand Est;55;1;08;517;Seuil-d'Argonne;510;6;516
44;Grand Est;55;2;15;518;Cousances-lès-Triconville;145;2;147
44;Grand Est;55;1;01;519;Tronville-en-Barrois;1343;17;1360
44;Grand Est;55;2;15;520;Troussey;477;11;488
44;Grand Est;55;2;13;521;Troyon;235;1;236
44;Grand Est;55;2;15;522;Ugny-sur-Meuse;110;3;113
44;Grand Est;55;3;04;523;Vacherauville;188;4;192
44;Grand Est;55;3;08;525;Vadelaincourt;75;1;76
44;Grand Est;55;2;07;526;Vadonville;263;4;267
44;Grand Est;55;3;06;527;Varennes-en-Argonne;635;11;646
44;Grand Est;55;2;13;528;Varnéville;50;0;50
44;Grand Est;55;2;13;530;Valbois;92;1;93
44;Grand Est;55;1;12;531;Vassincourt;283;21;304
44;Grand Est;55;1;12;532;Vaubecourt;313;5;318
44;Grand Est;55;2;15;533;Vaucouleurs;1929;24;1953
44;Grand Est;55;2;10;534;Vaudeville-le-Haut;53;0;53
44;Grand Est;55;3;05;535;Vaudoncourt;90;0;90
44;Grand Est;55;3;06;536;Vauquois;19;2;21
44;Grand Est;55;3;04;537;Douaumont-Vaux;79;0;79
44;Grand Est;55;2;13;540;Vaux-lès-Palameix;59;3;62
44;Grand Est;55;1;03;541;Vavincourt;527;9;536
44;Grand Est;55;1;01;543;Velaines;925;18;943
44;Grand Est;55;3;11;544;Velosnes;148;1;149
44;Grand Est;55;3;99;545;Verdun;16877;969;17846
44;Grand Est;55;3;11;546;Verneuil-Grand;207;8;215
44;Grand Est;55;3;11;547;Verneuil-Petit;114;4;118
44;Grand Est;55;3;06;549;Véry;89;1;90
44;Grand Est;55;2;13;551;Vigneulles-lès-Hattonchâtel;1566;92;1658
44;Grand Est;55;3;11;552;Vigneul-sous-Montmédy;81;4;85
44;Grand Est;55;2;07;553;Vignot;1299;20;1319
44;Grand Est;55;3;11;554;Villécloye;268;14;282
44;Grand Est;55;2;08;555;Ville-devant-Belrain;32;1;33
44;Grand Est;55;3;11;556;Ville-devant-Chaumont;49;1;50
44;Grand Est;55;3;09;557;Ville-en-Woëvre;124;0;124
44;Grand Est;55;2;15;559;Villeroy-sur-Méholle;52;2;54
44;Grand Est;55;1;12;560;Villers-aux-Vents;130;4;134
44;Grand Est;55;3;14;561;Villers-devant-Dun;51;1;52
44;Grand Est;55;1;10;562;Villers-le-Sec;126;0;126
44;Grand Est;55;3;05;563;Villers-lès-Mangiennes;77;2;79
44;Grand Est;55;3;09;565;Villers-sous-Pareid;77;3;80
44;Grand Est;55;3;08;566;Villers-sur-Meuse;298;6;304
44;Grand Est;55;3;08;567;Ville-sur-Cousances;141;3;144
44;Grand Est;55;1;01;568;Ville-sur-Saulx;277;5;282
44;Grand Est;55;1;12;569;Villotte-devant-Louppy;165;5;170
44;Grand Est;55;2;08;570;Villotte-sur-Aire;212;7;219
44;Grand Est;55;3;06;571;Vilosnes-Haraumont;235;5;240
44;Grand Est;55;3;11;572;Vittarville;89;1;90
44;Grand Est;55;2;15;573;Void-Vacon;1621;29;1650
44;Grand Est;55;2;10;574;Vouthon-Bas;43;2;45
44;Grand Est;55;2;10;575;Vouthon-Haut;89;0;89
44;Grand Est;55;1;08;577;Waly;57;2;59
44;Grand Est;55;3;09;578;Warcq;186;7;193
44;Grand Est;55;3;09;579;Watronville;101;0;101
44;Grand Est;55;3;11;580;Wavrille;50;3;53
44;Grand Est;55;1;15;581;Willeroncourt;105;2;107
44;Grand Est;55;3;14;582;Wiseppe;89;1;90
44;Grand Est;55;3;09;583;Woël;205;3;208
44;Grand Est;55;2;08;584;Woimbey;126;2;128
44;Grand Est;55;2;13;586;Xivray-et-Marvoisin;111;3;114
53;Bretagne;56;3;04;001;Allaire;3882;126;4008
53;Bretagne;56;3;11;002;Ambon;2042;53;2095
53;Bretagne;56;3;20;003;Arradon;5549;150;5699
53;Bretagne;56;3;11;004;Arzal;1699;32;1731
53;Bretagne;56;3;18;005;Arzon;2264;41;2305
53;Bretagne;56;3;04;006;Augan;1522;31;1553
53;Bretagne;56;1;01;007;Auray;14155;416;14571
53;Bretagne;56;3;20;008;Baden;4418;127;4545
53;Bretagne;56;1;17;009;Bangor;1018;20;1038
53;Bretagne;56;2;15;010;Baud;6242;185;6427
53;Bretagne;56;3;04;011;Béganne;1390;26;1416
53;Bretagne;56;3;04;012;Beignon;1955;43;1998
53;Bretagne;56;1;17;013;Belz;3784;61;3845
53;Bretagne;56;2;02;014;Berné;1545;134;1679
53;Bretagne;56;3;16;015;Berric;2095;31;2126
53;Bretagne;56;2;10;017;Bignan;2758;63;2821
53;Bretagne;56;3;11;018;Billiers;1037;26;1063
53;Bretagne;56;2;10;019;Billio;332;10;342
53;Bretagne;56;3;10;020;Bohal;852;13;865
53;Bretagne;56;1;14;021;Brandérion;1466;26;1492
53;Bretagne;56;3;03;022;Brandivy;1341;36;1377
53;Bretagne;56;1;14;023;Brech;6792;286;7078
53;Bretagne;56;2;03;024;Bréhan;2291;33;2324
53;Bretagne;56;2;13;025;Brignac;194;4;198
53;Bretagne;56;1;05;026;Bubry;2289;57;2346
53;Bretagne;56;2;10;027;Buléon;542;7;549
53;Bretagne;56;3;16;028;Caden;1580;36;1616
53;Bretagne;56;1;05;029;Calan;1247;25;1272
53;Bretagne;56;3;11;030;Camoël;1089;15;1104
53;Bretagne;56;1;14;031;Camors;3083;61;3144
53;Bretagne;56;2;13;032;Campénéac;1898;53;1951
53;Bretagne;56;3;04;033;Carentoir;3062;58;3120
53;Bretagne;56;1;17;034;Carnac;4231;106;4337
53;Bretagne;56;3;10;035;Caro;1143;29;1172
53;Bretagne;56;1;07;036;Caudan;7091;207;7298
53;Bretagne;56;2;03;039;La Chapelle-Neuve;984;22;1006
53;Bretagne;56;1;05;040;Cléguer;3310;61;3371
53;Bretagne;56;2;02;041;Cléguérec;2835;88;2923
53;Bretagne;56;3;03;042;Colpo;2216;46;2262
53;Bretagne;56;2;13;043;Concoret;750;17;767
53;Bretagne;56;3;04;044;Cournon;798;29;827
53;Bretagne;56;3;16;045;Le Cours;674;10;684
53;Bretagne;56;1;01;046;Crach;3421;80;3501
53;Bretagne;56;2;03;047;Crédin;1501;45;1546
53;Bretagne;56;2;02;048;Le Croisty;721;14;735
53;Bretagne;56;2;13;050;La Croix-Helléan;876;32;908
53;Bretagne;56;2;13;051;Cruguel;656;9;665
53;Bretagne;56;3;11;052;Damgan;1908;29;1937
53;Bretagne;56;3;16;053;Elven;6387;127;6514
53;Bretagne;56;1;17;054;Erdeven;3958;95;4053
53;Bretagne;56;1;17;055;Étel;2053;180;2233
53;Bretagne;56;2;13;056;Évriguet;205;4;209
53;Bretagne;56;2;02;057;Le Faouët;2800;56;2856
53;Bretagne;56;3;11;058;Férel;3367;66;3433
53;Bretagne;56;3;04;060;Les Fougerêts;948;34;982
53;Bretagne;56;3;04;061;La Gacilly;3974;105;4079
53;Bretagne;56;1;14;062;Gâvres;679;19;698
53;Bretagne;56;1;05;063;Gestel;2609;89;2698
53;Bretagne;56;2;13;065;Gourhel;751;23;774
53;Bretagne;56;2;02;066;Gourin;3783;152;3935
53;Bretagne;56;3;03;067;Grand-Champ;5612;142;5754
53;Bretagne;56;2;13;068;La Grée-Saint-Laurent;315;3;318
53;Bretagne;56;1;09;069;Groix;2256;47;2303
53;Bretagne;56;2;13;070;Guégon;2261;52;2313
53;Bretagne;56;2;10;071;Guéhenno;796;12;808
53;Bretagne;56;2;15;072;Gueltas;511;10;521
53;Bretagne;56;2;02;073;Guémené-sur-Scorff;1059;15;1074
53;Bretagne;56;2;15;074;Guénin;1848;38;1886
53;Bretagne;56;3;04;075;Guer;6079;299;6378
53;Bretagne;56;2;15;076;Guern;1314;35;1349
53;Bretagne;56;3;11;077;Le Guerno;992;25;1017
53;Bretagne;56;1;05;078;Guidel;11743;294;12037
53;Bretagne;56;2;13;079;Guillac;1364;34;1398
53;Bretagne;56;2;13;080;Guilliers;1301;143;1444
53;Bretagne;56;2;02;081;Guiscriff;2081;57;2138
53;Bretagne;56;2;13;082;Helléan;383;7;390
53;Bretagne;56;1;06;083;Hennebont;15873;427;16300
53;Bretagne;56;3;18;084;Le Hézo;856;16;872
53;Bretagne;56;1;17;085;Hœdic;97;2;99
53;Bretagne;56;1;17;086;Île-d'Houat;216;6;222
53;Bretagne;56;3;20;087;Île-aux-Moines;627;18;645
53;Bretagne;56;3;20;088;Île-d'Arz;257;6;263
53;Bretagne;56;1;05;089;Inguiniel;2193;54;2247
53;Bretagne;56;1;05;090;Inzinzac-Lochrist;6535;134;6669
53;Bretagne;56;2;13;091;Josselin;2511;102;2613
53;Bretagne;56;2;15;092;Kerfourn;829;15;844
53;Bretagne;56;2;02;093;Kergrist;719;23;742
53;Bretagne;56;1;06;094;Kervignac;6858;216;7074
53;Bretagne;56;1;14;096;Landaul;2429;50;2479
53;Bretagne;56;1;14;097;Landévant;4013;71;4084
53;Bretagne;56;1;07;098;Lanester;22940;481;23421
53;Bretagne;56;2;02;099;Langoëlan;388;5;393
53;Bretagne;56;2;02;100;Langonnet;1708;52;1760
53;Bretagne;56;1;06;101;Languidic;8047;157;8204
53;Bretagne;56;2;13;102;Forges de Lanouée;2148;51;2199
53;Bretagne;56;2;13;103;Lantillac;296;4;300
53;Bretagne;56;1;05;104;Lanvaudan;804;10;814
53;Bretagne;56;2;02;105;Lanvénégen;1138;22;1160
53;Bretagne;56;3;20;106;Larmor-Baden;869;20;889
53;Bretagne;56;1;12;107;Larmor-Plage;8277;245;8522
53;Bretagne;56;3;16;108;Larré;1081;17;1098
53;Bretagne;56;3;16;109;Lauzach;1177;27;1204
53;Bretagne;56;2;02;110;Lignol;844;20;864
53;Bretagne;56;3;16;111;Limerzel;1311;23;1334
53;Bretagne;56;3;10;112;Lizio;740;15;755
53;Bretagne;56;2;02;113;Locmalo;903;21;924
53;Bretagne;56;1;17;114;Locmaria;962;30;992
53;Bretagne;56;3;03;115;Locmaria-Grand-Champ;1742;40;1782
53;Bretagne;56;1;01;116;Locmariaquer;1545;43;1588
53;Bretagne;56;2;03;117;Locminé;4578;237;4815
53;Bretagne;56;1;06;118;Locmiquélic;4056;111;4167
53;Bretagne;56;1;17;119;Locoal-Mendon;3486;80;3566
53;Bretagne;56;3;03;120;Locqueltas;1919;42;1961
53;Bretagne;56;1;98;121;Lorient;57412;1469;58881
53;Bretagne;56;2;13;122;Loyat;1667;42;1709
53;Bretagne;56;3;16;123;Malansac;2198;44;2242
53;Bretagne;56;3;10;124;Malestroit;2483;81;2564
53;Bretagne;56;2;02;125;Malguénac;1840;64;1904
53;Bretagne;56;3;11;126;Marzan;2468;30;2498
53;Bretagne;56;2;13;127;Mauron;3176;71;3247
53;Bretagne;56;2;15;128;Melrand;1520;24;1544
53;Bretagne;56;2;13;129;Ménéac;1512;33;1545
53;Bretagne;56;1;14;130;Merlevenez;3215;76;3291
53;Bretagne;56;2;02;131;Meslan;1438;29;1467
53;Bretagne;56;3;21;132;Meucon;2269;54;2323
53;Bretagne;56;3;10;133;Missiriac;1167;34;1201
53;Bretagne;56;2;13;134;Mohon;982;11;993
53;Bretagne;56;3;16;135;Molac;1622;31;1653
53;Bretagne;56;3;04;136;Monteneuf;755;15;770
53;Bretagne;56;3;21;137;Monterblanc;3311;78;3389
53;Bretagne;56;2;13;139;Montertelot;362;10;372
53;Bretagne;56;2;10;140;Moréac;3703;95;3798
53;Bretagne;56;2;03;141;Moustoir-Ac;1728;37;1765
53;Bretagne;56;3;11;143;Muzillac;5054;127;5181
53;Bretagne;56;2;03;144;Évellys;3446;79;3525
53;Bretagne;56;2;13;145;Néant-sur-Yvel;1119;27;1146
53;Bretagne;56;2;02;146;Neulliac;1419;35;1454
53;Bretagne;56;3;11;147;Nivillac;4746;98;4844
53;Bretagne;56;1;14;148;Nostang;1607;33;1640
53;Bretagne;56;3;11;149;Noyal-Muzillac;2520;51;2571
53;Bretagne;56;2;15;151;Noyal-Pontivy;3596;118;3714
53;Bretagne;56;1;17;152;Le Palais;2536;53;2589
53;Bretagne;56;3;11;153;Péaule;2718;52;2770
53;Bretagne;56;3;04;154;Peillac;1840;49;1889
53;Bretagne;56;3;11;155;Pénestin;2023;28;2051
53;Bretagne;56;2;02;156;Persquen;351;6;357
53;Bretagne;56;3;03;157;Plaudren;1957;54;2011
53;Bretagne;56;3;20;158;Plescop;6182;185;6367
53;Bretagne;56;3;10;159;Pleucadeuc;1819;43;1862
53;Bretagne;56;2;03;160;Pleugriffet;1292;18;1310
53;Bretagne;56;1;17;161;Ploemel;3032;90;3122
53;Bretagne;56;1;12;162;Ploemeur;18537;648;19185
53;Bretagne;56;2;02;163;Ploërdut;1228;24;1252
53;Bretagne;56;3;20;164;Ploeren;6669;224;6893
53;Bretagne;56;2;13;165;Ploërmel;9785;563;10348
53;Bretagne;56;1;05;166;Plouay;5789;141;5930
53;Bretagne;56;3;20;167;Plougoumelen;2599;85;2684
53;Bretagne;56;1;17;168;Plouharnel;2240;52;2292
53;Bretagne;56;1;14;169;Plouhinec;5365;122;5487
53;Bretagne;56;2;02;170;Plouray;1046;29;1075
53;Bretagne;56;3;16;171;Pluherlin;1520;27;1547
53;Bretagne;56;2;10;172;Plumelec;2686;67;2753
53;Bretagne;56;2;15;173;Pluméliau-Bieuzy;4341;89;4430
53;Bretagne;56;2;03;174;Plumelin;2753;70;2823
53;Bretagne;56;1;01;175;Plumergat;4190;96;4286
53;Bretagne;56;1;01;176;Pluneret;6023;143;6166
53;Bretagne;56;1;14;177;Pluvigner;7657;141;7798
53;Bretagne;56;2;15;178;Pontivy;15092;938;16030
53;Bretagne;56;1;05;179;Pont-Scorff;3897;88;3985
53;Bretagne;56;3;04;180;Porcaro;738;17;755
53;Bretagne;56;1;06;181;Port-Louis;2672;102;2774
53;Bretagne;56;2;02;182;Priziac;965;180;1145
53;Bretagne;56;3;16;184;Questembert;7937;282;8219
53;Bretagne;56;1;12;185;Quéven;8816;235;9051
53;Bretagne;56;1;17;186;Quiberon;4659;97;4756
53;Bretagne;56;1;05;188;Quistinic;1421;21;1442
53;Bretagne;56;2;03;189;Radenac;1067;19;1086
53;Bretagne;56;2;03;190;Réguiny;1963;54;2017
53;Bretagne;56;3;04;191;Réminiac;425;11;436
53;Bretagne;56;1;06;193;Riantec;5806;140;5946
53;Bretagne;56;3;04;194;Rieux;2862;74;2936
53;Bretagne;56;3;11;195;La Roche-Bernard;694;13;707
53;Bretagne;56;3;16;196;Rochefort-en-Terre;637;13;650
53;Bretagne;56;2;10;197;Val d'Oust;2782;78;2860
53;Bretagne;56;2;03;198;Rohan;1605;37;1642
53;Bretagne;56;2;02;199;Roudouallec;702;14;716
53;Bretagne;56;3;10;200;Ruffiac;1378;34;1412
53;Bretagne;56;2;02;201;Le Saint;590;7;597
53;Bretagne;56;3;10;202;Saint-Abraham;529;14;543
53;Bretagne;56;2;02;203;Saint-Aignan;629;14;643
53;Bretagne;56;2;10;204;Saint-Allouestre;630;8;638
53;Bretagne;56;3;18;205;Saint-Armel;877;18;895
53;Bretagne;56;3;21;206;Saint-Avé;11912;283;12195
53;Bretagne;56;2;15;207;Saint-Barthélemy;1153;18;1171
53;Bretagne;56;2;13;208;Saint-Brieuc-de-Mauron;302;8;310
53;Bretagne;56;2;02;209;Sainte-Brigitte;180;7;187
53;Bretagne;56;2;02;210;Saint-Caradec-Trégomel;479;6;485
53;Bretagne;56;3;10;211;Saint-Congard;798;17;815
53;Bretagne;56;3;11;212;Saint-Dolay;2570;50;2620
53;Bretagne;56;2;15;213;Saint-Gérand-Croixanvec;1316;32;1348
53;Bretagne;56;3;18;214;Saint-Gildas-de-Rhuys;1552;22;1574
53;Bretagne;56;2;15;215;Saint-Gonnery;1100;24;1124
53;Bretagne;56;3;04;216;Saint-Gorgon;399;4;403
53;Bretagne;56;3;16;218;Saint-Gravé;710;11;721
53;Bretagne;56;3;10;219;Saint-Guyomard;1407;23;1430
53;Bretagne;56;1;14;220;Sainte-Hélène;1272;31;1303
53;Bretagne;56;3;04;221;Saint-Jacut-les-Pins;1742;83;1825
53;Bretagne;56;2;10;222;Saint-Jean-Brévelay;2865;136;3001
53;Bretagne;56;3;04;223;Saint-Jean-la-Poterie;1454;58;1512
53;Bretagne;56;3;10;224;Saint-Laurent-sur-Oust;389;10;399
53;Bretagne;56;2;13;225;Saint-Léry;208;8;216
53;Bretagne;56;3;04;226;Saint-Malo-de-Beignon;543;23;566
53;Bretagne;56;2;13;227;Saint-Malo-des-Trois-Fontaines;596;15;611
53;Bretagne;56;3;10;228;Saint-Marcel;1113;48;1161
53;Bretagne;56;3;04;229;Saint-Martin-sur-Oust;1299;17;1316
53;Bretagne;56;3;10;230;Saint-Nicolas-du-Tertre;463;11;474
53;Bretagne;56;3;21;231;Saint-Nolff;3892;127;4019
53;Bretagne;56;3;04;232;Saint-Perreux;1066;42;1108
53;Bretagne;56;1;01;233;Saint-Philibert;1524;44;1568
53;Bretagne;56;1;17;234;Saint-Pierre-Quiberon;2145;48;2193
53;Bretagne;56;2;13;236;Saint-Servant;802;18;820
53;Bretagne;56;2;15;237;Saint-Thuriau;1869;76;1945
53;Bretagne;56;2;02;238;Saint-Tugdual;369;12;381
53;Bretagne;56;3;04;239;Saint-Vincent-sur-Oust;1584;42;1626
53;Bretagne;56;3;18;240;Sarzeau;8866;179;9045
53;Bretagne;56;1;17;241;Sauzon;1012;20;1032
53;Bretagne;56;2;02;242;Séglien;645;18;663
53;Bretagne;56;3;18;243;Séné;8930;259;9189
53;Bretagne;56;3;10;244;Sérent;3172;51;3223
53;Bretagne;56;2;02;245;Silfiac;478;13;491
53;Bretagne;56;2;15;246;Le Sourn;2124;43;2167
53;Bretagne;56;3;16;247;Sulniac;3797;92;3889
53;Bretagne;56;3;18;248;Surzur;4899;101;5000
53;Bretagne;56;2;13;249;Taupont;2259;64;2323
53;Bretagne;56;3;04;250;Théhillac;608;5;613
53;Bretagne;56;3;18;251;Theix-Noyalo;8386;239;8625
53;Bretagne;56;3;18;252;Le Tour-du-Parc;1211;8;1219
53;Bretagne;56;3;04;253;Tréal;640;25;665
53;Bretagne;56;3;16;254;Trédion;1323;22;1345
53;Bretagne;56;3;21;255;Treffléan;2450;57;2507
53;Bretagne;56;2;13;256;Tréhorenteuc;113;0;113
53;Bretagne;56;2;13;257;La Trinité-Porhoët;670;13;683
53;Bretagne;56;1;17;258;La Trinité-sur-Mer;1698;33;1731
53;Bretagne;56;3;18;259;La Trinité-Surzur;1738;22;1760
53;Bretagne;56;3;99;260;Vannes;54017;2001;56018
53;Bretagne;56;3;16;261;La Vraie-Croix;1473;31;1504
53;Bretagne;56;3;20;262;Bono;2567;42;2609
53;Bretagne;56;1;01;263;Sainte-Anne-d'Auray;2802;136;2938
53;Bretagne;56;2;02;264;Kernascléden;395;9;404
44;Grand Est;57;7;14;001;Aboncourt;324;3;327
44;Grand Est;57;5;23;002;Aboncourt-sur-Seille;66;1;67
44;Grand Est;57;5;17;003;Abreschviller;1409;28;1437
44;Grand Est;57;5;23;004;Achain;79;1;80
44;Grand Est;57;6;02;006;Achen;983;28;1011
44;Grand Est;57;3;07;007;Adaincourt;128;4;132
44;Grand Est;57;3;07;008;Adelange;203;7;210
44;Grand Est;57;5;23;009;Ajoncourt;104;1;105
44;Grand Est;57;5;23;010;Alaincourt-la-Côte;158;2;160
44;Grand Est;57;5;23;011;Albestroff;618;19;637
44;Grand Est;57;7;01;012;Algrange;6104;53;6157
44;Grand Est;57;3;25;013;Alsting;2508;50;2558
44;Grand Est;57;3;20;014;Altrippe;369;10;379
44;Grand Est;57;3;19;015;Altviller;561;12;573
44;Grand Est;57;3;04;016;Alzing;392;8;400
44;Grand Est;57;9;18;017;Amanvillers;2087;23;2110
44;Grand Est;57;5;23;018;Amelécourt;126;8;134
44;Grand Est;57;9;18;019;Amnéville;10668;71;10739
44;Grand Est;57;9;07;020;Ancerville;303;3;306
44;Grand Est;57;9;05;021;Ancy-Dornot;1509;29;1538
44;Grand Est;57;7;01;022;Angevillers;1264;28;1292
44;Grand Est;57;9;16;024;Antilly;188;0;188
44;Grand Est;57;3;04;025;Anzeling;511;7;518
44;Grand Est;57;7;04;026;Apach;1071;19;1090
44;Grand Est;57;3;07;027;Arraincourt;123;3;126
44;Grand Est;57;9;16;028;Argancy;1337;39;1376
44;Grand Est;57;3;07;029;Arriance;216;3;219
44;Grand Est;57;9;05;030;Arry;562;3;565
44;Grand Est;57;9;16;031;Ars-Laquenexy;930;17;947
44;Grand Est;57;9;05;032;Ars-sur-Moselle;4695;48;4743
44;Grand Est;57;5;17;033;Arzviller;538;16;554
44;Grand Est;57;5;17;034;Aspach;35;1;36
44;Grand Est;57;5;21;035;Assenoncourt;115;3;118
44;Grand Est;57;5;23;036;Attilloncourt;103;0;103
44;Grand Est;57;9;07;037;Aube;267;5;272
44;Grand Est;57;7;01;038;Audun-le-Tiche;7108;64;7172
44;Grand Est;57;9;05;039;Augny;2158;35;2193
44;Grand Est;57;5;23;040;Aulnois-sur-Seille;289;2;291
44;Grand Est;57;7;01;041;Aumetz;2368;31;2399
44;Grand Est;57;5;21;042;Avricourt;583;11;594
44;Grand Est;57;9;16;043;Ay-sur-Moselle;1517;19;1536
44;Grand Est;57;5;21;044;Azoudange;125;5;130
44;Grand Est;57;5;23;045;Bacourt;110;0;110
44;Grand Est;57;6;02;046;Baerenthal;756;13;769
44;Grand Est;57;3;07;047;Bambiderstroff;1045;13;1058
44;Grand Est;57;3;03;048;Bannay;72;2;74
44;Grand Est;57;9;15;049;Le Ban-Saint-Martin;4604;68;4672
44;Grand Est;57;5;17;050;Barchain;111;2;113
44;Grand Est;57;3;20;051;Baronville;370;4;374
44;Grand Est;57;3;09;052;Barst;573;9;582
44;Grand Est;57;5;23;053;Bassing;107;5;112
44;Grand Est;57;5;23;054;Baudrecourt;184;1;185
44;Grand Est;57;9;16;055;Bazoncourt;537;4;541
44;Grand Est;57;5;21;056;Bébing;190;5;195
44;Grand Est;57;9;07;057;Béchy;604;6;610
44;Grand Est;57;3;25;058;Behren-lès-Forbach;6571;64;6635
44;Grand Est;57;5;23;059;Bellange;53;2;55
44;Grand Est;57;5;23;060;Bénestroff;523;6;529
44;Grand Est;57;3;09;061;Béning-lès-Saint-Avold;1145;28;1173
44;Grand Est;57;7;27;062;Berg-sur-Moselle;433;14;447
44;Grand Est;57;3;20;063;Bérig-Vintrange;216;8;224
44;Grand Est;57;5;17;064;Berling;260;4;264
44;Grand Est;57;5;23;065;Bermering;214;5;219
44;Grand Est;57;5;21;066;Berthelming;512;4;516
44;Grand Est;57;7;14;067;Bertrange;2808;60;2868
44;Grand Est;57;3;04;069;Berviller-en-Moselle;458;7;465
44;Grand Est;57;3;03;070;Bettange;247;2;249
44;Grand Est;57;5;21;071;Bettborn;380;5;385
44;Grand Est;57;7;14;072;Bettelainville;623;8;631
44;Grand Est;57;3;09;073;Betting;863;16;879
44;Grand Est;57;6;02;074;Bettviller;820;17;837
44;Grand Est;57;9;07;075;Beux;294;3;297
44;Grand Est;57;7;27;076;Beyren-lès-Sierck;512;16;528
44;Grand Est;57;5;23;077;Bezange-la-Petite;97;3;100
44;Grand Est;57;3;04;079;Bibiche;448;9;457
44;Grand Est;57;5;21;080;Bickenholtz;83;0;83
44;Grand Est;57;5;23;081;Bidestroff;132;1;133
44;Grand Est;57;3;20;082;Biding;334;7;341
44;Grand Est;57;6;02;083;Bining;1195;22;1217
44;Grand Est;57;5;23;084;Bioncourt;301;2;303
44;Grand Est;57;3;03;085;Bionville-sur-Nied;386;2;388
44;Grand Est;57;5;21;086;Belles-Forêts;232;5;237
44;Grand Est;57;3;03;087;Bisten-en-Lorraine;251;4;255
44;Grand Est;57;3;20;088;Bistroff;310;7;317
44;Grand Est;57;6;02;089;Bitche;4955;101;5056
44;Grand Est;57;5;23;090;Blanche-Église;110;2;112
44;Grand Est;57;6;22;091;Bliesbruck;1007;22;1029
44;Grand Est;57;6;22;092;Blies-Ébersing;616;8;624
44;Grand Est;57;6;22;093;Blies-Guersviller;650;12;662
44;Grand Est;57;3;07;095;Boucheporn;576;10;586
44;Grand Est;57;7;01;096;Boulange;2469;47;2516
44;Grand Est;57;3;03;097;Boulay-Moselle;5565;70;5635
44;Grand Est;57;5;23;098;Bourgaltroff;236;13;249
44;Grand Est;57;5;23;099;Bourdonnay;236;5;241
44;Grand Est;57;5;17;100;Bourscheid;175;6;181
44;Grand Est;57;3;25;101;Bousbach;1228;23;1251
44;Grand Est;57;7;14;102;Bousse;3209;49;3258
44;Grand Est;57;6;02;103;Bousseviller;122;2;124
44;Grand Est;57;7;27;104;Boust;1156;27;1183
44;Grand Est;57;3;20;105;Boustroff;151;1;152
44;Grand Est;57;3;04;106;Bouzonville;3926;75;4001
44;Grand Est;57;5;23;107;Bréhain;106;0;106
44;Grand Est;57;6;02;108;Breidenbach;313;5;318
44;Grand Est;57;7;27;109;Breistroff-la-Grande;792;12;804
44;Grand Est;57;3;04;110;Brettnach;425;2;427
44;Grand Est;57;9;18;111;Bronvaux;518;3;521
44;Grand Est;57;3;03;112;Brouck;83;0;83
44;Grand Est;57;5;17;113;Brouderdorff;971;19;990
44;Grand Est;57;5;17;114;Brouviller;436;16;452
44;Grand Est;57;3;20;115;Brulange;98;4;102
44;Grand Est;57;9;07;116;Buchy;93;1;94
44;Grand Est;57;7;14;117;Buding;581;15;596
44;Grand Est;57;7;14;118;Budling;165;6;171
44;Grand Est;57;5;21;119;Buhl-Lorraine;1199;33;1232
44;Grand Est;57;5;23;120;Burlioncourt;118;3;121
44;Grand Est;57;9;16;121;Burtoncourt;220;5;225
44;Grand Est;57;3;09;122;Cappel;677;12;689
44;Grand Est;57;3;19;123;Carling;3414;42;3456
44;Grand Est;57;7;27;124;Cattenom;2619;34;2653
44;Grand Est;57;9;16;125;Chailly-lès-Ennery;425;7;432
44;Grand Est;57;5;23;126;Chambrey;322;9;331
44;Grand Est;57;9;07;127;Chanville;148;1;149
44;Grand Est;57;9;16;128;Charleville-sous-Bois;309;8;317
44;Grand Est;57;9;16;129;Charly-Oradour;734;23;757
44;Grand Est;57;5;23;130;Château-Bréhain;74;1;75
44;Grand Est;57;3;04;131;Château-Rouge;296;11;307
44;Grand Est;57;5;23;132;Château-Salins;2304;238;2542
44;Grand Est;57;5;23;133;Château-Voué;93;0;93
44;Grand Est;57;9;05;134;Châtel-Saint-Germain;1913;192;2105
44;Grand Est;57;3;04;136;Chémery-les-Deux;573;17;590
44;Grand Est;57;9;07;137;Cheminot;807;14;821
44;Grand Est;57;5;23;138;Chenois;82;3;85
44;Grand Est;57;9;07;139;Chérisey;284;6;290
44;Grand Est;57;9;16;140;Chesny;571;10;581
44;Grand Est;57;5;23;141;Chicourt;89;0;89
44;Grand Est;57;9;16;142;Chieulles;424;8;432
44;Grand Est;57;7;10;143;Clouange;3369;32;3401
44;Grand Est;57;3;08;144;Cocheren;3355;41;3396
44;Grand Est;57;9;16;145;Coincy;325;5;330
44;Grand Est;57;9;05;146;Coin-lès-Cuvry;804;19;823
44;Grand Est;57;9;05;147;Coin-sur-Seille;337;14;351
44;Grand Est;57;9;16;148;Colligny-Maizery;568;11;579
44;Grand Est;57;3;04;149;Colmen;202;4;206
44;Grand Est;57;3;03;150;Condé-Northen;692;9;701
44;Grand Est;57;5;23;151;Conthil;147;2;149
44;Grand Est;57;7;04;152;Contz-les-Bains;514;8;522
44;Grand Est;57;9;05;153;Corny-sur-Moselle;2168;38;2206
44;Grand Est;57;3;03;154;Coume;620;19;639
44;Grand Est;57;9;16;155;Courcelles-Chaussy;2961;325;3286
44;Grand Est;57;9;16;156;Courcelles-sur-Nied;1169;12;1181
44;Grand Est;57;5;23;158;Craincourt;240;5;245
44;Grand Est;57;3;07;159;Créhange;3854;55;3909
44;Grand Est;57;3;03;160;Creutzwald;12772;203;12975
44;Grand Est;57;5;23;161;Cutting;105;1;106
44;Grand Est;57;9;05;162;Cuvry;903;15;918
44;Grand Est;57;5;17;163;Dabo;2384;46;2430
44;Grand Est;57;3;04;165;Dalem;695;9;704
44;Grand Est;57;5;23;166;Dalhain;104;2;106
44;Grand Est;57;3;04;167;Dalstein;376;6;382
44;Grand Est;57;5;17;168;Danne-et-Quatre-Vents;676;16;692
44;Grand Est;57;5;17;169;Dannelbourg;496;16;512
44;Grand Est;57;5;23;171;Delme;1151;13;1164
44;Grand Est;57;3;03;172;Denting;284;1;285
44;Grand Est;57;5;21;173;Desseling;101;3;104
44;Grand Est;57;3;20;174;Destry;101;1;102
44;Grand Est;57;5;21;175;Diane-Capelle;224;7;231
44;Grand Est;57;3;25;176;Diebling;1677;37;1714
44;Grand Est;57;5;23;177;Dieuze;2795;209;3004
44;Grand Est;57;3;20;178;Diffembach-lès-Hellimer;351;4;355
44;Grand Est;57;7;14;179;Distroff;1830;33;1863
44;Grand Est;57;5;21;180;Dolving;342;9;351
44;Grand Est;57;5;23;181;Domnom-lès-Dieuze;84;2;86
44;Grand Est;57;5;23;182;Donjeux;95;1;96
44;Grand Est;57;5;23;183;Donnelay;189;2;191
44;Grand Est;57;3;04;186;Ébersviller;956;11;967
44;Grand Est;57;3;03;187;Éblange;363;7;370
44;Grand Est;57;6;02;188;Éguelshardt;424;104;528
44;Grand Est;57;3;20;189;Eincheville;225;2;227
44;Grand Est;57;3;07;190;Elvange;418;2;420
44;Grand Est;57;7;14;191;Elzange;694;16;710
44;Grand Est;57;6;02;192;Enchenberg;1218;32;1250
44;Grand Est;57;9;16;193;Ennery;2230;26;2256
44;Grand Est;57;7;27;194;Entrange;1229;34;1263
44;Grand Est;57;6;02;195;Epping;562;15;577
44;Grand Est;57;6;02;196;Erching;423;12;435
44;Grand Est;57;6;20;197;Ernestviller;510;8;518
44;Grand Est;57;3;20;198;Erstroff;192;3;195
44;Grand Est;57;7;27;199;Escherange;690;15;705
44;Grand Est;57;9;16;200;Les Étangs;397;10;407
44;Grand Est;57;6;02;201;Etting;720;12;732
44;Grand Est;57;3;25;202;Etzling;1155;17;1172
44;Grand Est;57;7;27;203;Évrange;222;4;226
44;Grand Est;57;9;16;204;Failly;536;10;546
44;Grand Est;57;3;04;205;Falck;2520;33;2553
44;Grand Est;57;7;06;206;Fameck;14829;168;14997
44;Grand Est;57;3;09;207;Farébersviller;5406;47;5453
44;Grand Est;57;3;25;208;Farschviller;1340;34;1374
44;Grand Est;57;3;07;209;Faulquemont;5157;84;5241
44;Grand Est;57;5;21;210;Fénétrange;664;19;683
44;Grand Est;57;9;18;211;Fèves;1204;11;1215
44;Grand Est;57;9;05;212;Féy;731;9;740
44;Grand Est;57;3;04;213;Filstroff;772;13;785
44;Grand Est;57;7;27;214;Fixem;408;7;415
44;Grand Est;57;7;04;215;Flastroff;340;3;343
44;Grand Est;57;5;21;216;Fleisheim;142;5;147
44;Grand Est;57;3;07;217;Flétrange;892;18;910
44;Grand Est;57;9;07;218;Fleury;1287;22;1309
44;Grand Est;57;9;16;219;Flévy;560;6;566
44;Grand Est;57;9;07;220;Flocourt;117;2;119
44;Grand Est;57;7;06;221;Florange;11939;101;12040
44;Grand Est;57;3;25;222;Folkling;1354;39;1393
44;Grand Est;57;3;19;224;Folschviller;3949;70;4019
44;Grand Est;57;5;23;225;Fonteny;140;2;142
44;Grand Est;57;7;01;226;Fontoy;3132;41;3173
44;Grand Est;57;3;08;227;Forbach;21509;288;21797
44;Grand Est;57;5;23;228;Fossieux;191;5;196
44;Grand Est;57;5;21;229;Foulcrey;153;2;155
44;Grand Est;57;3;07;230;Fouligny;194;2;196
44;Grand Est;57;9;23;231;Foville;100;0;100
44;Grand Est;57;5;23;232;Francaltroff;778;12;790
44;Grand Est;57;5;17;233;Fraquelfing;86;1;87
44;Grand Est;57;6;22;234;Frauenberg;599;8;607
44;Grand Est;57;3;04;235;Freistroff;1031;20;1051
44;Grand Est;57;5;23;236;Frémery;88;0;88
44;Grand Est;57;3;20;237;Frémestroff;304;7;311
44;Grand Est;57;5;23;238;Fresnes-en-Saulnois;193;6;199
44;Grand Est;57;3;20;239;Freybouse;432;6;438
44;Grand Est;57;3;09;240;Freyming-Merlebach;12840;112;12952
44;Grand Est;57;5;21;241;Fribourg;165;8;173
44;Grand Est;57;7;10;242;Gandrange;3035;33;3068
44;Grand Est;57;5;17;244;Garrebourg;492;12;504
44;Grand Est;57;7;27;245;Gavisse;570;9;579
44;Grand Est;57;5;23;246;Gelucourt;217;4;221
44;Grand Est;57;5;23;247;Gerbécourt;77;3;80
44;Grand Est;57;5;23;248;Givrycourt;86;2;88
44;Grand Est;57;9;16;249;Glatigny;259;7;266
44;Grand Est;57;6;02;250;Goetzenbruck;1465;40;1505
44;Grand Est;57;9;07;251;Goin;344;2;346
44;Grand Est;57;3;03;252;Gomelange;474;10;484
44;Grand Est;57;5;21;253;Gondrexange;502;6;508
44;Grand Est;57;9;05;254;Gorze;1155;9;1164
44;Grand Est;57;5;21;255;Gosselming;568;23;591
44;Grand Est;57;9;05;256;Gravelotte;821;4;825
44;Grand Est;57;5;23;257;Grémecey;104;1;105
44;Grand Est;57;3;20;258;Gréning;115;1;116
44;Grand Est;57;7;04;259;Grindorff-Bizing;316;10;326
44;Grand Est;57;6;22;260;Grosbliederstroff;3319;52;3371
44;Grand Est;57;6;02;261;Gros-Réderching;1324;30;1354
44;Grand Est;57;3;20;262;Grostenquin;658;7;665
44;Grand Est;57;6;20;263;Grundviller;654;19;673
44;Grand Est;57;6;20;264;Guebenhouse;404;6;410
44;Grand Est;57;5;23;265;Guébestroff;59;3;62
44;Grand Est;57;5;23;266;Guéblange-lès-Dieuze;146;3;149
44;Grand Est;57;6;20;267;Le Val-de-Guéblange;832;12;844
44;Grand Est;57;5;23;268;Guébling;123;1;124
44;Grand Est;57;7;14;269;Guénange;7594;67;7661
44;Grand Est;57;5;23;270;Val-de-Bride;562;6;568
44;Grand Est;57;3;09;271;Guenviller;678;17;695
44;Grand Est;57;5;21;272;Guermange;88;4;92
44;Grand Est;57;3;04;273;Guerstling;385;9;394
44;Grand Est;57;3;03;274;Guerting;863;15;878
44;Grand Est;57;3;20;275;Guessling-Hémering;918;12;930
44;Grand Est;57;3;07;276;Guinglange;335;4;339
44;Grand Est;57;3;03;277;Guinkirchen;147;5;152
44;Grand Est;57;5;23;278;Guinzeling;65;0;65
44;Grand Est;57;5;17;280;Guntzviller;362;20;382
44;Grand Est;57;5;23;281;Haboudange;235;5;240
44;Grand Est;57;7;27;282;Hagen;354;4;358
44;Grand Est;57;9;24;283;Hagondange;9332;105;9437
44;Grand Est;57;3;07;284;Hallering;113;5;118
44;Grand Est;57;7;04;286;Halstroff;305;8;313
44;Grand Est;57;7;14;287;Basse-Ham;2221;44;2265
44;Grand Est;57;3;03;288;Ham-sous-Varsberg;2862;40;2902
44;Grand Est;57;6;22;289;Hambach;2864;66;2930
44;Grand Est;57;5;23;290;Hampont;176;2;178
44;Grand Est;57;5;17;291;Hangviller;262;5;267
44;Grand Est;57;5;23;292;Hannocourt;19;0;19
44;Grand Est;57;3;07;293;Han-sur-Nied;257;6;263
44;Grand Est;57;6;02;294;Hanviller;195;7;202
44;Grand Est;57;5;23;295;Haraucourt-sur-Seille;105;1;106
44;Grand Est;57;3;04;296;Hargarten-aux-Mines;1095;20;1115
44;Grand Est;57;3;20;297;Harprich;184;6;190
44;Grand Est;57;5;17;298;Harreberg;377;7;384
44;Grand Est;57;5;17;299;Hartzviller;926;17;943
44;Grand Est;57;5;17;300;Haselbourg;319;5;324
44;Grand Est;57;6;02;301;Haspelschiedt;303;12;315
44;Grand Est;57;5;17;302;Hattigny;189;1;190
44;Grand Est;57;9;24;303;Hauconcourt;596;9;605
44;Grand Est;57;5;21;304;Haut-Clocher;355;9;364
44;Grand Est;57;7;01;305;Havange;451;6;457
44;Grand Est;57;7;10;306;Hayange;15994;192;16186
44;Grand Est;57;9;16;307;Hayes;251;5;256
44;Grand Est;57;6;20;308;Hazembourg;149;5;154
44;Grand Est;57;3;04;309;Heining-lès-Bouzonville;481;9;490
44;Grand Est;57;5;21;310;Hellering-lès-Fénétrange;192;5;197
44;Grand Est;57;3;20;311;Hellimer;518;10;528
44;Grand Est;57;3;03;312;Helstroff;492;8;500
44;Grand Est;57;3;07;313;Hémilly;142;3;145
44;Grand Est;57;5;17;314;Héming;496;5;501
44;Grand Est;57;5;17;315;Henridorff;709;21;730
44;Grand Est;57;3;09;316;Henriville;750;16;766
44;Grand Est;57;5;17;317;Hérange;107;1;108
44;Grand Est;57;5;17;318;Hermelange;216;5;221
44;Grand Est;57;3;07;319;Herny;526;5;531
44;Grand Est;57;5;21;320;Hertzing;182;3;185
44;Grand Est;57;5;17;321;Hesse;559;21;580
44;Grand Est;57;3;04;322;Hestroff;474;6;480
44;Grand Est;57;7;27;323;Hettange-Grande;7753;168;7921
44;Grand Est;57;5;21;324;Hilbesheim;615;23;638
44;Grand Est;57;6;20;325;Hilsprich;825;16;841
44;Grand Est;57;3;03;326;Hinckange;336;4;340
44;Grand Est;57;3;07;328;Holacourt;90;1;91
44;Grand Est;57;3;04;329;Holling;430;11;441
44;Grand Est;57;6;20;330;Holving;1280;20;1300
44;Grand Est;57;7;14;331;Hombourg-Budange;553;11;564
44;Grand Est;57;3;09;332;Hombourg-Haut;6275;55;6330
44;Grand Est;57;5;21;333;Hommarting;827;24;851
44;Grand Est;57;5;17;334;Hommert;319;4;323
44;Grand Est;57;5;23;335;Honskirch;218;4;222
44;Grand Est;57;3;19;336;L'Hôpital;5205;57;5262
44;Grand Est;57;3;09;337;Hoste;584;17;601
44;Grand Est;57;6;02;338;Hottviller;512;5;517
44;Grand Est;57;5;17;339;Hultehouse;366;5;371
44;Grand Est;57;6;22;340;Hundling;1355;20;1375
44;Grand Est;57;7;04;341;Hunting;707;16;723
44;Grand Est;57;5;21;342;Ibigny;94;0;94
44;Grand Est;57;7;27;343;Illange;1814;30;1844
44;Grand Est;57;5;21;344;Imling;737;8;745
44;Grand Est;57;7;14;345;Inglange;412;32;444
44;Grand Est;57;5;23;346;Insming;593;9;602
44;Grand Est;57;5;23;347;Insviller;173;5;178
44;Grand Est;57;6;22;348;Ippling;797;17;814
44;Grand Est;57;5;23;349;Jallaucourt;148;3;151
44;Grand Est;57;9;05;350;Jouy-aux-Arches;1424;20;1444
44;Grand Est;57;9;16;351;Jury;1317;18;1335
44;Grand Est;57;9;05;352;Jussy;446;16;462
44;Grand Est;57;5;23;353;Juvelize;72;1;73
44;Grand Est;57;5;23;354;Juville;121;5;126
44;Grand Est;57;6;22;355;Kalhausen;799;19;818
44;Grand Est;57;7;27;356;Kanfen;1210;38;1248
44;Grand Est;57;6;20;357;Kappelkinger;407;2;409
44;Grand Est;57;7;14;358;Kédange-sur-Canner;1080;24;1104
44;Grand Est;57;7;14;359;Kemplich;172;4;176
44;Grand Est;57;3;25;360;Kerbach;1207;22;1229
44;Grand Est;57;7;04;361;Kerling-lès-Sierck;610;18;628
44;Grand Est;57;5;21;362;Kerprich-aux-Bois;182;5;187
44;Grand Est;57;7;04;364;Kirsch-lès-Sierck;314;7;321
44;Grand Est;57;7;04;365;Kirschnaumen;471;11;482
44;Grand Est;57;6;20;366;Kirviller;139;2;141
44;Grand Est;57;7;14;367;Klang;218;4;222
44;Grand Est;57;7;01;368;Knutange;3197;48;3245
44;Grand Est;57;7;14;370;Kœnigsmacker;2278;40;2318
44;Grand Est;57;7;04;371;Haute-Kontz;586;7;593
44;Grand Est;57;7;14;372;Kuntzig;1360;26;1386
44;Grand Est;57;3;19;373;Lachambre;926;19;945
44;Grand Est;57;5;17;374;Lafrimbolle;198;6;204
44;Grand Est;57;5;23;375;Lagarde;185;5;190
44;Grand Est;57;6;02;376;Lambach;492;7;499
44;Grand Est;57;5;17;377;Landange;247;4;251
44;Grand Est;57;3;20;379;Landroff;272;2;274
44;Grand Est;57;5;17;380;Laneuveville-lès-Lorquin;106;2;108
44;Grand Est;57;5;23;381;Laneuveville-en-Saulnois;286;6;292
44;Grand Est;57;5;21;382;Langatte;581;8;589
44;Grand Est;57;5;21;383;Languimberg;160;6;166
44;Grand Est;57;3;20;384;Laning;623;18;641
44;Grand Est;57;9;16;385;Laquenexy;1258;23;1281
44;Grand Est;57;3;07;386;Laudrefang;346;7;353
44;Grand Est;57;7;04;387;Laumesfeld;293;1;294
44;Grand Est;57;7;04;388;Launstroff;258;7;265
44;Grand Est;57;3;20;389;Lelling;465;12;477
44;Grand Est;57;6;02;390;Lemberg;1420;38;1458
44;Grand Est;57;5;23;391;Lemoncourt;63;2;65
44;Grand Est;57;9;07;392;Lemud;539;4;543
44;Grand Est;57;6;02;393;Lengelsheim;196;3;199
44;Grand Est;57;5;23;394;Léning;346;12;358
44;Grand Est;57;5;23;395;Lesse;204;4;208
44;Grand Est;57;9;05;396;Lessy;736;27;763
44;Grand Est;57;5;23;397;Ley;102;0;102
44;Grand Est;57;3;20;398;Leyviller;506;10;516
44;Grand Est;57;5;23;399;Lezey;91;7;98
44;Grand Est;57;5;23;401;Lidrezing;84;1;85
44;Grand Est;57;6;02;402;Liederschiedt;119;1;120
44;Grand Est;57;9;07;403;Liéhon;129;0;129
44;Grand Est;57;5;23;404;Lindre-Basse;210;6;216
44;Grand Est;57;5;23;405;Lindre-Haute;54;0;54
44;Grand Est;57;5;23;406;Liocourt;141;3;144
44;Grand Est;57;5;17;407;Lixheim;589;6;595
44;Grand Est;57;6;22;408;Lixing-lès-Rouhling;847;18;865
44;Grand Est;57;3;20;409;Lixing-lès-Saint-Avold;670;15;685
44;Grand Est;57;5;23;410;Lhor;140;3;143
44;Grand Est;57;7;01;411;Lommerange;350;1;351
44;Grand Est;57;9;15;412;Longeville-lès-Metz;3926;64;3990
44;Grand Est;57;3;07;413;Longeville-lès-Saint-Avold;3627;82;3709
44;Grand Est;57;5;17;414;Lorquin;1144;25;1169
44;Grand Est;57;9;05;415;Lorry-lès-Metz;1737;75;1812
44;Grand Est;57;9;05;416;Lorry-Mardigny;664;8;672
44;Grand Est;57;5;23;417;Lostroff;69;3;72
44;Grand Est;57;5;23;418;Loudrefing;323;3;326
44;Grand Est;57;6;20;419;Loupershouse;902;20;922
44;Grand Est;57;6;02;421;Loutzviller;154;3;157
44;Grand Est;57;9;07;422;Louvigny;883;11;894
44;Grand Est;57;5;23;423;Lubécourt;72;1;73
44;Grand Est;57;5;23;424;Lucy;235;2;237
44;Grand Est;57;9;07;425;Luppy;575;4;579
44;Grand Est;57;7;14;426;Luttange;900;9;909
44;Grand Est;57;5;17;427;Lutzelbourg;565;10;575
44;Grand Est;57;3;19;428;Macheren;2778;50;2828
44;Grand Est;57;3;07;430;Mainvillers;327;5;332
44;Grand Est;57;9;16;431;Maizeroy;409;3;412
44;Grand Est;57;9;24;433;Maizières-lès-Metz;11776;116;11892
44;Grand Est;57;5;23;434;Maizières-lès-Vic;482;9;491
44;Grand Est;57;5;23;436;Malaucourt-sur-Seille;129;6;135
44;Grand Est;57;7;04;437;Malling;647;13;660
44;Grand Est;57;9;16;438;Malroy;350;5;355
44;Grand Est;57;7;04;439;Manderen-Ritzing;602;13;615
44;Grand Est;57;5;23;440;Manhoué;141;3;144
44;Grand Est;57;7;27;441;Manom;2947;61;3008
44;Grand Est;57;3;07;442;Many;238;2;240
44;Grand Est;57;9;18;443;Marange-Silvange;6446;56;6502
44;Grand Est;57;3;07;444;Marange-Zondrange;358;5;363
44;Grand Est;57;9;05;445;Marieulles;700;11;711
44;Grand Est;57;5;23;446;Marimont-lès-Bénestroff;45;0;45
44;Grand Est;57;9;15;447;Marly;9961;226;10187
44;Grand Est;57;5;23;448;Marsal;245;6;251
44;Grand Est;57;9;16;449;Marsilly;594;3;597
44;Grand Est;57;5;23;451;Marthille;168;4;172
44;Grand Est;57;9;24;452;La Maxe;1034;15;1049
44;Grand Est;57;3;20;453;Maxstadt;297;11;308
44;Grand Est;57;9;16;454;Mécleuves;1187;25;1212
44;Grand Est;57;3;03;455;Mégange;143;3;146
44;Grand Est;57;6;02;456;Meisenthal;662;24;686
44;Grand Est;57;3;04;457;Menskirch;137;2;139
44;Grand Est;57;7;04;459;Merschweiller;289;2;291
44;Grand Est;57;3;04;460;Merten;1471;17;1488
44;Grand Est;57;5;17;461;Métairies-Saint-Quirin;276;8;284
44;Grand Est;57;5;17;462;Metting;431;7;438
44;Grand Est;57;9;98;463;Metz;120211;1825;122036
44;Grand Est;57;7;14;464;Metzeresche;978;28;1006
44;Grand Est;57;7;14;465;Metzervisse;2268;51;2319
44;Grand Est;57;3;25;466;Metzing;665;9;674
44;Grand Est;57;9;16;467;Mey;308;2;310
44;Grand Est;57;5;17;468;Mittelbronn;673;17;690
44;Grand Est;57;5;21;469;Mittersheim;595;4;599
44;Grand Est;57;5;23;470;Molring;4;0;4
44;Grand Est;57;3;03;471;Momerstroff;297;3;300
44;Grand Est;57;9;23;472;Moncheux;147;0;147
44;Grand Est;57;5;23;473;Moncourt;65;2;67
44;Grand Est;57;7;06;474;Mondelange;5701;57;5758
44;Grand Est;57;7;27;475;Mondorff;527;15;542
44;Grand Est;57;7;14;476;Monneren;407;10;417
44;Grand Est;57;6;02;477;Montbronn;1597;44;1641
44;Grand Est;57;5;23;478;Montdidier;86;0;86
44;Grand Est;57;7;04;479;Montenach;479;12;491
44;Grand Est;57;9;15;480;Montigny-lès-Metz;21788;347;22135
44;Grand Est;57;9;18;481;Montois-la-Montagne;2730;17;2747
44;Grand Est;57;9;16;482;Ogy-Montoy-Flanville;1777;29;1806
44;Grand Est;57;3;20;483;Morhange;3390;85;3475
44;Grand Est;57;3;08;484;Morsbach;2675;28;2703
44;Grand Est;57;5;23;485;Morville-lès-Vic;124;2;126
44;Grand Est;57;5;23;486;Morville-sur-Nied;116;1;117
44;Grand Est;57;9;05;487;Moulins-lès-Metz;5021;58;5079
44;Grand Est;57;5;21;488;Moussey;561;8;569
44;Grand Est;57;6;02;489;Mouterhouse;288;0;288
44;Grand Est;57;5;23;490;Moyenvic;341;4;345
44;Grand Est;57;7;10;491;Moyeuvre-Grande;7349;63;7412
44;Grand Est;57;7;10;492;Moyeuvre-Petite;448;9;457
44;Grand Est;57;5;23;493;Mulcey;211;4;215
44;Grand Est;57;5;23;494;Munster;236;0;236
44;Grand Est;57;3;03;495;Narbéfontaine;115;1;116
44;Grand Est;57;5;23;496;Nébing;334;6;340
44;Grand Est;57;6;20;497;Nelling;262;9;271
44;Grand Est;57;7;01;498;Neufchef;2593;53;2646
44;Grand Est;57;6;22;499;Neufgrange;1357;30;1387
44;Grand Est;57;5;17;500;Neufmoulins;43;0;43
44;Grand Est;57;5;23;501;Neufvillage;40;0;40
44;Grand Est;57;3;04;502;Neunkirchen-lès-Bouzonville;331;12;343
44;Grand Est;57;5;17;504;Niderhoff;278;5;283
44;Grand Est;57;5;17;505;Niderviller;1192;22;1214
44;Grand Est;57;5;21;506;Niederstinzel;247;5;252
44;Grand Est;57;3;03;507;Niedervisse;271;2;273
44;Grand Est;57;7;01;508;Nilvange;4430;53;4483
44;Grand Est;57;5;17;509;Nitting;487;11;498
44;Grand Est;57;9;16;510;Noisseville;1108;11;1119
44;Grand Est;57;9;18;511;Norroy-le-Veneur;1019;21;1040
44;Grand Est;57;9;16;512;Nouilly;712;11;723
44;Grand Est;57;6;02;513;Nousseviller-lès-Bitche;154;1;155
44;Grand Est;57;3;25;514;Nousseviller-Saint-Nabor;1186;25;1211
44;Grand Est;57;9;05;515;Novéant-sur-Moselle;1836;25;1861
44;Grand Est;57;3;04;516;Oberdorff;339;10;349
44;Grand Est;57;6;02;517;Obergailbach;279;4;283
44;Grand Est;57;5;21;518;Oberstinzel;327;10;337
44;Grand Est;57;3;03;519;Obervisse;160;3;163
44;Grand Est;57;5;23;520;Obreck;32;1;33
44;Grand Est;57;3;08;521;Œting;2711;54;2765
44;Grand Est;57;5;23;524;Ommeray;129;1;130
44;Grand Est;57;5;23;525;Oriocourt;55;1;56
44;Grand Est;57;6;02;526;Ormersviller;378;1;379
44;Grand Est;57;9;07;527;Orny;357;4;361
44;Grand Est;57;5;23;528;Oron;105;1;106
44;Grand Est;57;7;01;529;Ottange;3127;66;3193
44;Grand Est;57;3;03;530;Ottonville;438;6;444
44;Grand Est;57;7;14;531;Oudrenne;742;12;754
44;Grand Est;57;9;07;532;Pagny-lès-Goin;230;3;233
44;Grand Est;57;9;16;533;Pange;876;18;894
44;Grand Est;57;9;16;534;Peltre;1830;123;1953
44;Grand Est;57;6;02;535;Petit-Réderching;1426;33;1459
44;Grand Est;57;3;20;536;Petit-Tenquin;219;3;222
44;Grand Est;57;3;08;537;Petite-Rosselle;6257;67;6324
44;Grand Est;57;5;23;538;Pettoncourt;296;3;299
44;Grand Est;57;5;23;539;Pévange;45;3;48
44;Grand Est;57;5;17;540;Phalsbourg;4700;239;4939
44;Grand Est;57;6;02;541;Philippsbourg;600;13;613
44;Grand Est;57;3;03;542;Piblange;973;10;983
44;Grand Est;57;9;18;543;Pierrevillers;1495;22;1517
44;Grand Est;57;5;17;544;Plaine-de-Walsch;610;17;627
44;Grand Est;57;9;15;545;Plappeville;2032;56;2088
44;Grand Est;57;9;18;546;Plesnois;803;31;834
44;Grand Est;57;9;07;547;Pommérieux;709;10;719
44;Grand Est;57;9;07;548;Pontoy;581;7;588
44;Grand Est;57;3;07;549;Pontpierre;743;14;757
44;Grand Est;57;3;19;550;Porcelette;2473;65;2538
44;Grand Est;57;5;21;551;Postroff;208;7;215
44;Grand Est;57;9;05;552;Pouilly;727;10;737
44;Grand Est;57;9;05;553;Pournoy-la-Chétive;624;13;637
44;Grand Est;57;9;07;554;Pournoy-la-Grasse;710;21;731
44;Grand Est;57;5;23;555;Prévocourt;112;0;112
44;Grand Est;57;6;20;556;Puttelange-aux-Lacs;3081;46;3127
44;Grand Est;57;7;27;557;Puttelange-lès-Thionville;1016;24;1040
44;Grand Est;57;5;23;558;Puttigny;77;0;77
44;Grand Est;57;5;23;559;Puzieux;170;0;170
44;Grand Est;57;3;20;560;Racrange;621;13;634
44;Grand Est;57;6;02;561;Rahling;722;20;742
44;Grand Est;57;7;10;562;Ranguevaux;865;18;883
44;Grand Est;57;9;16;563;Raville;250;2;252
44;Grand Est;57;5;21;564;Réchicourt-le-Château;564;14;578
44;Grand Est;57;7;01;565;Rédange;996;19;1015
44;Grand Est;57;5;21;566;Réding;2349;64;2413
44;Grand Est;57;3;04;567;Rémelfang;146;1;147
44;Grand Est;57;6;22;568;Rémelfing;1367;23;1390
44;Grand Est;57;7;04;569;Rémeling;320;6;326
44;Grand Est;57;3;04;570;Rémering;416;5;421
44;Grand Est;57;6;20;571;Rémering-lès-Puttelange;1040;32;1072
44;Grand Est;57;9;07;572;Rémilly;2009;100;2109
44;Grand Est;57;5;23;573;Réning;134;2;136
44;Grand Est;57;7;27;574;Basse-Rentgen;522;13;535
44;Grand Est;57;9;16;575;Retonfey;1344;30;1374
44;Grand Est;57;7;04;576;Rettel;796;54;850
44;Grand Est;57;6;02;577;Reyersviller;371;6;377
44;Grand Est;57;9;05;578;Rezonville-Vionville;494;7;501
44;Grand Est;57;5;21;579;Rhodes;128;1;129
44;Grand Est;57;5;23;580;Riche;187;2;189
44;Grand Est;57;6;20;581;Richeling;351;7;358
44;Grand Est;57;7;06;582;Richemont;2090;44;2134
44;Grand Est;57;5;21;583;Richeval;129;6;135
44;Grand Est;57;6;02;584;Rimling;656;17;673
44;Grand Est;57;7;01;586;Rochonvillers;186;2;188
44;Grand Est;57;5;23;587;Rodalbe;248;3;251
44;Grand Est;57;7;27;588;Rodemack;1292;33;1325
44;Grand Est;57;6;02;589;Rohrbach-lès-Bitche;2305;50;2355
44;Grand Est;57;6;02;590;Rolbing;259;6;265
44;Grand Est;57;9;18;591;Rombas;9864;91;9955
44;Grand Est;57;5;21;592;Romelfing;344;7;351
44;Grand Est;57;9;18;593;Roncourt;1029;11;1040
44;Grand Est;57;6;02;594;Roppeviller;98;3;101
44;Grand Est;57;5;23;595;Rorbach-lès-Dieuze;49;0;49
44;Grand Est;57;3;08;596;Rosbruck;740;11;751
44;Grand Est;57;7;10;597;Rosselange;2567;25;2592
44;Grand Est;57;6;22;598;Rouhling;1995;53;2048
44;Grand Est;57;3;03;599;Roupeldange;361;8;369
44;Grand Est;57;7;27;600;Roussy-le-Village;1443;25;1468
44;Grand Est;57;9;05;601;Rozérieulles;1322;41;1363
44;Grand Est;57;7;14;602;Rurange-lès-Thionville;2399;53;2452
44;Grand Est;57;7;01;603;Russange;1268;22;1290
44;Grand Est;57;7;04;604;Rustroff;630;5;635
44;Grand Est;57;9;23;605;Sailly-Achâtel;303;2;305
44;Grand Est;57;3;19;606;Saint-Avold;15171;323;15494
44;Grand Est;57;9;16;607;Sainte-Barbe;769;10;779
44;Grand Est;57;5;23;609;Saint-Epvre;173;2;175
44;Grand Est;57;3;04;610;Saint-François-Lacroix;311;6;317
44;Grand Est;57;5;21;611;Saint-Georges;197;6;203
44;Grand Est;57;9;16;612;Saint-Hubert;237;5;242
44;Grand Est;57;5;21;613;Saint-Jean-de-Bassel;344;5;349
44;Grand Est;57;5;17;614;Saint-Jean-Kourtzerode;703;4;707
44;Grand Est;57;6;20;615;Saint-Jean-Rohrbach;969;19;988
44;Grand Est;57;9;16;616;Saint-Julien-lès-Metz;3467;64;3531
44;Grand Est;57;9;23;617;Saint-Jure;283;6;289
44;Grand Est;57;5;17;618;Saint-Louis;642;18;660
44;Grand Est;57;6;02;619;Saint-Louis-lès-Bitche;467;9;476
44;Grand Est;57;9;18;620;Sainte-Marie-aux-Chênes;4463;59;4522
44;Grand Est;57;5;23;621;Saint-Médard;109;1;110
44;Grand Est;57;9;18;622;Saint-Privat-la-Montagne;1897;23;1920
44;Grand Est;57;5;17;623;Saint-Quirin;705;49;754
44;Grand Est;57;9;05;624;Sainte-Ruffine;570;31;601
44;Grand Est;57;5;23;625;Salonnes;174;2;176
44;Grand Est;57;9;16;626;Sanry-lès-Vigy;523;12;535
44;Grand Est;57;9;16;627;Sanry-sur-Nied;357;3;360
44;Grand Est;57;6;20;628;Sarralbe;4450;90;4540
44;Grand Est;57;5;21;629;Sarraltroff;780;6;786
44;Grand Est;57;5;21;630;Sarrebourg;12278;304;12582
44;Grand Est;57;6;22;631;Sarreguemines;20555;462;21017
44;Grand Est;57;6;22;633;Sarreinsming;1261;32;1293
44;Grand Est;57;9;18;634;Saulny;1511;40;1551
44;Grand Est;57;5;21;635;Schalbach;368;7;375
44;Grand Est;57;6;02;636;Schmittviller;322;8;330
44;Grand Est;57;5;17;637;Schneckenbusch;307;7;314
44;Grand Est;57;3;08;638;Schœneck;2473;41;2514
44;Grand Est;57;6;02;639;Schorbach;536;9;545
44;Grand Est;57;3;04;640;Schwerdorff;474;14;488
44;Grand Est;57;6;02;641;Schweyen;309;6;315
44;Grand Est;57;9;15;642;Scy-Chazelles;2665;52;2717
44;Grand Est;57;9;23;643;Secourt;201;6;207
44;Grand Est;57;3;09;644;Seingbouse;1741;44;1785
44;Grand Est;57;9;24;645;Semécourt;1021;9;1030
44;Grand Est;57;7;10;647;Serémange-Erzange;4164;56;4220
44;Grand Est;57;9;16;648;Servigny-lès-Raville;501;5;506
44;Grand Est;57;9;16;649;Servigny-lès-Sainte-Barbe;478;4;482
44;Grand Est;57;7;04;650;Sierck-les-Bains;1776;13;1789
44;Grand Est;57;6;02;651;Siersthal;639;6;645
44;Grand Est;57;9;07;652;Sillegny;584;6;590
44;Grand Est;57;9;07;653;Silly-en-Saulnois;33;1;34
44;Grand Est;57;9;16;654;Silly-sur-Nied;703;11;714
44;Grand Est;57;9;07;655;Solgne;1124;53;1177
44;Grand Est;57;9;16;656;Sorbey;385;6;391
44;Grand Est;57;5;23;657;Sotzeling;21;0;21
44;Grand Est;57;6;02;658;Soucht;1038;20;1058
44;Grand Est;57;3;25;659;Spicheren;3227;56;3283
44;Grand Est;57;3;25;660;Stiring-Wendel;11043;131;11174
44;Grand Est;57;6;02;661;Sturzelbronn;172;1;173
44;Grand Est;57;3;20;662;Suisse;98;1;99
44;Grand Est;57;9;24;663;Talange;7832;177;8009
44;Grand Est;57;5;23;664;Tarquimpol;61;2;63
44;Grand Est;57;3;25;665;Tenteling;1051;19;1070
44;Grand Est;57;7;26;666;Terville;7328;93;7421
44;Grand Est;57;3;03;667;Téterchen;775;8;783
44;Grand Est;57;3;07;668;Teting-sur-Nied;1264;34;1298
44;Grand Est;57;3;25;669;Théding;2459;44;2503
44;Grand Est;57;3;07;670;Thicourt;132;1;133
44;Grand Est;57;9;07;671;Thimonville;154;0;154
44;Grand Est;57;7;99;672;Thionville;41383;734;42117
44;Grand Est;57;3;07;673;Thonville;49;1;50
44;Grand Est;57;5;23;674;Tincry;174;4;178
44;Grand Est;57;5;23;675;Torcheville;118;1;119
44;Grand Est;57;9;07;676;Tragny;90;1;91
44;Grand Est;57;9;16;677;Trémery;1024;21;1045
44;Grand Est;57;7;01;678;Tressange;2301;30;2331
44;Grand Est;57;3;07;679;Tritteling-Redlach;526;10;536
44;Grand Est;57;5;17;680;Troisfontaines;1255;29;1284
44;Grand Est;57;3;04;681;Tromborn;334;5;339
44;Grand Est;57;5;17;682;Turquestein-Blancrupt;11;0;11
44;Grand Est;57;7;06;683;Uckange;6951;37;6988
44;Grand Est;57;3;20;684;Vahl-Ebersing;509;10;519
44;Grand Est;57;5;23;685;Vahl-lès-Bénestroff;150;3;153
44;Grand Est;57;3;07;686;Vahl-lès-Faulquemont;247;1;248
44;Grand Est;57;3;20;687;Vallerange;212;4;216
44;Grand Est;57;7;14;689;Valmestroff;329;5;334
44;Grand Est;57;3;19;690;Valmont;2976;68;3044
44;Grand Est;57;3;03;691;Valmunster;85;4;89
44;Grand Est;57;5;23;692;Vannecourt;73;0;73
44;Grand Est;57;9;16;693;Vantoux;808;19;827
44;Grand Est;57;9;16;694;Vany;452;11;463
44;Grand Est;57;3;03;695;Varize-Vaudoncourt;506;9;515
44;Grand Est;57;3;03;696;Varsberg;968;24;992
44;Grand Est;57;5;17;697;Vasperviller;314;9;323
44;Grand Est;57;3;07;698;Vatimont;314;6;320
44;Grand Est;57;3;04;700;Vaudreching;499;8;507
44;Grand Est;57;9;05;701;Vaux;816;26;842
44;Grand Est;57;5;23;702;Vaxy;169;0;169
44;Grand Est;57;5;21;703;Veckersviller;234;17;251
44;Grand Est;57;7;14;704;Veckring;647;15;662
44;Grand Est;57;3;03;705;Velving;209;5;214
44;Grand Est;57;5;23;706;Vergaville;545;13;558
44;Grand Est;57;9;05;707;Vernéville;670;6;676
44;Grand Est;57;9;07;708;Verny;1981;44;2025
44;Grand Est;57;5;17;709;Vescheim;310;7;317
44;Grand Est;57;5;23;711;Vibersviller;400;8;408
44;Grand Est;57;5;23;712;Vic-sur-Seille;1332;44;1376
44;Grand Est;57;5;21;713;Vieux-Lixheim;248;6;254
44;Grand Est;57;3;07;714;Haute-Vigneulles;442;9;451
44;Grand Est;57;9;23;715;Vigny;383;11;394
44;Grand Est;57;9;16;716;Vigy;1673;18;1691
44;Grand Est;57;3;20;717;Viller;181;4;185
44;Grand Est;57;9;07;718;Villers-Stoncourt;216;1;217
44;Grand Est;57;5;23;719;Villers-sur-Nied;82;3;85
44;Grand Est;57;3;04;720;Villing;501;12;513
44;Grand Est;57;5;17;721;Vilsberg;346;11;357
44;Grand Est;57;5;23;723;Virming;293;6;299
44;Grand Est;57;7;10;724;Vitry-sur-Orne;3019;32;3051
44;Grand Est;57;5;23;725;Vittersbourg;343;7;350
44;Grand Est;57;3;07;726;Vittoncourt;385;4;389
44;Grand Est;57;5;23;727;Viviers;124;1;125
44;Grand Est;57;3;07;728;Voimhaut;254;3;257
44;Grand Est;57;3;03;730;Volmerange-lès-Boulay;565;14;579
44;Grand Est;57;7;27;731;Volmerange-les-Mines;2308;41;2349
44;Grand Est;57;6;02;732;Volmunster;768;20;788
44;Grand Est;57;7;14;733;Volstroff;2048;29;2077
44;Grand Est;57;5;17;734;Voyer;458;9;467
44;Grand Est;57;9;16;736;Vry;619;11;630
44;Grand Est;57;9;23;737;Vulmont;32;2;34
44;Grand Est;57;6;02;738;Waldhouse;387;9;396
44;Grand Est;57;7;04;739;Waldweistroff;510;5;515
44;Grand Est;57;7;04;740;Waldwisse;812;11;823
44;Grand Est;57;6;02;741;Walschbronn;408;12;420
44;Grand Est;57;5;17;742;Walscheid;1496;42;1538
44;Grand Est;57;5;17;743;Waltembourg;241;7;248
44;Grand Est;57;6;22;745;Wiesviller;920;22;942
44;Grand Est;57;6;22;746;Willerwald;1538;32;1570
44;Grand Est;57;5;17;747;Wintersbourg;266;3;269
44;Grand Est;57;6;22;748;Wittring;752;19;771
44;Grand Est;57;3;04;749;Vœlfling-lès-Bouzonville;156;6;162
44;Grand Est;57;6;22;750;Wœlfling-lès-Sarreguemines;710;26;736
44;Grand Est;57;9;24;751;Woippy;14526;123;14649
44;Grand Est;57;6;20;752;Woustviller;2891;50;2941
44;Grand Est;57;5;23;753;Wuisse;59;1;60
44;Grand Est;57;5;23;754;Xanrey;109;1;110
44;Grand Est;57;5;23;755;Xocourt;99;0;99
44;Grand Est;57;5;17;756;Xouaxange;314;4;318
44;Grand Est;57;7;27;757;Yutz;17304;276;17580
44;Grand Est;57;5;23;759;Zarbeling;66;1;67
44;Grand Est;57;6;22;760;Zetting;854;20;874
44;Grand Est;57;5;17;761;Zilling;273;4;277
44;Grand Est;57;3;07;762;Zimming;704;6;710
44;Grand Est;57;5;23;763;Zommange;47;2;49
44;Grand Est;57;7;27;764;Zoufftgen;1253;17;1270
44;Grand Est;57;3;19;765;Diesen;1057;16;1073
44;Grand Est;57;7;14;767;Stuckange;1336;34;1370
27;Bourgogne-Franche-Comté;58;1;02;001;Achun;159;0;159
27;Bourgogne-Franche-Comté;58;4;05;002;Alligny-Cosne;919;13;932
27;Bourgogne-Franche-Comté;58;1;02;003;Alligny-en-Morvan;601;7;608
27;Bourgogne-Franche-Comté;58;1;02;004;Alluy;374;8;382
27;Bourgogne-Franche-Comté;58;2;03;005;Amazy;222;4;226
27;Bourgogne-Franche-Comté;58;3;08;006;Anlezy;242;3;245
27;Bourgogne-Franche-Comté;58;4;15;007;Annay;344;5;349
27;Bourgogne-Franche-Comté;58;2;04;008;Anthien;168;4;172
27;Bourgogne-Franche-Comté;58;4;01;009;Arbourse;126;1;127
27;Bourgogne-Franche-Comté;58;1;02;010;Arleuf;651;11;662
27;Bourgogne-Franche-Comté;58;2;03;011;Armes;283;5;288
27;Bourgogne-Franche-Comté;58;4;15;012;Arquian;571;13;584
27;Bourgogne-Franche-Comté;58;4;01;013;Arthel;95;2;97
27;Bourgogne-Franche-Comté;58;4;01;014;Arzembouy;65;1;66
27;Bourgogne-Franche-Comté;58;2;04;015;Asnan;119;3;122
27;Bourgogne-Franche-Comté;58;2;03;016;Asnois;139;4;143
27;Bourgogne-Franche-Comté;58;1;02;017;Aunay-en-Bazois;225;7;232
27;Bourgogne-Franche-Comté;58;2;04;018;Authiou;45;0;45
27;Bourgogne-Franche-Comté;58;1;10;019;Avrée;84;2;86
27;Bourgogne-Franche-Comté;58;3;16;020;Avril-sur-Loire;246;4;250
27;Bourgogne-Franche-Comté;58;3;16;021;Azy-le-Vif;203;5;208
27;Bourgogne-Franche-Comté;58;1;04;023;Bazoches;173;3;176
27;Bourgogne-Franche-Comté;58;3;08;024;Bazolles;280;11;291
27;Bourgogne-Franche-Comté;58;3;09;025;Béard;163;7;170
27;Bourgogne-Franche-Comté;58;2;04;026;Beaulieu;141;9;150
27;Bourgogne-Franche-Comté;58;4;01;027;Beaumont-la-Ferrière;120;3;123
27;Bourgogne-Franche-Comté;58;3;08;028;Beaumont-Sardolles;118;3;121
27;Bourgogne-Franche-Comté;58;2;04;029;Beuvron;83;0;83
27;Bourgogne-Franche-Comté;58;1;02;030;Biches;282;12;294
27;Bourgogne-Franche-Comté;58;3;08;031;Billy-Chevannes;297;3;300
27;Bourgogne-Franche-Comté;58;2;03;032;Billy-sur-Oisy;357;7;364
27;Bourgogne-Franche-Comté;58;4;15;033;Bitry;301;9;310
27;Bourgogne-Franche-Comté;58;1;02;034;Blismes;185;6;191
27;Bourgogne-Franche-Comté;58;3;08;035;Bona;297;2;299
27;Bourgogne-Franche-Comté;58;4;15;036;Bouhy;462;9;471
27;Bourgogne-Franche-Comté;58;1;04;037;Brassy;591;36;627
27;Bourgogne-Franche-Comté;58;2;03;038;Breugnon;156;5;161
27;Bourgogne-Franche-Comté;58;2;03;039;Brèves;231;3;234
27;Bourgogne-Franche-Comté;58;1;02;040;Brinay;144;3;147
27;Bourgogne-Franche-Comté;58;2;04;041;Brinon-sur-Beuvron;167;5;172
27;Bourgogne-Franche-Comté;58;4;15;042;Bulcy;140;2;142
27;Bourgogne-Franche-Comté;58;2;04;043;Bussy-la-Pesle;53;0;53
27;Bourgogne-Franche-Comté;58;4;05;044;La Celle-sur-Loire;804;11;815
27;Bourgogne-Franche-Comté;58;4;01;045;La Celle-sur-Nièvre;158;1;159
27;Bourgogne-Franche-Comté;58;1;10;046;Cercy-la-Tour;1697;24;1721
27;Bourgogne-Franche-Comté;58;2;04;047;Cervon;639;15;654
27;Bourgogne-Franche-Comté;58;4;15;048;Cessy-les-Bois;114;5;119
27;Bourgogne-Franche-Comté;58;1;04;049;Chalaux;83;2;85
27;Bourgogne-Franche-Comté;58;2;04;050;Challement;45;2;47
27;Bourgogne-Franche-Comté;58;3;13;051;Challuy;1522;133;1655
27;Bourgogne-Franche-Comté;58;2;04;052;Champallement;48;1;49
27;Bourgogne-Franche-Comté;58;4;01;053;Champlemy;325;8;333
27;Bourgogne-Franche-Comté;58;2;01;054;Champlin;40;1;41
27;Bourgogne-Franche-Comté;58;3;06;055;Champvert;752;14;766
27;Bourgogne-Franche-Comté;58;4;01;056;Champvoux;291;7;298
27;Bourgogne-Franche-Comté;58;3;16;057;Chantenay-Saint-Imbert;1108;19;1127
27;Bourgogne-Franche-Comté;58;2;03;058;La Chapelle-Saint-André;298;5;303
27;Bourgogne-Franche-Comté;58;4;01;059;La Charité-sur-Loire;4673;53;4726
27;Bourgogne-Franche-Comté;58;1;10;060;Charrin;614;10;624
27;Bourgogne-Franche-Comté;58;4;01;061;Chasnay;125;1;126
27;Bourgogne-Franche-Comté;58;1;02;062;Château-Chinon (Ville);1934;383;2317
27;Bourgogne-Franche-Comté;58;1;02;063;Château-Chinon (Campagne);549;8;557
27;Bourgogne-Franche-Comté;58;4;15;064;Châteauneuf-Val-de-Bargis;491;15;506
27;Bourgogne-Franche-Comté;58;1;02;065;Châtillon-en-Bazois;912;16;928
27;Bourgogne-Franche-Comté;58;1;02;066;Châtin;82;0;82
27;Bourgogne-Franche-Comté;58;4;01;067;Chaulgnes;1508;23;1531
27;Bourgogne-Franche-Comté;58;1;02;068;Chaumard;205;1;206
27;Bourgogne-Franche-Comté;58;2;04;069;Chaumot;163;4;167
27;Bourgogne-Franche-Comté;58;2;04;070;Chazeuil;58;0;58
27;Bourgogne-Franche-Comté;58;2;04;071;Chevannes-Changy;137;7;144
27;Bourgogne-Franche-Comté;58;3;16;072;Chevenon;623;10;633
27;Bourgogne-Franche-Comté;58;2;03;073;Chevroches;126;4;130
27;Bourgogne-Franche-Comté;58;1;10;074;Chiddes;344;11;355
27;Bourgogne-Franche-Comté;58;2;04;075;Chitry-les-Mines;218;4;222
27;Bourgogne-Franche-Comté;58;1;02;076;Chougny;81;0;81
27;Bourgogne-Franche-Comté;58;4;15;077;Ciez;373;7;380
27;Bourgogne-Franche-Comté;58;3;08;078;Cizely;53;0;53
27;Bourgogne-Franche-Comté;58;2;03;079;Clamecy;3594;185;3779
27;Bourgogne-Franche-Comté;58;2;04;080;La Collancelle;167;1;168
27;Bourgogne-Franche-Comté;58;4;15;081;Colméry;271;4;275
27;Bourgogne-Franche-Comté;58;1;02;082;Corancy;284;4;288
27;Bourgogne-Franche-Comté;58;2;04;083;Corbigny;1397;96;1493
27;Bourgogne-Franche-Comté;58;2;04;084;Corvol-d'Embernard;95;4;99
27;Bourgogne-Franche-Comté;58;2;03;085;Corvol-l'Orgueilleux;730;12;742
27;Bourgogne-Franche-Comté;58;4;05;086;Cosne-Cours-sur-Loire;9415;243;9658
27;Bourgogne-Franche-Comté;58;3;06;087;Cossaye;689;12;701
27;Bourgogne-Franche-Comté;58;3;11;088;Coulanges-lès-Nevers;3708;71;3779
27;Bourgogne-Franche-Comté;58;4;15;089;Couloutre;192;7;199
27;Bourgogne-Franche-Comté;58;2;03;090;Courcelles;219;1;220
27;Bourgogne-Franche-Comté;58;3;08;092;Crux-la-Ville;397;10;407
27;Bourgogne-Franche-Comté;58;2;03;093;Cuncy-lès-Varzy;126;2;128
27;Bourgogne-Franche-Comté;58;4;15;094;Dampierre-sous-Bouhy;444;4;448
27;Bourgogne-Franche-Comté;58;3;06;095;Decize;5193;182;5375
27;Bourgogne-Franche-Comté;58;3;06;096;Devay;496;10;506
27;Bourgogne-Franche-Comté;58;3;08;097;Diennes-Aubigny;91;1;92
27;Bourgogne-Franche-Comté;58;2;03;098;Dirol;110;5;115
27;Bourgogne-Franche-Comté;58;1;02;099;Dommartin;161;3;164
27;Bourgogne-Franche-Comté;58;4;01;101;Dompierre-sur-Nièvre;190;2;192
27;Bourgogne-Franche-Comté;58;4;15;102;Donzy;1571;25;1596
27;Bourgogne-Franche-Comté;58;2;03;103;Dornecy;469;8;477
27;Bourgogne-Franche-Comté;58;3;16;104;Dornes;1473;24;1497
27;Bourgogne-Franche-Comté;58;3;09;105;Druy-Parigny;307;4;311
27;Bourgogne-Franche-Comté;58;1;04;106;Dun-les-Places;356;3;359
27;Bourgogne-Franche-Comté;58;1;02;107;Dun-sur-Grandry;144;2;146
27;Bourgogne-Franche-Comté;58;1;04;108;Empury;86;1;87
27;Bourgogne-Franche-Comté;58;2;03;109;Entrains-sur-Nohain;739;12;751
27;Bourgogne-Franche-Comté;58;2;04;110;Epiry;239;2;241
27;Bourgogne-Franche-Comté;58;1;02;111;Fâchin;104;0;104
27;Bourgogne-Franche-Comté;58;3;08;112;La Fermeté;629;7;636
27;Bourgogne-Franche-Comté;58;3;08;113;Fertrève;96;1;97
27;Bourgogne-Franche-Comté;58;1;10;114;Fléty;91;4;95
27;Bourgogne-Franche-Comté;58;3;16;115;Fleury-sur-Loire;224;6;230
27;Bourgogne-Franche-Comté;58;2;03;116;Flez-Cuzy;130;4;134
27;Bourgogne-Franche-Comté;58;3;07;117;Fourchambault;4069;51;4120
27;Bourgogne-Franche-Comté;58;1;10;118;Fours;641;7;648
27;Bourgogne-Franche-Comté;58;3;08;119;Frasnay-Reugny;79;2;81
27;Bourgogne-Franche-Comté;58;2;04;120;Gâcogne;219;0;219
27;Bourgogne-Franche-Comté;58;3;07;121;Garchizy;3750;45;3795
27;Bourgogne-Franche-Comté;58;4;15;122;Garchy;425;11;436
27;Bourgogne-Franche-Comté;58;2;04;123;Germenay;121;11;132
27;Bourgogne-Franche-Comté;58;3;07;124;Germigny-sur-Loire;767;7;774
27;Bourgogne-Franche-Comté;58;1;02;125;Gien-sur-Cure;92;2;94
27;Bourgogne-Franche-Comté;58;3;13;126;Gimouille;438;12;450
27;Bourgogne-Franche-Comté;58;4;01;127;Giry;188;3;191
27;Bourgogne-Franche-Comté;58;1;02;128;Glux-en-Glenne;90;1;91
27;Bourgogne-Franche-Comté;58;1;02;129;Gouloux;170;5;175
27;Bourgogne-Franche-Comté;58;2;04;130;Grenois;94;3;97
27;Bourgogne-Franche-Comté;58;3;08;131;Guérigny;2525;43;2568
27;Bourgogne-Franche-Comté;58;2;04;132;Guipy;227;10;237
27;Bourgogne-Franche-Comté;58;2;04;133;Héry;72;2;74
27;Bourgogne-Franche-Comté;58;3;09;134;Imphy;3195;38;3233
27;Bourgogne-Franche-Comté;58;1;10;135;Isenay;101;0;101
27;Bourgogne-Franche-Comté;58;3;08;136;Jailly;68;2;70
27;Bourgogne-Franche-Comté;58;3;06;137;Lamenay-sur-Loire;71;0;71
27;Bourgogne-Franche-Comté;58;3;16;138;Langeron;352;13;365
27;Bourgogne-Franche-Comté;58;1;10;139;Lanty;113;0;113
27;Bourgogne-Franche-Comté;58;1;10;140;Larochemillay;229;4;233
27;Bourgogne-Franche-Comté;58;1;02;141;Lavault-de-Frétoy;72;0;72
27;Bourgogne-Franche-Comté;58;1;02;142;Limanton;239;1;240
27;Bourgogne-Franche-Comté;58;3;08;143;Limon;141;5;146
27;Bourgogne-Franche-Comté;58;3;16;144;Livry;681;15;696
27;Bourgogne-Franche-Comté;58;1;04;145;Lormes;1267;30;1297
27;Bourgogne-Franche-Comté;58;3;06;146;Lucenay-lès-Aix;981;19;1000
27;Bourgogne-Franche-Comté;58;4;01;147;Lurcy-le-Bourg;276;5;281
27;Bourgogne-Franche-Comté;58;3;16;148;Luthenay-Uxeloup;613;10;623
27;Bourgogne-Franche-Comté;58;1;10;149;Luzy;1994;39;2033
27;Bourgogne-Franche-Comté;58;2;03;150;Lys;108;0;108
27;Bourgogne-Franche-Comté;58;3;09;151;La Machine;3231;52;3283
27;Bourgogne-Franche-Comté;58;3;12;152;Magny-Cours;1404;27;1431
27;Bourgogne-Franche-Comté;58;2;04;153;Magny-Lormes;70;2;72
27;Bourgogne-Franche-Comté;58;2;03;154;La Maison-Dieu;115;1;116
27;Bourgogne-Franche-Comté;58;4;01;155;La Marche;558;17;575
27;Bourgogne-Franche-Comté;58;2;03;156;Marcy;142;2;144
27;Bourgogne-Franche-Comté;58;1;04;157;Marigny-l'Église;279;16;295
27;Bourgogne-Franche-Comté;58;3;16;158;Mars-sur-Allier;304;5;309
27;Bourgogne-Franche-Comté;58;2;04;159;Marigny-sur-Yonne;192;4;196
27;Bourgogne-Franche-Comté;58;3;07;160;Marzy;3701;160;3861
27;Bourgogne-Franche-Comté;58;1;10;161;Maux;145;1;146
27;Bourgogne-Franche-Comté;58;4;15;162;Menestreau;103;3;106
27;Bourgogne-Franche-Comté;58;2;03;163;Menou;187;3;190
27;Bourgogne-Franche-Comté;58;4;15;164;Mesves-sur-Loire;661;29;690
27;Bourgogne-Franche-Comté;58;2;03;165;Metz-le-Comte;166;7;173
27;Bourgogne-Franche-Comté;58;2;04;166;Mhère;230;3;233
27;Bourgogne-Franche-Comté;58;1;10;168;Millay;440;6;446
27;Bourgogne-Franche-Comté;58;2;03;169;Moissy-Moulinot;14;2;16
27;Bourgogne-Franche-Comté;58;2;03;170;Monceaux-le-Comte;124;3;127
27;Bourgogne-Franche-Comté;58;1;02;171;Montapas;288;2;290
27;Bourgogne-Franche-Comté;58;1;10;172;Montambert;121;2;123
27;Bourgogne-Franche-Comté;58;1;10;173;Montaron;156;1;157
27;Bourgogne-Franche-Comté;58;4;01;174;Montenoison;120;2;122
27;Bourgogne-Franche-Comté;58;1;02;175;Mont-et-Marré;155;1;156
27;Bourgogne-Franche-Comté;58;3;08;176;Montigny-aux-Amognes;637;22;659
27;Bourgogne-Franche-Comté;58;1;02;177;Montigny-en-Morvan;276;1;277
27;Bourgogne-Franche-Comté;58;1;10;178;Montigny-sur-Canne;154;2;156
27;Bourgogne-Franche-Comté;58;2;02;179;Montreuillon;258;11;269
27;Bourgogne-Franche-Comté;58;1;02;180;Montsauche-les-Settons;515;3;518
27;Bourgogne-Franche-Comté;58;2;04;181;Moraches;140;2;142
27;Bourgogne-Franche-Comté;58;1;10;182;Moulins-Engilbert;1415;14;1429
27;Bourgogne-Franche-Comté;58;2;04;183;Mouron-sur-Yonne;94;1;95
27;Bourgogne-Franche-Comté;58;4;01;184;Moussy;104;1;105
27;Bourgogne-Franche-Comté;58;1;02;185;Moux-en-Morvan;528;4;532
27;Bourgogne-Franche-Comté;58;4;01;186;Murlin;57;1;58
27;Bourgogne-Franche-Comté;58;4;05;187;Myennes;524;7;531
27;Bourgogne-Franche-Comté;58;4;01;188;Nannay;113;3;116
27;Bourgogne-Franche-Comté;58;4;01;189;Narcy;476;3;479
27;Bourgogne-Franche-Comté;58;2;03;190;Neuffontaines;105;2;107
27;Bourgogne-Franche-Comté;58;2;04;191;Neuilly;111;3;114
27;Bourgogne-Franche-Comté;58;3;16;192;Neuville-lès-Decize;218;9;227
27;Bourgogne-Franche-Comté;58;4;15;193;Neuvy-sur-Loire;1393;29;1422
27;Bourgogne-Franche-Comté;58;3;99;194;Nevers;32284;1001;33285
27;Bourgogne-Franche-Comté;58;1;10;195;La Nocle-Maulaix;276;1;277
27;Bourgogne-Franche-Comté;58;3;08;196;Nolay;344;3;347
27;Bourgogne-Franche-Comté;58;2;03;197;Nuars;163;3;166
27;Bourgogne-Franche-Comté;58;2;03;198;Oisy;299;5;304
27;Bourgogne-Franche-Comté;58;1;02;199;Onlay;157;4;161
27;Bourgogne-Franche-Comté;58;2;03;200;Ouagne;147;1;148
27;Bourgogne-Franche-Comté;58;2;03;201;Oudan;141;3;144
27;Bourgogne-Franche-Comté;58;1;02;202;Ougny;25;0;25
27;Bourgogne-Franche-Comté;58;4;01;203;Oulon;62;1;63
27;Bourgogne-Franche-Comté;58;3;08;204;Vaux d'Amognes;538;7;545
27;Bourgogne-Franche-Comté;58;1;02;205;Ouroux-en-Morvan;600;8;608
27;Bourgogne-Franche-Comté;58;2;03;206;Parigny-la-Rose;34;0;34
27;Bourgogne-Franche-Comté;58;3;17;207;Parigny-les-Vaux;973;32;1005
27;Bourgogne-Franche-Comté;58;2;04;208;Pazy;293;13;306
27;Bourgogne-Franche-Comté;58;4;15;209;Perroy;147;5;152
27;Bourgogne-Franche-Comté;58;1;02;210;Planchez;304;4;308
27;Bourgogne-Franche-Comté;58;1;10;211;Poil;152;3;155
27;Bourgogne-Franche-Comté;58;3;08;212;Poiseux;329;4;333
27;Bourgogne-Franche-Comté;58;4;05;213;Pougny;469;9;478
27;Bourgogne-Franche-Comté;58;3;17;214;Pougues-les-Eaux;2361;49;2410
27;Bourgogne-Franche-Comté;58;4;15;215;Pouilly-sur-Loire;1607;24;1631
27;Bourgogne-Franche-Comté;58;2;04;216;Pouques-Lormes;157;4;161
27;Bourgogne-Franche-Comté;58;2;03;217;Pousseaux;196;4;200
27;Bourgogne-Franche-Comté;58;4;01;218;Prémery;1823;25;1848
27;Bourgogne-Franche-Comté;58;1;10;219;Préporché;207;4;211
27;Bourgogne-Franche-Comté;58;4;01;220;Raveau;645;12;657
27;Bourgogne-Franche-Comté;58;1;10;221;Rémilly;150;2;152
27;Bourgogne-Franche-Comté;58;2;03;222;Rix;157;1;158
27;Bourgogne-Franche-Comté;58;3;08;223;Rouy;637;8;645
27;Bourgogne-Franche-Comté;58;2;03;224;Ruages;88;1;89
27;Bourgogne-Franche-Comté;58;3;13;225;Saincaize-Meauce;369;7;376
27;Bourgogne-Franche-Comté;58;1;02;226;Saint-Agnan;129;2;131
27;Bourgogne-Franche-Comté;58;4;15;227;Saint-Amand-en-Puisaye;1223;21;1244
27;Bourgogne-Franche-Comté;58;4;15;228;Saint-Andelain;592;4;596
27;Bourgogne-Franche-Comté;58;1;04;229;Saint-André-en-Morvan;311;4;315
27;Bourgogne-Franche-Comté;58;2;03;230;Saint-Aubin-des-Chaumes;70;0;70
27;Bourgogne-Franche-Comté;58;4;01;231;Saint-Aubin-les-Forges;387;8;395
27;Bourgogne-Franche-Comté;58;3;08;232;Saint-Benin-d'Azy;1262;20;1282
27;Bourgogne-Franche-Comté;58;3;08;233;Saint-Benin-des-Bois;175;1;176
27;Bourgogne-Franche-Comté;58;4;01;234;Saint-Bonnot;143;1;144
27;Bourgogne-Franche-Comté;58;1;02;235;Saint-Brisson;257;0;257
27;Bourgogne-Franche-Comté;58;4;15;236;Sainte-Colombe-des-Bois;136;2;138
27;Bourgogne-Franche-Comté;58;2;03;237;Saint-Didier;29;2;31
27;Bourgogne-Franche-Comté;58;3;12;238;Saint-Éloi;2223;49;2272
27;Bourgogne-Franche-Comté;58;3;08;239;Saint-Firmin;155;2;157
27;Bourgogne-Franche-Comté;58;3;08;240;Saint-Franchy;78;2;80
27;Bourgogne-Franche-Comté;58;3;06;241;Saint-Germain-Chassenay;314;5;319
27;Bourgogne-Franche-Comté;58;2;03;242;Saint-Germain-des-Bois;124;0;124
27;Bourgogne-Franche-Comté;58;1;10;243;Saint-Gratien-Savigny;115;3;118
27;Bourgogne-Franche-Comté;58;1;02;244;Saint-Hilaire-en-Morvan;215;6;221
27;Bourgogne-Franche-Comté;58;1;10;245;Saint-Hilaire-Fontaine;165;4;169
27;Bourgogne-Franche-Comté;58;1;10;246;Saint-Honoré-les-Bains;698;13;711
27;Bourgogne-Franche-Comté;58;3;08;247;Saint-Jean-aux-Amognes;484;7;491
27;Bourgogne-Franche-Comté;58;4;15;248;Saint-Laurent-l'Abbaye;214;5;219
27;Bourgogne-Franche-Comté;58;1;02;249;Saint-Léger-de-Fougeret;350;2;352
27;Bourgogne-Franche-Comté;58;3;06;250;Saint-Léger-des-Vignes;1799;39;1838
27;Bourgogne-Franche-Comté;58;4;05;251;Saint-Loup-des-Bois;470;7;477
27;Bourgogne-Franche-Comté;58;4;15;252;Saint-Malo-en-Donziois;126;2;128
27;Bourgogne-Franche-Comté;58;3;08;253;Sainte-Marie;81;7;88
27;Bourgogne-Franche-Comté;58;3;08;254;Saint-Martin-d'Heuille;564;12;576
27;Bourgogne-Franche-Comté;58;1;04;255;Saint-Martin-du-Puy;283;5;288
27;Bourgogne-Franche-Comté;58;4;15;256;Saint-Martin-sur-Nohain;378;14;392
27;Bourgogne-Franche-Comté;58;3;08;257;Saint-Maurice;65;1;66
27;Bourgogne-Franche-Comté;58;3;09;258;Saint-Ouen-sur-Loire;531;9;540
27;Bourgogne-Franche-Comté;58;3;16;259;Saint-Parize-en-Viry;142;0;142
27;Bourgogne-Franche-Comté;58;3;16;260;Saint-Parize-le-Châtel;1242;27;1269
27;Bourgogne-Franche-Comté;58;4;05;261;Saint-Père;1055;20;1075
27;Bourgogne-Franche-Comté;58;1;02;262;Saint-Péreuse;209;6;215
27;Bourgogne-Franche-Comté;58;2;03;263;Saint-Pierre-du-Mont;167;2;169
27;Bourgogne-Franche-Comté;58;3;16;264;Saint-Pierre-le-Moûtier;1840;28;1868
27;Bourgogne-Franche-Comté;58;4;15;265;Saint-Quentin-sur-Nohain;91;3;94
27;Bourgogne-Franche-Comté;58;2;04;266;Saint-Révérien;170;0;170
27;Bourgogne-Franche-Comté;58;3;08;267;Saint-Saulge;719;81;800
27;Bourgogne-Franche-Comté;58;1;10;268;Saint-Seine;191;5;196
27;Bourgogne-Franche-Comté;58;3;08;269;Saint-Sulpice;420;10;430
27;Bourgogne-Franche-Comté;58;4;15;270;Saint-Vérain;356;7;363
27;Bourgogne-Franche-Comté;58;2;03;271;Saizy;186;3;189
27;Bourgogne-Franche-Comté;58;2;04;272;Sardy-lès-Épiry;110;3;113
27;Bourgogne-Franche-Comté;58;3;09;273;Sauvigny-les-Bois;1427;33;1460
27;Bourgogne-Franche-Comté;58;1;10;274;Savigny-Poil-Fol;113;3;116
27;Bourgogne-Franche-Comté;58;3;08;275;Saxi-Bourdon;288;5;293
27;Bourgogne-Franche-Comté;58;1;10;276;Sémelay;222;2;224
27;Bourgogne-Franche-Comté;58;1;10;277;Sermages;191;5;196
27;Bourgogne-Franche-Comté;58;3;12;278;Sermoise-sur-Loire;1480;69;1549
27;Bourgogne-Franche-Comté;58;4;01;279;Sichamps;173;6;179
27;Bourgogne-Franche-Comté;58;3;09;280;Sougy-sur-Loire;592;16;608
27;Bourgogne-Franche-Comté;58;4;15;281;Suilly-la-Tour;589;13;602
27;Bourgogne-Franche-Comté;58;2;03;282;Surgy;335;11;346
27;Bourgogne-Franche-Comté;58;2;04;283;Taconnay;73;2;75
27;Bourgogne-Franche-Comté;58;2;03;284;Talon;37;2;39
27;Bourgogne-Franche-Comté;58;1;02;285;Tamnay-en-Bazois;159;5;164
27;Bourgogne-Franche-Comté;58;2;03;286;Tannay;570;12;582
27;Bourgogne-Franche-Comté;58;1;10;287;Tazilly;188;2;190
27;Bourgogne-Franche-Comté;58;2;03;288;Teigny;107;2;109
27;Bourgogne-Franche-Comté;58;1;10;289;Ternant;182;1;183
27;Bourgogne-Franche-Comté;58;1;10;290;Thaix;44;1;45
27;Bourgogne-Franche-Comté;58;3;09;291;Thianges;180;0;180
27;Bourgogne-Franche-Comté;58;1;02;292;Tintury;165;0;165
27;Bourgogne-Franche-Comté;58;3;16;293;Toury-Lurcy;409;4;413
27;Bourgogne-Franche-Comté;58;3;16;294;Toury-sur-Jour;120;0;120
27;Bourgogne-Franche-Comté;58;4;15;295;Tracy-sur-Loire;985;16;1001
27;Bourgogne-Franche-Comté;58;3;16;296;Tresnay;135;1;136
27;Bourgogne-Franche-Comté;58;3;09;297;Trois-Vèvres;244;1;245
27;Bourgogne-Franche-Comté;58;4;01;298;Tronsanges;400;9;409
27;Bourgogne-Franche-Comté;58;2;03;299;Trucy-l'Orgueilleux;220;3;223
27;Bourgogne-Franche-Comté;58;3;08;300;Urzy;1747;31;1778
27;Bourgogne-Franche-Comté;58;1;10;301;Vandenesse;299;5;304
27;Bourgogne-Franche-Comté;58;4;01;302;Varennes-lès-Narcy;921;5;926
27;Bourgogne-Franche-Comté;58;3;17;303;Varennes-Vauzelles;9195;167;9362
27;Bourgogne-Franche-Comté;58;2;03;304;Varzy;1053;198;1251
27;Bourgogne-Franche-Comté;58;2;04;305;Vauclaix;136;1;137
27;Bourgogne-Franche-Comté;58;3;06;306;Verneuil;289;4;293
27;Bourgogne-Franche-Comté;58;4;15;307;Vielmanay;177;4;181
27;Bourgogne-Franche-Comté;58;2;03;308;Vignol;62;0;62
27;Bourgogne-Franche-Comté;58;1;10;309;Villapourçon;409;9;418
27;Bourgogne-Franche-Comté;58;2;03;310;Villiers-le-Sec;48;1;49
27;Bourgogne-Franche-Comté;58;3;08;311;Ville-Langy;238;6;244
27;Bourgogne-Franche-Comté;58;2;03;312;Villiers-sur-Yonne;269;9;278
27;Bourgogne-Franche-Comté;58;2;04;313;Vitry-Laché;87;2;89
32;Hauts-de-France;59;2;09;001;Abancourt;468;13;481
32;Hauts-de-France;59;6;14;002;Abscon;4241;33;4274
32;Hauts-de-France;59;1;19;003;Aibes;371;6;377
32;Hauts-de-France;59;3;31;004;Aix-en-Pévèle;1368;13;1381
32;Hauts-de-France;59;5;02;005;Allennes-les-Marais;3532;61;3593
32;Hauts-de-France;59;1;05;006;Amfroipret;213;8;221
32;Hauts-de-France;59;3;31;007;Anhiers;892;8;900
32;Hauts-de-France;59;3;01;008;Aniche;9944;81;10025
32;Hauts-de-France;59;5;40;009;Villeneuve-d'Ascq;61258;644;61902
32;Hauts-de-France;59;2;09;010;Anneux;257;2;259
32;Hauts-de-France;59;5;02;011;Annœullin;10679;108;10787
32;Hauts-de-France;59;1;19;012;Anor;3254;47;3301
32;Hauts-de-France;59;5;36;013;Anstaing;1559;25;1584
32;Hauts-de-France;59;6;03;014;Anzin;13195;75;13270
32;Hauts-de-France;59;3;01;015;Arleux;3160;26;3186
32;Hauts-de-France;59;4;12;016;Armbouts-Cappel;2159;44;2203
32;Hauts-de-France;59;5;04;017;Armentières;25225;363;25588
32;Hauts-de-France;59;4;41;018;Arnèke;1566;16;1582
32;Hauts-de-France;59;6;06;019;Artres;1055;12;1067
32;Hauts-de-France;59;1;30;021;Assevent;1810;18;1828
32;Hauts-de-France;59;5;36;022;Attiches;2234;30;2264
32;Hauts-de-France;59;2;09;023;Aubencheul-au-Bac;544;7;551
32;Hauts-de-France;59;3;01;024;Auberchicourt;4634;27;4661
32;Hauts-de-France;59;5;02;025;Aubers;1698;28;1726
32;Hauts-de-France;59;3;01;026;Aubigny-au-Bac;1161;16;1177
32;Hauts-de-France;59;6;06;027;Aubry-du-Hainaut;1720;16;1736
32;Hauts-de-France;59;3;31;028;Auby;7205;31;7236
32;Hauts-de-France;59;3;31;029;Auchy-lez-Orchies;1493;20;1513
32;Hauts-de-France;59;1;05;031;Audignies;374;4;378
32;Hauts-de-France;59;6;06;032;Aulnoy-lez-Valenciennes;7167;70;7237
32;Hauts-de-France;59;1;05;033;Aulnoye-Aymeries;8804;238;9042
32;Hauts-de-France;59;5;36;034;Avelin;2616;43;2659
32;Hauts-de-France;59;1;19;035;Avesnelles;2309;46;2355
32;Hauts-de-France;59;1;07;036;Avesnes-sur-Helpe;4158;137;4295
32;Hauts-de-France;59;2;11;037;Avesnes-les-Aubert;3628;34;3662
32;Hauts-de-France;59;6;14;038;Avesnes-le-Sec;1445;18;1463
32;Hauts-de-France;59;2;10;039;Awoingt;812;18;830
32;Hauts-de-France;59;1;05;041;Bachant;2276;16;2292
32;Hauts-de-France;59;5;36;042;Bachy;1836;31;1867
32;Hauts-de-France;59;4;08;043;Bailleul;15026;224;15250
32;Hauts-de-France;59;5;36;044;Baisieux;4993;51;5044
32;Hauts-de-France;59;1;19;045;Baives;166;4;170
32;Hauts-de-France;59;4;41;046;Bambecque;822;2;824
32;Hauts-de-France;59;2;10;047;Banteux;350;3;353
32;Hauts-de-France;59;2;09;048;Bantigny;515;9;524
32;Hauts-de-France;59;2;10;049;Bantouzelle;440;7;447
32;Hauts-de-France;59;1;19;050;Bas-Lieu;342;8;350
32;Hauts-de-France;59;5;02;051;La Bassée;6565;38;6603
32;Hauts-de-France;59;5;02;052;Bauvin;5044;44;5088
32;Hauts-de-France;59;1;05;053;Bavay;3248;60;3308
32;Hauts-de-France;59;4;41;054;Bavinchove;1041;8;1049
32;Hauts-de-France;59;2;10;055;Bazuel;526;10;536
32;Hauts-de-France;59;5;28;056;Beaucamps-Ligny;844;23;867
32;Hauts-de-France;59;1;07;057;Beaudignies;564;4;568
32;Hauts-de-France;59;1;07;058;Beaufort;1013;14;1027
32;Hauts-de-France;59;2;10;059;Beaumont-en-Cambrésis;447;7;454
32;Hauts-de-France;59;2;11;060;Beaurain;232;5;237
32;Hauts-de-France;59;1;07;061;Beaurepaire-sur-Sambre;268;2;270
32;Hauts-de-France;59;1;19;062;Beaurieux;163;7;170
32;Hauts-de-France;59;2;11;063;Beauvois-en-Cambrésis;1970;18;1988
32;Hauts-de-France;59;6;06;064;Bellaing;1263;12;1275
32;Hauts-de-France;59;1;05;065;Bellignies;809;18;827
32;Hauts-de-France;59;1;19;066;Bérelles;161;5;166
32;Hauts-de-France;59;4;12;067;Bergues;3580;43;3623
32;Hauts-de-France;59;1;05;068;Berlaimont;3174;36;3210
32;Hauts-de-France;59;2;11;069;Bermerain;739;12;751
32;Hauts-de-France;59;1;05;070;Bermeries;376;3;379
32;Hauts-de-France;59;5;36;071;Bersée;2271;47;2318
32;Hauts-de-France;59;1;30;072;Bersillies;256;6;262
32;Hauts-de-France;59;4;08;073;Berthen;577;9;586
32;Hauts-de-France;59;2;10;074;Bertry;2158;22;2180
32;Hauts-de-France;59;2;11;075;Béthencourt;736;5;741
32;Hauts-de-France;59;1;30;076;Bettignies;309;5;314
32;Hauts-de-France;59;1;05;077;Bettrechies;259;6;265
32;Hauts-de-France;59;1;19;078;Beugnies;619;6;625
32;Hauts-de-France;59;6;03;079;Beuvrages;6800;33;6833
32;Hauts-de-France;59;3;31;080;Beuvry-la-Forêt;2817;39;2856
32;Hauts-de-France;59;2;11;081;Bévillers;560;11;571
32;Hauts-de-France;59;4;12;082;Bierne;1799;31;1830
32;Hauts-de-France;59;4;41;083;Bissezeele;250;11;261
32;Hauts-de-France;59;4;21;084;Blaringhem;2055;30;2085
32;Hauts-de-France;59;2;09;085;Blécourt;302;6;308
32;Hauts-de-France;59;4;08;086;Boeschepe;2144;31;2175
32;Hauts-de-France;59;4;21;087;Boëseghem;745;13;758
32;Hauts-de-France;59;5;04;088;Bois-Grenier;1802;24;1826
32;Hauts-de-France;59;4;41;089;Bollezeele;1424;30;1454
32;Hauts-de-France;59;5;24;090;Bondues;9759;185;9944
32;Hauts-de-France;59;4;08;091;Borre;575;15;590
32;Hauts-de-France;59;6;14;092;Bouchain;3937;42;3979
32;Hauts-de-France;59;1;07;093;Boulogne-sur-Helpe;325;6;331
32;Hauts-de-France;59;4;20;094;Bourbourg;7087;48;7135
32;Hauts-de-France;59;5;36;096;Bourghelles;1670;40;1710
32;Hauts-de-France;59;2;09;097;Boursies;408;5;413
32;Hauts-de-France;59;5;22;098;Bousbecque;4791;54;4845
32;Hauts-de-France;59;1;07;099;Bousies;1766;16;1782
32;Hauts-de-France;59;6;34;100;Bousignies;354;4;358
32;Hauts-de-France;59;1;19;101;Bousignies-sur-Roc;379;11;390
32;Hauts-de-France;59;2;11;102;Boussières-en-Cambrésis;440;4;444
32;Hauts-de-France;59;1;05;103;Boussières-sur-Sambre;518;8;526
32;Hauts-de-France;59;1;30;104;Boussois;3176;25;3201
32;Hauts-de-France;59;3;31;105;Bouvignies;1532;24;1556
32;Hauts-de-France;59;5;36;106;Bouvines;746;14;760
32;Hauts-de-France;59;4;17;107;Bray-Dunes;4476;45;4521
32;Hauts-de-France;59;2;10;108;Briastre;732;7;739
32;Hauts-de-France;59;6;34;109;Brillon;770;9;779
32;Hauts-de-France;59;4;20;110;Brouckerque;1434;25;1459
32;Hauts-de-France;59;4;41;111;Broxeele;397;4;401
32;Hauts-de-France;59;6;03;112;Bruay-sur-l'Escaut;11325;48;11373
32;Hauts-de-France;59;3;35;113;Bruille-lez-Marchiennes;1354;6;1360
32;Hauts-de-France;59;6;34;114;Bruille-Saint-Amand;1671;18;1689
32;Hauts-de-France;59;3;01;115;Brunémont;710;7;717
32;Hauts-de-France;59;1;05;116;Bry;419;12;431
32;Hauts-de-France;59;3;01;117;Bugnicourt;1058;10;1068
32;Hauts-de-France;59;2;10;118;Busigny;2440;24;2464
32;Hauts-de-France;59;4;41;119;Buysscheure;599;6;605
32;Hauts-de-France;59;4;08;120;Caëstre;2034;33;2067
32;Hauts-de-France;59;2;11;121;Cagnoncles;621;7;628
32;Hauts-de-France;59;2;09;122;Cambrai;31559;569;32128
32;Hauts-de-France;59;5;02;123;Camphin-en-Carembault;1702;24;1726
32;Hauts-de-France;59;5;36;124;Camphin-en-Pévèle;2497;68;2565
32;Hauts-de-France;59;2;10;125;Cantaing-sur-Escaut;405;9;414
32;Hauts-de-France;59;3;01;126;Cantin;1719;14;1733
32;Hauts-de-France;59;2;11;127;Capelle;143;5;148
32;Hauts-de-France;59;5;04;128;Capinghem;2506;31;2537
32;Hauts-de-France;59;5;36;129;Cappelle-en-Pévèle;2265;45;2310
32;Hauts-de-France;59;4;20;130;Cappelle-Brouck;1154;19;1173
32;Hauts-de-France;59;4;12;131;Cappelle-la-Grande;7953;77;8030
32;Hauts-de-France;59;2;11;132;Carnières;1009;13;1022
32;Hauts-de-France;59;5;02;133;Carnin;1054;14;1068
32;Hauts-de-France;59;1;07;134;Cartignies;1257;10;1267
32;Hauts-de-France;59;4;08;135;Cassel;2249;100;2349
32;Hauts-de-France;59;2;10;136;Le Cateau-Cambrésis;7016;137;7153
32;Hauts-de-France;59;2;10;137;Catillon-sur-Sambre;788;8;796
32;Hauts-de-France;59;2;10;138;Cattenières;682;14;696
32;Hauts-de-France;59;2;11;139;Caudry;14028;142;14170
32;Hauts-de-France;59;2;10;140;Caullery;457;9;466
32;Hauts-de-France;59;2;11;141;Cauroir;566;15;581
32;Hauts-de-France;59;1;19;142;Cerfontaine;709;5;714
32;Hauts-de-France;59;5;04;143;La Chapelle-d'Armentières;8656;68;8724
32;Hauts-de-France;59;6;34;144;Château-l'Abbaye;859;10;869
32;Hauts-de-France;59;5;18;145;Chemy;770;12;782
32;Hauts-de-France;59;5;36;146;Chéreng;2978;41;3019
32;Hauts-de-France;59;1;19;147;Choisies;48;2;50
32;Hauts-de-France;59;1;19;148;Clairfayts;363;1;364
32;Hauts-de-France;59;2;10;149;Clary;1086;16;1102
32;Hauts-de-France;59;5;36;150;Cobrieux;535;7;542
32;Hauts-de-France;59;1;19;151;Colleret;1595;22;1617
32;Hauts-de-France;59;5;22;152;Comines;12749;98;12847
32;Hauts-de-France;59;6;29;153;Condé-sur-l'Escaut;9445;53;9498
32;Hauts-de-France;59;4;12;155;Coudekerque-Branche;20708;279;20987
32;Hauts-de-France;59;3;15;156;Courchelettes;2912;35;2947
32;Hauts-de-France;59;1;19;157;Cousolre;2172;20;2192
32;Hauts-de-France;59;3;31;158;Coutiches;3151;46;3197
32;Hauts-de-France;59;4;20;159;Craywick;741;7;748
32;Hauts-de-France;59;6;29;160;Crespin;4481;30;4511
32;Hauts-de-France;59;2;10;161;Crèvecœur-sur-l'Escaut;741;32;773
32;Hauts-de-France;59;4;41;162;Crochte;665;21;686
32;Hauts-de-France;59;5;13;163;Croix;20574;263;20837
32;Hauts-de-France;59;1;07;164;Croix-Caluyau;244;8;252
32;Hauts-de-France;59;3;15;165;Cuincy;6444;65;6509
32;Hauts-de-France;59;6;29;166;Curgies;1348;36;1384
32;Hauts-de-France;59;2;09;167;Cuvillers;207;1;208
32;Hauts-de-France;59;5;36;168;Cysoing;4798;68;4866
32;Hauts-de-France;59;1;19;169;Damousies;207;4;211
32;Hauts-de-France;59;3;01;170;Dechy;5352;33;5385
32;Hauts-de-France;59;2;10;171;Dehéries;38;1;39
32;Hauts-de-France;59;6;14;172;Denain;20415;117;20532
32;Hauts-de-France;59;5;04;173;Deûlémont;1843;25;1868
32;Hauts-de-France;59;1;19;174;Dimechaux;326;2;328
32;Hauts-de-France;59;1;19;175;Dimont;310;9;319
32;Hauts-de-France;59;2;09;176;Doignies;323;3;326
32;Hauts-de-France;59;1;07;177;Dompierre-sur-Helpe;858;14;872
32;Hauts-de-France;59;3;15;178;Douai;39842;855;40697
32;Hauts-de-France;59;6;14;179;Douchy-les-Mines;10144;35;10179
32;Hauts-de-France;59;4;08;180;Le Doulieu;1462;19;1481
32;Hauts-de-France;59;1;07;181;Dourlers;542;6;548
32;Hauts-de-France;59;4;20;182;Drincham;274;4;278
32;Hauts-de-France;59;4;96;183;Dunkerque;86545;1260;87805
32;Hauts-de-France;59;4;21;184;Ebblinghem;660;10;670
32;Hauts-de-France;59;3;01;185;Écaillon;1936;13;1949
32;Hauts-de-France;59;1;19;186;Eccles;84;2;86
32;Hauts-de-France;59;1;07;187;Éclaibes;265;5;270
32;Hauts-de-France;59;1;05;188;Écuélin;140;4;144
32;Hauts-de-France;59;4;08;189;Eecke;1222;27;1249
32;Hauts-de-France;59;1;30;190;Élesmes;998;14;1012
32;Hauts-de-France;59;2;10;191;Élincourt;630;4;634
32;Hauts-de-France;59;6;14;192;Émerchicourt;826;47;873
32;Hauts-de-France;59;5;18;193;Emmerin;3077;24;3101
32;Hauts-de-France;59;1;07;194;Englefontaine;1271;22;1293
32;Hauts-de-France;59;5;28;195;Englos;615;9;624
32;Hauts-de-France;59;5;28;196;Ennetières-en-Weppes;1299;20;1319
32;Hauts-de-France;59;5;36;197;Ennevelin;2295;28;2323
32;Hauts-de-France;59;1;19;198;Eppe-Sauvage;243;0;243
32;Hauts-de-France;59;3;01;199;Erchin;690;11;701
32;Hauts-de-France;59;4;41;200;Eringhem;492;9;501
32;Hauts-de-France;59;5;28;201;Erquinghem-le-Sec;595;11;606
32;Hauts-de-France;59;5;04;202;Erquinghem-Lys;5364;38;5402
32;Hauts-de-France;59;3;35;203;Erre;1580;9;1589
32;Hauts-de-France;59;2;11;204;Escarmain;482;8;490
32;Hauts-de-France;59;6;14;205;Escaudain;9445;44;9489
32;Hauts-de-France;59;2;09;206;Escaudœuvres;3186;28;3214
32;Hauts-de-France;59;6;03;207;Escautpont;4172;28;4200
32;Hauts-de-France;59;5;28;208;Escobecques;304;11;315
32;Hauts-de-France;59;2;10;209;Esnes;673;8;681
32;Hauts-de-France;59;4;41;210;Esquelbecq;2125;51;2176
32;Hauts-de-France;59;3;15;211;Esquerchin;914;20;934
32;Hauts-de-France;59;4;21;212;Estaires;6501;123;6624
32;Hauts-de-France;59;2;11;213;Estourmel;457;15;472
32;Hauts-de-France;59;3;01;214;Estrées;1111;24;1135
32;Hauts-de-France;59;6;29;215;Estreux;960;33;993
32;Hauts-de-France;59;2;09;216;Eswars;349;8;357
32;Hauts-de-France;59;1;05;217;Eth;347;7;354
32;Hauts-de-France;59;1;07;218;Étrœungt;1291;16;1307
32;Hauts-de-France;59;2;09;219;Estrun;718;8;726
32;Hauts-de-France;59;5;18;220;Faches-Thumesnil;18160;120;18280
32;Hauts-de-France;59;6;06;221;Famars;2494;68;2562
32;Hauts-de-France;59;3;31;222;Faumont;2235;46;2281
32;Hauts-de-France;59;1;07;223;Le Favril;501;4;505
32;Hauts-de-France;59;3;01;224;Féchain;1675;13;1688
32;Hauts-de-France;59;1;05;225;Feignies;6763;68;6831
32;Hauts-de-France;59;1;19;226;Felleries;1458;15;1473
32;Hauts-de-France;59;3;35;227;Fenain;5516;48;5564
32;Hauts-de-France;59;3;01;228;Férin;1452;22;1474
32;Hauts-de-France;59;1;19;229;Féron;546;19;565
32;Hauts-de-France;59;1;30;230;Ferrière-la-Grande;5239;53;5292
32;Hauts-de-France;59;1;19;231;Ferrière-la-Petite;1081;13;1094
32;Hauts-de-France;59;1;05;232;La Flamengrie;436;4;440
32;Hauts-de-France;59;1;19;233;Flaumont-Waudrechies;356;3;359
32;Hauts-de-France;59;3;15;234;Flers-en-Escrebieux;5751;41;5792
32;Hauts-de-France;59;2;10;236;Flesquières;263;4;267
32;Hauts-de-France;59;4;08;237;Flêtre;992;23;1015
32;Hauts-de-France;59;6;34;238;Flines-lès-Mortagne;1630;25;1655
32;Hauts-de-France;59;3;31;239;Flines-lez-Raches;5612;91;5703
32;Hauts-de-France;59;1;07;240;Floursies;127;3;130
32;Hauts-de-France;59;1;07;241;Floyon;515;14;529
32;Hauts-de-France;59;1;07;242;Fontaine-au-Bois;680;6;686
32;Hauts-de-France;59;2;10;243;Fontaine-au-Pire;1217;12;1229
32;Hauts-de-France;59;2;09;244;Fontaine-Notre-Dame;1767;30;1797
32;Hauts-de-France;59;1;07;246;Forest-en-Cambrésis;575;3;578
32;Hauts-de-France;59;5;40;247;Forest-sur-Marque;1503;17;1520
32;Hauts-de-France;59;1;19;249;Fourmies;11403;171;11574
32;Hauts-de-France;59;5;02;250;Fournes-en-Weppes;2220;107;2327
32;Hauts-de-France;59;1;05;251;Frasnoy;376;4;380
32;Hauts-de-France;59;5;04;252;Frelinghien;2482;22;2504
32;Hauts-de-France;59;6;03;253;Fresnes-sur-Escaut;7453;38;7491
32;Hauts-de-France;59;3;01;254;Fressain;880;12;892
32;Hauts-de-France;59;2;09;255;Fressies;572;5;577
32;Hauts-de-France;59;5;36;256;Fretin;3245;33;3278
32;Hauts-de-France;59;5;02;257;Fromelles;1065;14;1079
32;Hauts-de-France;59;5;36;258;Genech;2839;624;3463
32;Hauts-de-France;59;1;07;259;Ghissignies;502;20;522
32;Hauts-de-France;59;4;17;260;Ghyvelde;4111;59;4170
32;Hauts-de-France;59;1;19;261;Glageon;1751;29;1780
32;Hauts-de-France;59;4;08;262;Godewaersvelde;2070;28;2098
32;Hauts-de-France;59;3;01;263;Gœulzin;1045;26;1071
32;Hauts-de-France;59;1;30;264;Gognies-Chaussée;728;11;739
32;Hauts-de-France;59;1;05;265;Gommegnies;2295;36;2331
32;Hauts-de-France;59;5;18;266;Gondecourt;4000;39;4039
32;Hauts-de-France;59;2;10;267;Gonnelieu;295;7;302
32;Hauts-de-France;59;4;21;268;La Gorgue;5640;52;5692
32;Hauts-de-France;59;2;10;269;Gouzeaucourt;1463;25;1488
32;Hauts-de-France;59;1;07;270;Grand-Fayt;477;7;484
32;Hauts-de-France;59;4;20;271;Grande-Synthe;20635;205;20840
32;Hauts-de-France;59;4;20;272;Grand-Fort-Philippe;5054;49;5103
32;Hauts-de-France;59;4;20;273;Gravelines;11001;174;11175
32;Hauts-de-France;59;2;10;274;La Groise;481;4;485
32;Hauts-de-France;59;5;36;275;Gruson;1246;35;1281
32;Hauts-de-France;59;3;01;276;Guesnain;4667;28;4695
32;Hauts-de-France;59;1;05;277;Gussignies;339;3;342
32;Hauts-de-France;59;5;28;278;Hallennes-lez-Haubourdin;4697;36;4733
32;Hauts-de-France;59;5;37;279;Halluin;20812;122;20934
32;Hauts-de-France;59;3;01;280;Hamel;780;9;789
32;Hauts-de-France;59;5;02;281;Hantay;1269;12;1281
32;Hauts-de-France;59;4;41;282;Hardifort;401;9;410
32;Hauts-de-France;59;1;05;283;Hargnies;622;10;632
32;Hauts-de-France;59;6;34;284;Hasnon;3894;37;3931
32;Hauts-de-France;59;6;06;285;Haspres;2650;20;2670
32;Hauts-de-France;59;5;18;286;Haubourdin;14556;105;14661
32;Hauts-de-France;59;2;10;287;Haucourt-en-Cambrésis;190;4;194
32;Hauts-de-France;59;6;06;288;Haulchin;2328;26;2354
32;Hauts-de-France;59;2;11;289;Haussy;1514;32;1546
32;Hauts-de-France;59;1;07;290;Haut-Lieu;388;1;389
32;Hauts-de-France;59;1;07;291;Hautmont;14318;95;14413
32;Hauts-de-France;59;6;06;292;Haveluy;3276;12;3288
32;Hauts-de-France;59;4;21;293;Haverskerque;1408;18;1426
32;Hauts-de-France;59;2;09;294;Haynecourt;309;7;316
32;Hauts-de-France;59;4;21;295;Hazebrouck;21464;405;21869
32;Hauts-de-France;59;1;07;296;Hecq;350;10;360
32;Hauts-de-France;59;6;34;297;Hélesmes;1937;19;1956
32;Hauts-de-France;59;5;13;299;Hem;18462;148;18610
32;Hauts-de-France;59;2;09;300;Hem-Lenglet;549;9;558
32;Hauts-de-France;59;6;29;301;Hergnies;4465;27;4492
32;Hauts-de-France;59;6;06;302;Hérin;4125;28;4153
32;Hauts-de-France;59;5;02;303;Herlies;2358;29;2387
32;Hauts-de-France;59;5;18;304;Herrin;421;7;428
32;Hauts-de-France;59;4;41;305;Herzeele;1642;35;1677
32;Hauts-de-France;59;1;19;306;Hestrud;295;3;298
32;Hauts-de-France;59;4;41;307;Holque;887;2;889
32;Hauts-de-France;59;4;08;308;Hondeghem;922;23;945
32;Hauts-de-France;59;4;41;309;Hondschoote;4041;82;4123
32;Hauts-de-France;59;1;05;310;Hon-Hergies;869;10;879
32;Hauts-de-France;59;2;10;311;Honnechy;567;6;573
32;Hauts-de-France;59;2;10;312;Honnecourt-sur-Escaut;743;16;759
32;Hauts-de-France;59;6;14;313;Hordain;1431;15;1446
32;Hauts-de-France;59;3;35;314;Hornaing;3548;35;3583
32;Hauts-de-France;59;1;05;315;Houdain-lez-Bavay;892;12;904
32;Hauts-de-France;59;5;18;316;Houplin-Ancoisne;3299;45;3344
32;Hauts-de-France;59;5;04;317;Houplines;7870;96;7966
32;Hauts-de-France;59;4;41;318;Houtkerque;986;9;995
32;Hauts-de-France;59;4;41;319;Hoymille;3185;202;3387
32;Hauts-de-France;59;5;02;320;Illies;1640;12;1652
32;Hauts-de-France;59;2;10;321;Inchy;643;5;648
32;Hauts-de-France;59;2;11;322;Iwuy;3358;31;3389
32;Hauts-de-France;59;1;05;323;Jenlain;1150;27;1177
32;Hauts-de-France;59;1;30;324;Jeumont;10447;97;10544
32;Hauts-de-France;59;1;07;325;Jolimetz;856;14;870
32;Hauts-de-France;59;4;41;326;Killem;1175;21;1196
32;Hauts-de-France;59;3;35;327;Lallaing;6311;35;6346
32;Hauts-de-France;59;5;22;328;Lambersart;27425;443;27868
32;Hauts-de-France;59;3;15;329;Lambres-lez-Douai;4953;85;5038
32;Hauts-de-France;59;3;31;330;Landas;2414;38;2452
32;Hauts-de-France;59;1;07;331;Landrecies;3456;89;3545
32;Hauts-de-France;59;5;13;332;Lannoy;1810;8;1818
32;Hauts-de-France;59;1;07;333;Larouillies;249;9;258
32;Hauts-de-France;59;3;15;334;Lauwin-Planque;1604;22;1626
32;Hauts-de-France;59;6;34;335;Lecelles;2896;57;2953
32;Hauts-de-France;59;3;01;336;Lécluse;1366;15;1381
32;Hauts-de-France;59;4;41;337;Lederzeele;687;20;707
32;Hauts-de-France;59;4;41;338;Ledringhem;640;20;660
32;Hauts-de-France;59;5;33;339;Leers;9548;80;9628
32;Hauts-de-France;59;4;17;340;Leffrinckoucke;4150;100;4250
32;Hauts-de-France;59;2;10;341;Lesdain;439;7;446
32;Hauts-de-France;59;1;19;342;Lez-Fontaine;223;4;227
32;Hauts-de-France;59;5;36;343;Lesquin;9113;86;9199
32;Hauts-de-France;59;1;05;344;Leval;2500;10;2510
32;Hauts-de-France;59;3;01;345;Lewarde;2418;24;2442
32;Hauts-de-France;59;5;26;346;Lezennes;3038;20;3058
32;Hauts-de-France;59;1;19;347;Liessies;534;16;550
32;Hauts-de-France;59;6;14;348;Lieu-Saint-Amand;1465;15;1480
32;Hauts-de-France;59;2;10;349;Ligny-en-Cambrésis;1928;30;1958
32;Hauts-de-France;59;5;97;350;Lille;236234;1870;238104
32;Hauts-de-France;59;1;07;351;Limont-Fontaine;544;7;551
32;Hauts-de-France;59;5;22;352;Linselles;8211;96;8307
32;Hauts-de-France;59;1;07;353;Locquignol;302;6;308
32;Hauts-de-France;59;3;01;354;Loffre;719;13;732
32;Hauts-de-France;59;5;22;356;Lompret;2195;47;2242
32;Hauts-de-France;59;1;05;357;La Longueville;2070;33;2103
32;Hauts-de-France;59;4;20;358;Looberghe;1195;23;1218
32;Hauts-de-France;59;4;20;359;Loon-Plage;6083;74;6157
32;Hauts-de-France;59;5;28;360;Loos;22896;257;23153
32;Hauts-de-France;59;6;14;361;Lourches;3872;23;3895
32;Hauts-de-France;59;1;07;363;Louvignies-Quesnoy;922;17;939
32;Hauts-de-France;59;5;36;364;Louvil;890;12;902
32;Hauts-de-France;59;1;30;365;Louvroil;6389;40;6429
32;Hauts-de-France;59;4;21;366;Lynde;779;15;794
32;Hauts-de-France;59;5;13;367;Lys-lez-Lannoy;13797;145;13942
32;Hauts-de-France;59;5;23;368;La Madeleine;22214;173;22387
32;Hauts-de-France;59;6;06;369;Maing;4039;53;4092
32;Hauts-de-France;59;1;30;370;Mairieux;700;11;711
32;Hauts-de-France;59;5;02;371;Le Maisnil;634;15;649
32;Hauts-de-France;59;2;10;372;Malincourt;481;5;486
32;Hauts-de-France;59;1;07;374;Marbaix;470;4;474
32;Hauts-de-France;59;3;35;375;Marchiennes;4549;63;4612
32;Hauts-de-France;59;2;10;377;Marcoing;1897;25;1922
32;Hauts-de-France;59;5;24;378;Marcq-en-Barœul;38604;715;39319
32;Hauts-de-France;59;3;01;379;Marcq-en-Ostrevent;755;3;758
32;Hauts-de-France;59;1;07;381;Maresches;808;20;828
32;Hauts-de-France;59;2;10;382;Maretz;1430;14;1444
32;Hauts-de-France;59;6;29;383;Marly;12014;121;12135
32;Hauts-de-France;59;1;07;384;Maroilles;1432;22;1454
32;Hauts-de-France;59;1;30;385;Marpent;2674;21;2695
32;Hauts-de-France;59;5;23;386;Marquette-lez-Lille;11105;70;11175
32;Hauts-de-France;59;6;14;387;Marquette-en-Ostrevant;1919;12;1931
32;Hauts-de-France;59;5;02;388;Marquillies;1987;24;2011
32;Hauts-de-France;59;2;10;389;Masnières;2757;30;2787
32;Hauts-de-France;59;3;01;390;Masny;4080;42;4122
32;Hauts-de-France;59;6;14;391;Mastaing;887;5;892
32;Hauts-de-France;59;1;30;392;Maubeuge;29625;288;29913
32;Hauts-de-France;59;6;34;393;Maulde;1007;13;1020
32;Hauts-de-France;59;2;10;394;Maurois;404;2;406
32;Hauts-de-France;59;2;10;395;Mazinghien;297;5;302
32;Hauts-de-France;59;1;05;396;Mecquignies;713;11;724
32;Hauts-de-France;59;4;41;397;Merckeghem;603;12;615
32;Hauts-de-France;59;5;36;398;Mérignies;3289;135;3424
32;Hauts-de-France;59;4;08;399;Merris;1009;30;1039
32;Hauts-de-France;59;4;21;400;Merville;9692;88;9780
32;Hauts-de-France;59;4;08;401;Méteren;2281;30;2311
32;Hauts-de-France;59;4;41;402;Millam;854;22;876
32;Hauts-de-France;59;6;34;403;Millonfosse;715;7;722
32;Hauts-de-France;59;2;09;405;Mœuvres;485;3;488
32;Hauts-de-France;59;1;05;406;Monceau-Saint-Waast;435;6;441
32;Hauts-de-France;59;6;06;407;Monchaux-sur-Écaillon;548;9;557
32;Hauts-de-France;59;5;36;408;Moncheaux;1723;20;1743
32;Hauts-de-France;59;3;01;409;Monchecourt;2508;19;2527
32;Hauts-de-France;59;5;25;410;Mons-en-Barœul;21564;133;21697
32;Hauts-de-France;59;5;36;411;Mons-en-Pévèle;2105;37;2142
32;Hauts-de-France;59;2;10;412;Montay;273;4;277
32;Hauts-de-France;59;2;10;413;Montigny-en-Cambrésis;555;7;562
32;Hauts-de-France;59;3;01;414;Montigny-en-Ostrevent;4774;35;4809
32;Hauts-de-France;59;2;11;415;Montrécourt;224;1;225
32;Hauts-de-France;59;4;21;416;Morbecque;2518;41;2559
32;Hauts-de-France;59;6;34;418;Mortagne-du-Nord;1584;7;1591
32;Hauts-de-France;59;5;36;419;Mouchin;1416;16;1432
32;Hauts-de-France;59;1;19;420;Moustier-en-Fagne;58;2;60
32;Hauts-de-France;59;5;24;421;Mouvaux;13020;190;13210
32;Hauts-de-France;59;2;11;422;Naves;627;12;639
32;Hauts-de-France;59;4;21;423;Neuf-Berquin;1365;20;1385
32;Hauts-de-France;59;1;05;424;Neuf-Mesnil;1316;5;1321
32;Hauts-de-France;59;1;07;425;Neuville-en-Avesnois;303;8;311
32;Hauts-de-France;59;5;37;426;Neuville-en-Ferrain;10126;68;10194
32;Hauts-de-France;59;5;36;427;La Neuville;633;11;644
32;Hauts-de-France;59;2;09;428;Neuville-Saint-Rémy;3923;40;3963
32;Hauts-de-France;59;6;14;429;Neuville-sur-Escaut;2688;14;2702
32;Hauts-de-France;59;2;10;430;Neuvilly;1084;11;1095
32;Hauts-de-France;59;4;08;431;Nieppe;7528;84;7612
32;Hauts-de-France;59;2;10;432;Niergnies;513;7;520
32;Hauts-de-France;59;4;41;433;Nieurlet;905;12;917
32;Hauts-de-France;59;6;34;434;Nivelle;1361;17;1378
32;Hauts-de-France;59;3;31;435;Nomain;2569;36;2605
32;Hauts-de-France;59;4;41;436;Noordpeene;787;10;797
32;Hauts-de-France;59;5;18;437;Noyelles-lès-Seclin;852;15;867
32;Hauts-de-France;59;2;10;438;Noyelles-sur-Escaut;813;13;826
32;Hauts-de-France;59;1;05;439;Noyelles-sur-Sambre;273;7;280
32;Hauts-de-France;59;6;14;440;Noyelles-sur-Selle;685;11;696
32;Hauts-de-France;59;1;05;441;Obies;652;6;658
32;Hauts-de-France;59;1;19;442;Obrechies;270;6;276
32;Hauts-de-France;59;4;41;443;Ochtezeele;388;5;393
32;Hauts-de-France;59;6;29;444;Odomez;918;10;928
32;Hauts-de-France;59;1;19;445;Ohain;1193;18;1211
32;Hauts-de-France;59;6;06;446;Oisy;679;8;687
32;Hauts-de-France;59;6;03;447;Onnaing;8742;65;8807
32;Hauts-de-France;59;4;41;448;Oost-Cappel;474;5;479
32;Hauts-de-France;59;3;31;449;Orchies;8529;143;8672
32;Hauts-de-France;59;2;10;450;Ors;638;9;647
32;Hauts-de-France;59;1;07;451;Orsinval;555;10;565
32;Hauts-de-France;59;5;02;452;Ostricourt;5644;31;5675
32;Hauts-de-France;59;4;41;453;Oudezeele;672;14;686
32;Hauts-de-France;59;4;08;454;Oxelaëre;522;5;527
32;Hauts-de-France;59;2;09;455;Paillencourt;1007;8;1015
32;Hauts-de-France;59;3;35;456;Pecquencourt;6225;264;6489
32;Hauts-de-France;59;5;04;457;Pérenchies;8584;45;8629
32;Hauts-de-France;59;5;36;458;Péronne-en-Mélantois;972;20;992
32;Hauts-de-France;59;6;06;459;Petite-Forêt;5080;39;5119
32;Hauts-de-France;59;1;07;461;Petit-Fayt;302;6;308
32;Hauts-de-France;59;5;02;462;Phalempin;4834;51;4885
32;Hauts-de-France;59;4;20;463;Pitgam;976;12;988
32;Hauts-de-France;59;1;07;464;Poix-du-Nord;2224;16;2240
32;Hauts-de-France;59;2;10;465;Pommereuil;778;3;781
32;Hauts-de-France;59;5;36;466;Pont-à-Marcq;2924;90;3014
32;Hauts-de-France;59;1;05;467;Pont-sur-Sambre;2434;27;2461
32;Hauts-de-France;59;1;07;468;Potelle;442;3;445
32;Hauts-de-France;59;4;08;469;Pradelles;415;4;419
32;Hauts-de-France;59;5;04;470;Prémesques;2092;32;2124
32;Hauts-de-France;59;6;29;471;Préseau;2048;24;2072
32;Hauts-de-France;59;1;07;472;Preux-au-Bois;833;8;841
32;Hauts-de-France;59;1;05;473;Preux-au-Sart;306;7;313
32;Hauts-de-France;59;1;07;474;Prisches;1042;21;1063
32;Hauts-de-France;59;6;06;475;Prouvy;2190;19;2209
32;Hauts-de-France;59;2;09;476;Proville;3090;75;3165
32;Hauts-de-France;59;5;02;477;Provin;4488;44;4532
32;Hauts-de-France;59;4;41;478;Quaëdypre;1123;26;1149
32;Hauts-de-France;59;6;29;479;Quarouble;3108;27;3135
32;Hauts-de-France;59;6;06;480;Quérénaing;859;21;880
32;Hauts-de-France;59;1;07;481;Le Quesnoy;4863;120;4983
32;Hauts-de-France;59;5;22;482;Quesnoy-sur-Deûle;6985;60;7045
32;Hauts-de-France;59;1;19;483;Quiévelon;137;2;139
32;Hauts-de-France;59;6;29;484;Quiévrechain;6354;33;6387
32;Hauts-de-France;59;2;11;485;Quiévy;1801;19;1820
32;Hauts-de-France;59;3;31;486;Râches;2682;42;2724
32;Hauts-de-France;59;5;02;487;Radinghem-en-Weppes;1398;20;1418
32;Hauts-de-France;59;2;09;488;Raillencourt-Sainte-Olle;2155;40;2195
32;Hauts-de-France;59;3;31;489;Raimbeaucourt;4010;54;4064
32;Hauts-de-France;59;1;19;490;Rainsars;183;1;184
32;Hauts-de-France;59;6;34;491;Raismes;12201;52;12253
32;Hauts-de-France;59;2;09;492;Ramillies;605;7;612
32;Hauts-de-France;59;1;19;493;Ramousies;227;1;228
32;Hauts-de-France;59;1;07;494;Raucourt-au-Bois;156;1;157
32;Hauts-de-France;59;1;19;495;Recquignies;2460;25;2485
32;Hauts-de-France;59;2;10;496;Rejet-de-Beaulieu;237;1;238
32;Hauts-de-France;59;4;21;497;Renescure;2140;29;2169
32;Hauts-de-France;59;2;10;498;Reumont;347;8;355
32;Hauts-de-France;59;4;41;499;Rexpoëde;2000;33;2033
32;Hauts-de-France;59;2;10;500;Ribécourt-la-Tour;375;5;380
32;Hauts-de-France;59;3;35;501;Rieulay;1258;25;1283
32;Hauts-de-France;59;2;11;502;Rieux-en-Cambrésis;1439;10;1449
32;Hauts-de-France;59;1;07;503;Robersart;201;3;204
32;Hauts-de-France;59;6;14;504;Rœulx;3798;18;3816
32;Hauts-de-France;59;6;29;505;Rombies-et-Marchipont;755;7;762
32;Hauts-de-France;59;2;11;506;Romeries;470;7;477
32;Hauts-de-France;59;5;26;507;Ronchin;18933;128;19061
32;Hauts-de-France;59;5;37;508;Roncq;13560;115;13675
32;Hauts-de-France;59;3;31;509;Roost-Warendin;5985;47;6032
32;Hauts-de-France;59;6;34;511;Rosult;1948;27;1975
32;Hauts-de-France;59;5;98;512;Roubaix;98066;414;98480
32;Hauts-de-France;59;3;01;513;Roucourt;455;5;460
32;Hauts-de-France;59;1;19;514;Rousies;4089;53;4142
32;Hauts-de-France;59;6;06;515;Rouvignies;660;6;666
32;Hauts-de-France;59;4;41;516;Rubrouck;924;22;946
32;Hauts-de-France;59;2;10;517;Les Rues-des-Vignes;756;14;770
32;Hauts-de-France;59;1;07;518;Ruesnes;459;7;466
32;Hauts-de-France;59;6;34;519;Rumegies;1739;33;1772
32;Hauts-de-France;59;2;10;520;Rumilly-en-Cambrésis;1431;25;1456
32;Hauts-de-France;59;2;09;521;Sailly-lez-Cambrai;429;8;437
32;Hauts-de-France;59;5;40;522;Sailly-lez-Lannoy;1943;38;1981
32;Hauts-de-France;59;5;36;523;Sainghin-en-Mélantois;2840;28;2868
32;Hauts-de-France;59;5;02;524;Sainghin-en-Weppes;5597;50;5647
32;Hauts-de-France;59;1;19;525;Sains-du-Nord;2787;25;2812
32;Hauts-de-France;59;6;34;526;Saint-Amand-les-Eaux;15997;180;16177
32;Hauts-de-France;59;5;23;527;Saint-André-lez-Lille;13004;100;13104
32;Hauts-de-France;59;2;11;528;Saint-Aubert;1563;17;1580
32;Hauts-de-France;59;1;07;529;Saint-Aubin;349;8;357
32;Hauts-de-France;59;6;29;530;Saint-Aybert;333;1;334
32;Hauts-de-France;59;2;10;531;Saint-Benin;340;6;346
32;Hauts-de-France;59;4;20;532;Saint-Georges-sur-l'Aa;302;3;305
32;Hauts-de-France;59;2;11;533;Saint-Hilaire-lez-Cambrai;1559;16;1575
32;Hauts-de-France;59;1;07;534;Saint-Hilaire-sur-Helpe;832;31;863
32;Hauts-de-France;59;4;08;535;Saint-Jans-Cappel;1675;47;1722
32;Hauts-de-France;59;4;08;536;Sainte-Marie-Cappel;880;25;905
32;Hauts-de-France;59;2;11;537;Saint-Martin-sur-Écaillon;502;9;511
32;Hauts-de-France;59;4;41;538;Saint-Momelin;420;11;431
32;Hauts-de-France;59;4;20;539;Saint-Pierre-Brouck;984;15;999
32;Hauts-de-France;59;2;11;541;Saint-Python;1013;8;1021
32;Hauts-de-France;59;1;05;542;Saint-Remy-Chaussée;498;8;506
32;Hauts-de-France;59;1;07;543;Saint-Remy-du-Nord;1083;11;1094
32;Hauts-de-France;59;6;39;544;Saint-Saulve;11268;148;11416
32;Hauts-de-France;59;2;10;545;Saint-Souplet;1203;23;1226
32;Hauts-de-France;59;4;08;546;Saint-Sylvestre-Cappel;1150;29;1179
32;Hauts-de-France;59;2;11;547;Saint-Vaast-en-Cambrésis;852;8;860
32;Hauts-de-France;59;1;05;548;Saint-Waast;644;8;652
32;Hauts-de-France;59;1;07;549;Salesches;330;3;333
32;Hauts-de-France;59;5;02;550;Salomé;2985;21;3006
32;Hauts-de-France;59;3;31;551;Saméon;1738;23;1761
32;Hauts-de-France;59;2;09;552;Sancourt;195;6;201
32;Hauts-de-France;59;5;28;553;Santes;5663;51;5714
32;Hauts-de-France;59;6;34;554;Sars-et-Rosières;618;15;633
32;Hauts-de-France;59;1;19;555;Sars-Poteries;1432;18;1450
32;Hauts-de-France;59;1;05;556;Sassegnies;261;3;264
32;Hauts-de-France;59;6;29;557;Saultain;2577;17;2594
32;Hauts-de-France;59;2;11;558;Saulzoir;1684;19;1703
32;Hauts-de-France;59;6;29;559;Sebourg;1989;33;2022
32;Hauts-de-France;59;5;18;560;Seclin;12505;93;12598
32;Hauts-de-France;59;1;19;562;Sémeries;538;7;545
32;Hauts-de-France;59;1;07;563;Semousies;234;3;237
32;Hauts-de-France;59;6;06;564;La Sentinelle;3151;16;3167
32;Hauts-de-France;59;1;07;565;Sepmeries;649;11;660
32;Hauts-de-France;59;5;28;566;Sequedin;4812;38;4850
32;Hauts-de-France;59;2;10;567;Séranvillers-Forenville;416;6;422
32;Hauts-de-France;59;4;21;568;Sercus;484;8;492
32;Hauts-de-France;59;3;35;569;Sin-le-Noble;15442;97;15539
32;Hauts-de-France;59;4;41;570;Socx;906;19;925
32;Hauts-de-France;59;2;11;571;Solesmes;4266;108;4374
32;Hauts-de-France;59;1;19;572;Solre-le-Château;1777;21;1798
32;Hauts-de-France;59;1;19;573;Solrinnes;141;3;144
32;Hauts-de-France;59;3;35;574;Somain;11869;83;11952
32;Hauts-de-France;59;2;11;575;Sommaing;399;4;403
32;Hauts-de-France;59;4;12;576;Spycker;1779;36;1815
32;Hauts-de-France;59;4;08;577;Staple;671;4;675
32;Hauts-de-France;59;4;21;578;Steenbecque;1662;29;1691
32;Hauts-de-France;59;4;12;579;Steene;1373;25;1398
32;Hauts-de-France;59;4;41;580;Steenvoorde;4341;67;4408
32;Hauts-de-France;59;4;08;581;Steenwerck;3606;55;3661
32;Hauts-de-France;59;4;08;582;Strazeele;947;23;970
32;Hauts-de-France;59;1;07;583;Taisnières-en-Thiérache;473;4;477
32;Hauts-de-France;59;1;05;584;Taisnières-sur-Hon;957;12;969
32;Hauts-de-France;59;5;18;585;Templemars;3528;35;3563
32;Hauts-de-France;59;5;36;586;Templeuve-en-Pévèle;6469;90;6559
32;Hauts-de-France;59;4;41;587;Terdeghem;517;14;531
32;Hauts-de-France;59;4;12;588;Téteghem-Coudekerque-Village;8258;216;8474
32;Hauts-de-France;59;6;06;589;Thiant;3000;24;3024
32;Hauts-de-France;59;4;21;590;Thiennes;918;13;931
32;Hauts-de-France;59;6;29;591;Thivencelle;827;3;830
32;Hauts-de-France;59;5;36;592;Thumeries;3957;44;4001
32;Hauts-de-France;59;2;09;593;Thun-l'Évêque;756;11;767
32;Hauts-de-France;59;6;34;594;Thun-Saint-Amand;1116;13;1129
32;Hauts-de-France;59;2;09;595;Thun-Saint-Martin;541;8;549
32;Hauts-de-France;59;3;35;596;Tilloy-lez-Marchiennes;519;20;539
32;Hauts-de-France;59;2;09;597;Tilloy-lez-Cambrai;682;23;705
32;Hauts-de-France;59;5;40;598;Toufflers;3914;31;3945
32;Hauts-de-France;59;5;99;599;Tourcoing;99165;661;99826
32;Hauts-de-France;59;5;36;600;Tourmignies;940;15;955
32;Hauts-de-France;59;1;19;601;Trélon;2744;67;2811
32;Hauts-de-France;59;5;36;602;Tressin;1401;38;1439
32;Hauts-de-France;59;6;06;603;Trith-Saint-Léger;6186;79;6265
32;Hauts-de-France;59;2;10;604;Troisvilles;815;7;822
32;Hauts-de-France;59;4;12;605;Uxem;1470;27;1497
32;Hauts-de-France;59;6;39;606;Valenciennes;42738;450;43188
32;Hauts-de-France;59;1;07;607;Vendegies-au-Bois;483;5;488
32;Hauts-de-France;59;2;11;608;Vendegies-sur-Écaillon;1108;22;1130
32;Hauts-de-France;59;5;18;609;Vendeville;1548;21;1569
32;Hauts-de-France;59;6;06;610;Verchain-Maugré;1087;9;1096
32;Hauts-de-France;59;5;22;611;Verlinghem;2607;58;2665
32;Hauts-de-France;59;2;11;612;Vertain;508;9;517
32;Hauts-de-France;59;6;29;613;Vicq;1465;14;1479
32;Hauts-de-France;59;2;11;614;Viesly;1394;18;1412
32;Hauts-de-France;59;4;08;615;Vieux-Berquin;2634;44;2678
32;Hauts-de-France;59;6;29;616;Vieux-Condé;10409;56;10465
32;Hauts-de-France;59;1;05;617;Vieux-Mesnil;637;7;644
32;Hauts-de-France;59;1;30;618;Vieux-Reng;899;6;905
32;Hauts-de-France;59;1;05;619;Villereau;1054;15;1069
32;Hauts-de-France;59;3;01;620;Villers-au-Tertre;664;9;673
32;Hauts-de-France;59;2;11;622;Villers-en-Cauchies;1174;17;1191
32;Hauts-de-France;59;2;10;623;Villers-Guislain;686;3;689
32;Hauts-de-France;59;2;10;624;Villers-Outréaux;2146;25;2171
32;Hauts-de-France;59;2;10;625;Villers-Plouich;393;5;398
32;Hauts-de-France;59;1;07;626;Villers-Pol;1295;21;1316
32;Hauts-de-France;59;1;30;627;Villers-Sire-Nicole;1005;11;1016
32;Hauts-de-France;59;4;41;628;Volckerinckhove;562;5;567
32;Hauts-de-France;59;3;35;629;Vred;1320;23;1343
32;Hauts-de-France;59;5;02;630;Wahagnies;2615;49;2664
32;Hauts-de-France;59;2;10;631;Walincourt-Selvigny;2132;25;2157
32;Hauts-de-France;59;6;34;632;Wallers;5617;35;5652
32;Hauts-de-France;59;1;19;633;Wallers-en-Fagne;282;7;289
32;Hauts-de-France;59;4;21;634;Wallon-Cappel;777;20;797
32;Hauts-de-France;59;2;10;635;Wambaix;366;6;372
32;Hauts-de-France;59;5;23;636;Wambrechies;10716;105;10821
32;Hauts-de-France;59;3;35;637;Wandignies-Hamage;1327;14;1341
32;Hauts-de-France;59;5;36;638;Wannehain;1330;13;1343
32;Hauts-de-France;59;1;05;639;Wargnies-le-Grand;1102;23;1125
32;Hauts-de-France;59;1;05;640;Wargnies-le-Petit;774;11;785
32;Hauts-de-France;59;4;41;641;Warhem;2009;36;2045
32;Hauts-de-France;59;3;35;642;Warlaing;590;16;606
32;Hauts-de-France;59;5;04;643;Warneton;235;5;240
32;Hauts-de-France;59;6;14;645;Wasnes-au-Bac;593;4;597
32;Hauts-de-France;59;5;13;646;Wasquehal;20980;210;21190
32;Hauts-de-France;59;4;41;647;Watten;2587;21;2608
32;Hauts-de-France;59;5;18;648;Wattignies;15372;200;15572
32;Hauts-de-France;59;1;19;649;Wattignies-la-Victoire;239;5;244
32;Hauts-de-France;59;5;33;650;Wattrelos;41015;182;41197
32;Hauts-de-France;59;6;14;651;Wavrechain-sous-Denain;1624;11;1635
32;Hauts-de-France;59;6;14;652;Wavrechain-sous-Faulx;419;0;419
32;Hauts-de-France;59;5;02;653;Wavrin;7736;57;7793
32;Hauts-de-France;59;3;35;654;Waziers;7381;63;7444
32;Hauts-de-France;59;4;41;655;Wemaers-Cappel;246;4;250
32;Hauts-de-France;59;5;22;656;Wervicq-Sud;5322;51;5373
32;Hauts-de-France;59;4;41;657;West-Cappel;632;7;639
32;Hauts-de-France;59;5;02;658;Wicres;533;7;540
32;Hauts-de-France;59;1;19;659;Wignehies;2830;33;2863
32;Hauts-de-France;59;5;40;660;Willems;3023;30;3053
32;Hauts-de-France;59;1;19;661;Willies;133;2;135
32;Hauts-de-France;59;4;41;662;Winnezeele;1319;22;1341
32;Hauts-de-France;59;4;41;663;Wormhout;5709;85;5794
32;Hauts-de-France;59;4;41;664;Wulverdinghe;322;7;329
32;Hauts-de-France;59;4;41;665;Wylder;299;6;305
32;Hauts-de-France;59;4;41;666;Zegerscappel;1540;25;1565
32;Hauts-de-France;59;4;41;667;Zermezeele;231;6;237
32;Hauts-de-France;59;4;17;668;Zuydcoote;1593;60;1653
32;Hauts-de-France;59;4;41;669;Zuytpeene;512;17;529
32;Hauts-de-France;59;5;02;670;Don;1362;12;1374
32;Hauts-de-France;60;1;11;001;Abancourt;606;13;619
32;Hauts-de-France;60;1;04;002;Abbecourt;822;25;847
32;Hauts-de-France;60;2;19;003;Abbeville-Saint-Lucien;508;13;521
32;Hauts-de-France;60;1;11;004;Achy;407;7;414
32;Hauts-de-France;60;4;15;005;Acy-en-Multien;889;13;902
32;Hauts-de-France;60;2;18;006;Les Ageux;1143;20;1163
32;Hauts-de-France;60;2;05;007;Agnetz;3054;99;3153
32;Hauts-de-France;60;2;19;008;Airion;370;163;533
32;Hauts-de-France;60;1;02;009;Allonne;1659;33;1692
32;Hauts-de-France;60;1;12;010;Amblainville;1752;18;1770
32;Hauts-de-France;60;3;21;011;Amy;410;2;412
32;Hauts-de-France;60;1;12;012;Andeville;3332;40;3372
32;Hauts-de-France;60;2;18;013;Angicourt;1374;28;1402
32;Hauts-de-France;60;2;19;014;Angivillers;166;5;171
32;Hauts-de-France;60;2;14;015;Angy;1147;14;1161
32;Hauts-de-France;60;2;14;016;Ansacq;273;8;281
32;Hauts-de-France;60;2;19;017;Ansauvillers;1185;20;1205
32;Hauts-de-France;60;3;10;019;Antheuil-Portes;417;12;429
32;Hauts-de-France;60;4;15;020;Antilly;261;3;264
32;Hauts-de-France;60;3;17;021;Appilly;529;6;535
32;Hauts-de-France;60;4;03;022;Apremont;642;14;656
32;Hauts-de-France;60;3;07;023;Armancourt;539;17;556
32;Hauts-de-France;60;3;10;024;Arsy;784;9;793
32;Hauts-de-France;60;3;06;025;Attichy;1864;41;1905
32;Hauts-de-France;60;1;19;026;Auchy-la-Montagne;577;10;587
32;Hauts-de-France;60;4;09;027;Auger-Saint-Vincent;532;14;546
32;Hauts-de-France;60;4;20;028;Aumont-en-Halatte;494;22;516
32;Hauts-de-France;60;1;02;029;Auneuil;2856;39;2895
32;Hauts-de-France;60;1;02;030;Auteuil;556;9;565
32;Hauts-de-France;60;4;15;031;Autheuil-en-Valois;265;7;272
32;Hauts-de-France;60;3;06;032;Autrêches;717;14;731
32;Hauts-de-France;60;4;20;033;Avilly-Saint-Léonard;885;39;924
32;Hauts-de-France;60;2;19;034;Avrechy;1169;17;1186
32;Hauts-de-France;60;3;21;035;Avricourt;245;4;249
32;Hauts-de-France;60;2;10;036;Avrigny;390;6;396
32;Hauts-de-France;60;3;17;037;Babœuf;510;8;518
32;Hauts-de-France;60;2;19;039;Bacouël;484;6;490
32;Hauts-de-France;60;2;10;040;Bailleul-le-Soc;642;11;653
32;Hauts-de-France;60;1;14;041;Bailleul-sur-Thérain;2321;60;2381
32;Hauts-de-France;60;2;05;042;Bailleval;1486;46;1532
32;Hauts-de-France;60;3;21;043;Bailly;615;13;628
32;Hauts-de-France;60;4;13;044;Balagny-sur-Thérain;1671;26;1697
32;Hauts-de-France;60;4;18;045;Barbery;563;10;573
32;Hauts-de-France;60;4;15;046;Bargny;342;6;348
32;Hauts-de-France;60;4;15;047;Baron;763;16;779
32;Hauts-de-France;60;3;10;048;Baugy;278;5;283
32;Hauts-de-France;60;1;11;049;Bazancourt;106;3;109
32;Hauts-de-France;60;2;18;050;Bazicourt;351;8;359
32;Hauts-de-France;60;1;11;051;Beaudéduit;177;1;178
32;Hauts-de-France;60;3;17;052;Beaugies-sous-Bois;98;3;101
32;Hauts-de-France;60;3;21;053;Beaulieu-les-Fontaines;591;50;641
32;Hauts-de-France;60;1;04;054;Les Hauts-Talican;873;19;892
32;Hauts-de-France;60;3;17;055;Beaurains-lès-Noyon;340;5;345
32;Hauts-de-France;60;4;18;056;Beaurepaire;65;1;66
32;Hauts-de-France;60;1;98;057;Beauvais;56889;1417;58306
32;Hauts-de-France;60;2;19;058;Beauvoir;212;4;216
32;Hauts-de-France;60;3;17;059;Béhéricourt;202;3;205
32;Hauts-de-France;60;4;12;060;Belle-Église;656;11;667
32;Hauts-de-France;60;3;10;061;Belloy;79;5;84
32;Hauts-de-France;60;3;17;062;Berlancourt;316;4;320
32;Hauts-de-France;60;1;02;063;Berneuil-en-Bray;798;19;817
32;Hauts-de-France;60;3;06;064;Berneuil-sur-Aisne;989;17;1006
32;Hauts-de-France;60;1;04;065;Berthecourt;1616;33;1649
32;Hauts-de-France;60;4;09;066;Béthancourt-en-Valois;202;10;212
32;Hauts-de-France;60;4;09;067;Béthisy-Saint-Martin;999;19;1018
32;Hauts-de-France;60;4;09;068;Béthisy-Saint-Pierre;3154;41;3195
32;Hauts-de-France;60;4;15;069;Betz;1131;40;1171
32;Hauts-de-France;60;3;06;070;Bienville;452;10;462
32;Hauts-de-France;60;3;10;071;Biermont;172;5;177
32;Hauts-de-France;60;3;06;072;Bitry;317;12;329
32;Hauts-de-France;60;1;11;073;Blacourt;568;6;574
32;Hauts-de-France;60;4;13;074;Blaincourt-lès-Précy;1191;29;1220
32;Hauts-de-France;60;1;19;075;Blancfossé;142;0;142
32;Hauts-de-France;60;1;11;076;Blargies;516;9;525
32;Hauts-de-France;60;1;11;077;Blicourt;354;9;363
32;Hauts-de-France;60;2;10;078;Blincourt;116;2;118
32;Hauts-de-France;60;4;15;079;Boissy-Fresnoy;981;12;993
32;Hauts-de-France;60;1;14;081;Bonlier;477;9;486
32;Hauts-de-France;60;2;19;082;Bonneuil-les-Eaux;782;16;798
32;Hauts-de-France;60;4;09;083;Bonneuil-en-Valois;982;23;1005
32;Hauts-de-France;60;1;11;084;Bonnières;189;1;190
32;Hauts-de-France;60;2;19;085;Bonvillers;196;1;197
32;Hauts-de-France;60;4;03;086;Boran-sur-Oise;2129;45;2174
32;Hauts-de-France;60;4;15;087;Borest;340;17;357
32;Hauts-de-France;60;1;12;088;Bornel;4774;70;4844
32;Hauts-de-France;60;1;04;089;Boubiers;401;5;406
32;Hauts-de-France;60;1;04;090;Bouconvillers;386;6;392
32;Hauts-de-France;60;4;15;091;Bouillancy;420;6;426
32;Hauts-de-France;60;4;15;092;Boullarre;214;5;219
32;Hauts-de-France;60;3;10;093;Boulogne-la-Grasse;462;9;471
32;Hauts-de-France;60;4;15;094;Boursonne;314;3;317
32;Hauts-de-France;60;1;04;095;Boury-en-Vexin;343;7;350
32;Hauts-de-France;60;1;04;097;Boutencourt;209;5;214
32;Hauts-de-France;60;1;11;098;Bouvresse;159;4;163
32;Hauts-de-France;60;3;10;099;Braisnes-sur-Aronde;174;3;177
32;Hauts-de-France;60;4;18;100;Brasseuse;113;6;119
32;Hauts-de-France;60;4;15;101;Brégy;661;14;675
32;Hauts-de-France;60;2;18;102;Brenouille;2008;39;2047
32;Hauts-de-France;60;1;14;103;Bresles;3993;54;4047
32;Hauts-de-France;60;2;19;104;Breteuil;4192;110;4302
32;Hauts-de-France;60;3;17;105;Brétigny;427;8;435
32;Hauts-de-France;60;2;05;106;Breuil-le-Sec;2668;39;2707
32;Hauts-de-France;60;2;05;107;Breuil-le-Vert;3133;145;3278
32;Hauts-de-France;60;1;11;108;Briot;293;8;301
32;Hauts-de-France;60;1;11;109;Brombos;254;4;258
32;Hauts-de-France;60;1;11;110;Broquiers;252;0;252
32;Hauts-de-France;60;2;19;111;Broyes;148;2;150
32;Hauts-de-France;60;2;19;112;Brunvillers-la-Motte;351;1;352
32;Hauts-de-France;60;2;19;113;Bucamps;203;2;205
32;Hauts-de-France;60;1;11;114;Buicourt;148;1;149
32;Hauts-de-France;60;2;19;115;Bulles;878;16;894
32;Hauts-de-France;60;2;14;116;Bury;2951;41;2992
32;Hauts-de-France;60;3;17;117;Bussy;310;13;323
32;Hauts-de-France;60;3;17;118;Caisnes;507;9;516
32;Hauts-de-France;60;3;21;119;Cambronne-lès-Ribécourt;1920;31;1951
32;Hauts-de-France;60;2;14;120;Cambronne-lès-Clermont;1203;25;1228
32;Hauts-de-France;60;3;17;121;Campagne;160;4;164
32;Hauts-de-France;60;1;11;122;Campeaux;490;10;500
32;Hauts-de-France;60;2;19;123;Campremy;481;0;481
32;Hauts-de-France;60;3;21;124;Candor;317;7;324
32;Hauts-de-France;60;3;10;125;Canly;754;19;773
32;Hauts-de-France;60;3;21;126;Cannectancourt;513;12;525
32;Hauts-de-France;60;3;21;127;Canny-sur-Matz;403;3;406
32;Hauts-de-France;60;1;11;128;Canny-sur-Thérain;225;0;225
32;Hauts-de-France;60;3;17;129;Carlepont;1475;30;1505
32;Hauts-de-France;60;2;05;130;Catenoy;1035;23;1058
32;Hauts-de-France;60;1;19;131;Catheux;104;2;106
32;Hauts-de-France;60;3;17;132;Catigny;185;3;188
32;Hauts-de-France;60;2;19;133;Catillon-Fumechon;538;4;542
32;Hauts-de-France;60;2;16;134;Cauffry;2634;26;2660
32;Hauts-de-France;60;1;04;135;Cauvigny;1629;37;1666
32;Hauts-de-France;60;1;11;136;Cempuis;502;12;514
32;Hauts-de-France;60;2;10;137;Cernoy;293;3;296
32;Hauts-de-France;60;4;20;138;Chamant;1025;28;1053
32;Hauts-de-France;60;4;12;139;Chambly;10127;139;10266
32;Hauts-de-France;60;1;04;140;Chambors;310;7;317
32;Hauts-de-France;60;4;03;141;Chantilly;10604;217;10821
32;Hauts-de-France;60;4;20;142;La Chapelle-en-Serval;3141;90;3231
32;Hauts-de-France;60;1;04;143;Chaumont-en-Vexin;3348;43;3391
32;Hauts-de-France;60;1;04;144;Chavençon;172;4;176
32;Hauts-de-France;60;3;07;145;Chelles;473;12;485
32;Hauts-de-France;60;2;19;146;Chepoix;463;4;467
32;Hauts-de-France;60;3;21;147;Chevincourt;790;33;823
32;Hauts-de-France;60;4;15;148;Chèvreville;412;10;422
32;Hauts-de-France;60;3;10;149;Chevrières;2018;67;2085
32;Hauts-de-France;60;3;21;150;Chiry-Ourscamp;1177;26;1203
32;Hauts-de-France;60;3;06;151;Choisy-au-Bac;3307;105;3412
32;Hauts-de-France;60;2;10;152;Choisy-la-Victoire;247;1;248
32;Hauts-de-France;60;1;19;153;Choqueuse-les-Bénards;102;0;102
32;Hauts-de-France;60;2;18;154;Cinqueux;1604;57;1661
32;Hauts-de-France;60;4;13;155;Cires-lès-Mello;3995;55;4050
32;Hauts-de-France;60;3;06;156;Clairoix;2245;47;2292
32;Hauts-de-France;60;2;05;157;Clermont;10268;213;10481
32;Hauts-de-France;60;2;10;158;Coivrel;245;2;247
32;Hauts-de-France;60;3;99;159;Compiègne;40453;1017;41470
32;Hauts-de-France;60;3;10;160;Conchy-les-Pots;728;13;741
32;Hauts-de-France;60;1;19;161;Conteville;72;0;72
32;Hauts-de-France;60;1;04;162;Corbeil-Cerf;312;8;320
32;Hauts-de-France;60;1;19;163;Cormeilles;403;6;409
32;Hauts-de-France;60;1;11;164;Le Coudray-Saint-Germer;859;10;869
32;Hauts-de-France;60;1;04;165;Le Coudray-sur-Thelle;528;14;542
32;Hauts-de-France;60;3;10;166;Coudun;1063;32;1095
32;Hauts-de-France;60;3;06;167;Couloisy;592;14;606
32;Hauts-de-France;60;2;10;168;Courcelles-Epayelles;214;2;216
32;Hauts-de-France;60;1;04;169;Courcelles-lès-Gisors;810;22;832
32;Hauts-de-France;60;4;20;170;Courteuil;568;35;603
32;Hauts-de-France;60;3;06;171;Courtieux;179;3;182
32;Hauts-de-France;60;4;03;172;Coye-la-Forêt;3972;146;4118
32;Hauts-de-France;60;4;13;173;Cramoisy;810;12;822
32;Hauts-de-France;60;3;21;174;Crapeaumesnil;211;4;215
32;Hauts-de-France;60;4;08;175;Creil;35970;223;36193
32;Hauts-de-France;60;4;09;176;Crépy-en-Valois;14365;280;14645
32;Hauts-de-France;60;2;10;177;Cressonsacq;442;8;450
32;Hauts-de-France;60;1;19;178;Crèvecœur-le-Grand;3472;126;3598
32;Hauts-de-France;60;2;10;179;Crèvecœur-le-Petit;151;1;152
32;Hauts-de-France;60;1;11;180;Crillon;497;15;512
32;Hauts-de-France;60;3;17;181;Crisolles;908;18;926
32;Hauts-de-France;60;1;19;182;Le Crocq;176;4;180
32;Hauts-de-France;60;1;19;183;Croissy-sur-Celle;248;9;257
32;Hauts-de-France;60;3;07;184;Croutoy;207;10;217
32;Hauts-de-France;60;4;03;185;Crouy-en-Thelle;1117;9;1126
32;Hauts-de-France;60;2;19;186;Cuignières;251;3;254
32;Hauts-de-France;60;1;11;187;Cuigy-en-Bray;975;15;990
32;Hauts-de-France;60;3;07;188;Cuise-la-Motte;2220;106;2326
32;Hauts-de-France;60;3;17;189;Cuts;967;21;988
32;Hauts-de-France;60;4;15;190;Cuvergnon;300;6;306
32;Hauts-de-France;60;3;10;191;Cuvilly;623;6;629
32;Hauts-de-France;60;3;21;192;Cuy;219;6;225
32;Hauts-de-France;60;1;11;193;Daméraucourt;204;2;206
32;Hauts-de-France;60;1;11;194;Dargies;246;2;248
32;Hauts-de-France;60;1;04;195;Delincourt;514;10;524
32;Hauts-de-France;60;1;04;196;La Drenne;1047;16;1063
32;Hauts-de-France;60;4;12;197;Dieudonné;924;7;931
32;Hauts-de-France;60;3;21;198;Dives;392;9;401
32;Hauts-de-France;60;1;19;199;Doméliers;256;8;264
32;Hauts-de-France;60;2;10;200;Domfront;318;2;320
32;Hauts-de-France;60;2;10;201;Dompierre;242;3;245
32;Hauts-de-France;60;4;09;203;Duvy;429;7;436
32;Hauts-de-France;60;3;21;204;Écuvilly;303;5;308
32;Hauts-de-France;60;1;11;205;Élencourt;50;1;51
32;Hauts-de-France;60;3;21;206;Élincourt-Sainte-Marguerite;877;20;897
32;Hauts-de-France;60;4;09;207;Éméville;286;6;292
32;Hauts-de-France;60;1;04;208;Énencourt-Léage;121;6;127
32;Hauts-de-France;60;1;04;209;La Corne-en-Vexin;544;10;554
32;Hauts-de-France;60;2;10;210;Épineuse;267;4;271
32;Hauts-de-France;60;1;04;211;Éragny-sur-Epte;598;4;602
32;Hauts-de-France;60;4;12;212;Ercuis;1606;26;1632
32;Hauts-de-France;60;4;15;213;Ermenonville;946;21;967
32;Hauts-de-France;60;1;11;214;Ernemont-Boutavent;203;8;211
32;Hauts-de-France;60;2;05;215;Erquery;595;13;608
32;Hauts-de-France;60;2;19;216;Erquinvillers;185;2;187
32;Hauts-de-France;60;1;11;217;Escames;217;4;221
32;Hauts-de-France;60;1;12;218;Esches;1626;11;1637
32;Hauts-de-France;60;1;11;219;Escles-Saint-Pierre;168;1;169
32;Hauts-de-France;60;1;11;220;Espaubourg;503;16;519
32;Hauts-de-France;60;2;19;221;Esquennoy;719;3;722
32;Hauts-de-France;60;2;19;222;Essuiles;552;17;569
32;Hauts-de-France;60;3;10;223;Estrées-Saint-Denis;3726;84;3810
32;Hauts-de-France;60;4;15;224;Étavigny;160;5;165
32;Hauts-de-France;60;2;05;225;Étouy;821;42;863
32;Hauts-de-France;60;4;15;226;Ève;421;6;427
32;Hauts-de-France;60;3;21;227;Évricourt;233;3;236
32;Hauts-de-France;60;1;04;228;Fay-les-Étangs;465;9;474
32;Hauts-de-France;60;3;10;229;Le Fayel;230;4;234
32;Hauts-de-France;60;1;14;230;Le Fay-Saint-Quentin;524;14;538
32;Hauts-de-France;60;4;09;231;Feigneux;422;14;436
32;Hauts-de-France;60;2;10;232;Ferrières;468;4;472
32;Hauts-de-France;60;1;11;233;Feuquières;1360;21;1381
32;Hauts-de-France;60;2;05;234;Fitz-James;2578;28;2606
32;Hauts-de-France;60;1;02;235;Flavacourt;663;20;683
32;Hauts-de-France;60;3;17;236;Flavy-le-Meldeux;220;3;223
32;Hauts-de-France;60;2;19;237;Fléchy;88;1;89
32;Hauts-de-France;60;4;20;238;Fleurines;1844;80;1924
32;Hauts-de-France;60;1;04;239;Fleury;575;12;587
32;Hauts-de-France;60;1;19;240;Fontaine-Bonneleau;234;3;237
32;Hauts-de-France;60;4;15;241;Fontaine-Chaalis;330;15;345
32;Hauts-de-France;60;1;11;242;Fontaine-Lavaganne;504;10;514
32;Hauts-de-France;60;1;14;243;Fontaine-Saint-Lucien;175;7;182
32;Hauts-de-France;60;1;11;244;Fontenay-Torcy;146;1;147
32;Hauts-de-France;60;1;11;245;Formerie;2109;24;2133
32;Hauts-de-France;60;2;05;247;Fouilleuse;145;2;147
32;Hauts-de-France;60;1;11;248;Fouilloy;216;7;223
32;Hauts-de-France;60;4;13;249;Foulangues;197;4;201
32;Hauts-de-France;60;1;01;250;Fouquenies;421;13;434
32;Hauts-de-France;60;1;14;251;Fouquerolles;280;5;285
32;Hauts-de-France;60;2;19;252;Fournival;526;3;529
32;Hauts-de-France;60;1;19;253;Francastel;497;8;505
32;Hauts-de-France;60;3;10;254;Francières;552;16;568
32;Hauts-de-France;60;3;17;255;Fréniches;332;3;335
32;Hauts-de-France;60;1;04;256;Montchevreuil;1324;21;1345
32;Hauts-de-France;60;1;04;257;Fresne-Léguillon;440;10;450
32;Hauts-de-France;60;3;21;258;Fresnières;161;6;167
32;Hauts-de-France;60;4;12;259;Fresnoy-en-Thelle;885;23;908
32;Hauts-de-France;60;4;09;260;Fresnoy-la-Rivière;677;21;698
32;Hauts-de-France;60;4;15;261;Fresnoy-le-Luat;538;13;551
32;Hauts-de-France;60;2;10;262;Le Frestoy-Vaux;244;6;250
32;Hauts-de-France;60;3;17;263;Frétoy-le-Château;264;1;265
32;Hauts-de-France;60;1;02;264;Frocourt;510;13;523
32;Hauts-de-France;60;2;19;265;Froissy;978;15;993
32;Hauts-de-France;60;1;19;267;Le Gallet;170;6;176
32;Hauts-de-France;60;2;19;268;Gannes;337;1;338
32;Hauts-de-France;60;1;11;269;Gaudechart;344;5;349
32;Hauts-de-France;60;3;17;270;Genvry;335;85;420
32;Hauts-de-France;60;1;11;271;Gerberoy;83;2;85
32;Hauts-de-France;60;4;09;272;Gilocourt;631;19;650
32;Hauts-de-France;60;3;10;273;Giraumont;530;16;546
32;Hauts-de-France;60;4;09;274;Glaignes;379;14;393
32;Hauts-de-France;60;1;11;275;Glatigny;221;0;221
32;Hauts-de-France;60;2;10;276;Godenvillers;208;2;210
32;Hauts-de-France;60;1;02;277;Goincourt;1560;40;1600
32;Hauts-de-France;60;3;17;278;Golancourt;406;5;411
32;Hauts-de-France;60;4;15;279;Gondreville;195;5;200
32;Hauts-de-France;60;1;11;280;Gourchelles;107;0;107
32;Hauts-de-France;60;3;10;281;Gournay-sur-Aronde;539;14;553
32;Hauts-de-France;60;4;03;282;Gouvieux;8946;386;9332
32;Hauts-de-France;60;2;19;283;Gouy-les-Groseillers;16;1;17
32;Hauts-de-France;60;3;10;284;Grandfresnoy;1804;62;1866
32;Hauts-de-France;60;2;10;285;Grandvillers-aux-Bois;304;15;319
32;Hauts-de-France;60;1;11;286;Grandvilliers;2793;76;2869
32;Hauts-de-France;60;3;17;287;Grandrû;360;4;364
32;Hauts-de-France;60;1;11;288;Grémévillers;475;9;484
32;Hauts-de-France;60;1;11;289;Grez;265;5;270
32;Hauts-de-France;60;1;14;290;Guignecourt;387;7;394
32;Hauts-de-France;60;3;17;291;Guiscard;1800;23;1823
32;Hauts-de-France;60;3;21;292;Gury;235;7;242
32;Hauts-de-France;60;1;04;293;Hadancourt-le-Haut-Clocher;375;7;382
32;Hauts-de-France;60;3;10;294;Hainvillers;85;1;86
32;Hauts-de-France;60;1;11;295;Halloy;445;8;453
32;Hauts-de-France;60;1;11;296;Hannaches;135;4;139
32;Hauts-de-France;60;1;11;297;Le Hamel;188;1;189
32;Hauts-de-France;60;1;11;298;Hanvoile;648;13;661
32;Hauts-de-France;60;2;19;299;Hardivillers;540;9;549
32;Hauts-de-France;60;1;11;301;Haucourt;134;6;140
32;Hauts-de-France;60;1;14;302;Haudivillers;781;23;804
32;Hauts-de-France;60;1;11;303;Hautbos;198;1;199
32;Hauts-de-France;60;1;11;304;Haute-Épine;272;9;281
32;Hauts-de-France;60;3;07;305;Hautefontaine;339;7;346
32;Hauts-de-France;60;1;11;306;Hécourt;153;3;156
32;Hauts-de-France;60;2;14;307;Heilles;648;11;659
32;Hauts-de-France;60;3;10;308;Hémévillers;468;6;474
32;Hauts-de-France;60;1;04;309;Hénonville;896;20;916
32;Hauts-de-France;60;1;01;310;Herchies;615;14;629
32;Hauts-de-France;60;2;19;311;La Hérelle;236;2;238
32;Hauts-de-France;60;1;11;312;Héricourt-sur-Thérain;112;2;114
32;Hauts-de-France;60;1;14;313;Hermes;2510;41;2551
32;Hauts-de-France;60;1;11;314;Hétomesnil;327;4;331
32;Hauts-de-France;60;1;11;315;Hodenc-en-Bray;492;12;504
32;Hauts-de-France;60;1;04;316;Hodenc-l'Évêque;239;6;245
32;Hauts-de-France;60;2;14;317;Hondainville;725;8;733
32;Hauts-de-France;60;3;10;318;Houdancourt;665;13;678
32;Hauts-de-France;60;1;02;319;La Houssoye;607;5;612
32;Hauts-de-France;60;4;15;320;Ivors;257;6;263
32;Hauts-de-France;60;1;04;321;Ivry-le-Temple;843;7;850
32;Hauts-de-France;60;1;04;322;Jaméricourt;324;5;329
32;Hauts-de-France;60;3;06;323;Janville;646;11;657
32;Hauts-de-France;60;3;06;324;Jaulzy;873;11;884
32;Hauts-de-France;60;3;07;325;Jaux;2282;64;2346
32;Hauts-de-France;60;3;07;326;Jonquières;599;22;621
32;Hauts-de-France;60;1;04;327;Jouy-sous-Thelle;1048;18;1066
32;Hauts-de-France;60;1;14;328;Juvignies;302;9;311
32;Hauts-de-France;60;3;21;329;Laberlière;202;6;208
32;Hauts-de-France;60;1;04;330;Laboissière-en-Thelle;1339;26;1365
32;Hauts-de-France;60;1;02;331;Labosse;445;6;451
32;Hauts-de-France;60;2;05;332;Labruyère;724;9;733
32;Hauts-de-France;60;1;02;333;Lachapelle-aux-Pots;1618;30;1648
32;Hauts-de-France;60;1;04;334;Lachapelle-Saint-Pierre;846;14;860
32;Hauts-de-France;60;1;11;335;Lachapelle-sous-Gerberoy;148;1;149
32;Hauts-de-France;60;1;19;336;Lachaussée-du-Bois-d'Écu;189;3;192
32;Hauts-de-France;60;3;07;337;Lachelle;773;29;802
32;Hauts-de-France;60;3;07;338;Lacroix-Saint-Ouen;4943;164;5107
32;Hauts-de-France;60;1;14;339;Lafraye;358;9;367
32;Hauts-de-France;60;3;21;340;Lagny;533;18;551
32;Hauts-de-France;60;4;15;341;Lagny-le-Sec;2055;55;2110
32;Hauts-de-France;60;2;16;342;Laigneville;4722;53;4775
32;Hauts-de-France;60;1;02;343;Lalande-en-Son;615;23;638
32;Hauts-de-France;60;1;02;344;Lalandelle;507;9;516
32;Hauts-de-France;60;2;05;345;Lamécourt;190;2;192
32;Hauts-de-France;60;4;03;346;Lamorlaye;8889;241;9130
32;Hauts-de-France;60;1;11;347;Lannoy-Cuillère;282;5;287
32;Hauts-de-France;60;3;17;348;Larbroye;516;9;525
32;Hauts-de-France;60;3;21;350;Lassigny;1371;25;1396
32;Hauts-de-France;60;3;10;351;Lataule;120;2;122
32;Hauts-de-France;60;1;04;352;Lattainville;170;2;172
32;Hauts-de-France;60;1;11;353;Lavacquerie;189;1;190
32;Hauts-de-France;60;1;11;354;Laverrière;31;1;32
32;Hauts-de-France;60;1;14;355;Laversines;1169;52;1221
32;Hauts-de-France;60;1;04;356;Lavilletertre;640;16;656
32;Hauts-de-France;60;2;10;357;Léglantiers;551;7;558
32;Hauts-de-France;60;4;15;358;Lévignen;1015;25;1040
32;Hauts-de-France;60;1;11;359;Lhéraule;199;3;202
32;Hauts-de-France;60;2;05;360;Liancourt;7083;66;7149
32;Hauts-de-France;60;1;04;361;Liancourt-Saint-Pierre;587;12;599
32;Hauts-de-France;60;3;17;362;Libermont;174;6;180
32;Hauts-de-France;60;1;04;363;Lierville;221;1;222
32;Hauts-de-France;60;2;19;364;Lieuvillers;702;8;710
32;Hauts-de-France;60;1;11;365;Lihus;428;5;433
32;Hauts-de-France;60;2;14;366;Litz;364;5;369
32;Hauts-de-France;60;1;04;367;Loconville;332;8;340
32;Hauts-de-France;60;3;21;368;Longueil-Annel;2594;51;2645
32;Hauts-de-France;60;3;10;369;Longueil-Sainte-Marie;2000;36;2036
32;Hauts-de-France;60;1;12;370;Lormaison;1314;14;1328
32;Hauts-de-France;60;1;11;371;Loueuse;152;2;154
32;Hauts-de-France;60;1;19;372;Luchy;663;16;679
32;Hauts-de-France;60;3;21;373;Machemont;806;20;826
32;Hauts-de-France;60;2;10;374;Maignelay-Montigny;2616;38;2654
32;Hauts-de-France;60;2;05;375;Maimbeville;394;10;404
32;Hauts-de-France;60;1;14;376;Maisoncelle-Saint-Pierre;175;1;176
32;Hauts-de-France;60;2;19;377;Maisoncelle-Tuilerie;284;8;292
32;Hauts-de-France;60;3;21;378;Marest-sur-Matz;388;5;393
32;Hauts-de-France;60;3;21;379;Mareuil-la-Motte;612;16;628
32;Hauts-de-France;60;4;15;380;Mareuil-sur-Ourcq;1601;26;1627
32;Hauts-de-France;60;3;21;381;Margny-aux-Cerises;254;3;257
32;Hauts-de-France;60;3;06;382;Margny-lès-Compiègne;8704;179;8883
32;Hauts-de-France;60;3;10;383;Margny-sur-Matz;540;13;553
32;Hauts-de-France;60;4;15;385;Marolles;659;14;673
32;Hauts-de-France;60;3;10;386;Marquéglise;479;8;487
32;Hauts-de-France;60;1;11;387;Marseille-en-Beauvaisis;1469;11;1480
32;Hauts-de-France;60;1;11;388;Martincourt;135;7;142
32;Hauts-de-France;60;3;17;389;Maucourt;244;2;246
32;Hauts-de-France;60;1;19;390;Maulers;329;7;336
32;Hauts-de-France;60;4;13;391;Maysel;220;3;223
32;Hauts-de-France;60;3;21;392;Mélicocq;792;16;808
32;Hauts-de-France;60;4;13;393;Mello;601;13;614
32;Hauts-de-France;60;2;10;394;Ménévillers;104;1;105
32;Hauts-de-France;60;1;12;395;Méru;14354;192;14546
32;Hauts-de-France;60;2;10;396;Méry-la-Bataille;628;5;633
32;Hauts-de-France;60;1;11;397;Le Mesnil-Conteville;74;1;75
32;Hauts-de-France;60;4;03;398;Le Mesnil-en-Thelle;2267;27;2294
32;Hauts-de-France;60;2;19;399;Le Mesnil-Saint-Firmin;251;3;254
32;Hauts-de-France;60;2;19;400;Le Mesnil-sur-Bulles;269;7;276
32;Hauts-de-France;60;1;04;401;Le Mesnil-Théribus;785;20;805
32;Hauts-de-France;60;3;07;402;Le Meux;2331;55;2386
32;Hauts-de-France;60;1;01;403;Milly-sur-Thérain;1836;35;1871
32;Hauts-de-France;60;2;16;404;Mogneville;1467;36;1503
32;Hauts-de-France;60;1;11;405;Moliens;1144;17;1161
32;Hauts-de-France;60;2;18;406;Monceaux;869;20;889
32;Hauts-de-France;60;1;11;407;Monceaux-l'Abbaye;215;2;217
32;Hauts-de-France;60;3;10;408;Monchy-Humières;784;16;800
32;Hauts-de-France;60;2;16;409;Monchy-Saint-Éloi;2164;40;2204
32;Hauts-de-France;60;3;17;410;Mondescourt;249;8;257
32;Hauts-de-France;60;1;04;411;Monneville;773;23;796
32;Hauts-de-France;60;1;04;412;Montagny-en-Vexin;683;11;694
32;Hauts-de-France;60;4;15;413;Montagny-Sainte-Félicité;420;9;429
32;Hauts-de-France;60;4;13;414;Montataire;13683;151;13834
32;Hauts-de-France;60;4;18;415;Montépilloy;136;9;145
32;Hauts-de-France;60;2;10;416;Montgérain;170;2;172
32;Hauts-de-France;60;2;10;418;Montiers;406;13;419
32;Hauts-de-France;60;1;04;420;Montjavoult;495;9;504
32;Hauts-de-France;60;4;20;421;Mont-l'Évêque;397;6;403
32;Hauts-de-France;60;4;15;422;Montlognon;200;11;211
32;Hauts-de-France;60;3;21;423;Montmacq;1151;26;1177
32;Hauts-de-France;60;3;10;424;Montmartin;272;4;276
32;Hauts-de-France;60;2;19;425;Montreuil-sur-Brêche;483;13;496
32;Hauts-de-France;60;1;04;426;Montreuil-sur-Thérain;248;1;249
32;Hauts-de-France;60;1;04;427;Monts;184;1;185
32;Hauts-de-France;60;1;01;428;Le Mont-Saint-Adrien;642;27;669
32;Hauts-de-France;60;4;03;429;Morangles;408;16;424
32;Hauts-de-France;60;4;09;430;Morienval;1096;13;1109
32;Hauts-de-France;60;3;17;431;Morlincourt;538;11;549
32;Hauts-de-France;60;4;20;432;Mortefontaine;875;29;904
32;Hauts-de-France;60;1;04;433;Mortefontaine-en-Thelle;1008;20;1028
32;Hauts-de-France;60;3;10;434;Mortemer;223;6;229
32;Hauts-de-France;60;1;11;435;Morvillers;491;9;500
32;Hauts-de-France;60;2;19;436;Mory-Montcrux;72;2;74
32;Hauts-de-France;60;1;04;437;Mouchy-le-Châtel;82;0;82
32;Hauts-de-France;60;3;06;438;Moulin-sous-Touvent;196;5;201
32;Hauts-de-France;60;2;14;439;Mouy;5270;59;5329
32;Hauts-de-France;60;2;10;440;Moyenneville;599;16;615
32;Hauts-de-France;60;3;10;441;Moyvillers;705;7;712
32;Hauts-de-France;60;1;19;442;Muidorge;143;6;149
32;Hauts-de-France;60;3;17;443;Muirancourt;588;4;592
32;Hauts-de-France;60;1;11;444;Mureaumont;153;2;155
32;Hauts-de-France;60;3;06;445;Nampcel;310;2;312
32;Hauts-de-France;60;4;15;446;Nanteuil-le-Haudouin;4153;63;4216
32;Hauts-de-France;60;4;09;447;Néry;651;14;665
32;Hauts-de-France;60;4;15;448;Neufchelles;388;6;394
32;Hauts-de-France;60;3;10;449;Neufvy-sur-Aronde;279;6;285
32;Hauts-de-France;60;4;12;450;Neuilly-en-Thelle;4023;41;4064
32;Hauts-de-France;60;2;14;451;Neuilly-sous-Clermont;1632;27;1659
32;Hauts-de-France;60;1;04;452;Neuville-Bosc;484;14;498
32;Hauts-de-France;60;2;14;454;La Neuville-en-Hez;956;31;987
32;Hauts-de-France;60;2;10;456;La Neuville-Roy;915;28;943
32;Hauts-de-France;60;2;19;457;La Neuville-Saint-Pierre;163;2;165
32;Hauts-de-France;60;1;11;458;La Neuville-sur-Oudeuil;312;15;327
32;Hauts-de-France;60;3;10;459;La Neuville-sur-Ressons;203;3;206
32;Hauts-de-France;60;1;11;460;La Neuville-Vault;200;8;208
32;Hauts-de-France;60;1;14;461;Nivillers;199;13;212
32;Hauts-de-France;60;1;04;462;Noailles;2819;48;2867
32;Hauts-de-France;60;4;16;463;Nogent-sur-Oise;21589;344;21933
32;Hauts-de-France;60;2;05;464;Nointel;1122;15;1137
32;Hauts-de-France;60;2;19;465;Noirémont;183;6;189
32;Hauts-de-France;60;2;19;466;Noroy;257;3;260
32;Hauts-de-France;60;2;19;468;Nourard-le-Franc;305;4;309
32;Hauts-de-France;60;1;04;469;Novillers;358;9;367
32;Hauts-de-France;60;2;19;470;Noyers-Saint-Martin;903;14;917
32;Hauts-de-France;60;3;17;471;Noyon;13197;212;13409
32;Hauts-de-France;60;1;11;472;Offoy;118;1;119
32;Hauts-de-France;60;4;15;473;Ognes;293;1;294
32;Hauts-de-France;60;3;21;474;Ognolles;286;6;292
32;Hauts-de-France;60;1;11;476;Omécourt;200;7;207
32;Hauts-de-France;60;1;02;477;Ons-en-Bray;1399;22;1421
32;Hauts-de-France;60;4;15;478;Ormoy-le-Davien;363;9;372
32;Hauts-de-France;60;4;15;479;Ormoy-Villers;687;10;697
32;Hauts-de-France;60;1;14;480;Oroër;549;17;566
32;Hauts-de-France;60;4;09;481;Orrouy;617;13;630
32;Hauts-de-France;60;4;20;482;Orry-la-Ville;3385;88;3473
32;Hauts-de-France;60;3;10;483;Orvillers-Sorel;535;45;580
32;Hauts-de-France;60;1;11;484;Oudeuil;284;6;290
32;Hauts-de-France;60;2;19;485;Oursel-Maison;240;5;245
32;Hauts-de-France;60;2;19;486;Paillart;571;10;581
32;Hauts-de-France;60;1;04;487;Parnes;327;15;342
32;Hauts-de-France;60;3;17;488;Passel;272;6;278
32;Hauts-de-France;60;4;15;489;Péroy-les-Gombries;1189;19;1208
32;Hauts-de-France;60;1;01;490;Pierrefitte-en-Beauvaisis;369;14;383
32;Hauts-de-France;60;3;07;491;Pierrefonds;1877;150;2027
32;Hauts-de-France;60;3;21;492;Pimprez;856;19;875
32;Hauts-de-France;60;1;11;493;Pisseleu;509;10;519
32;Hauts-de-France;60;4;20;494;Plailly;1852;37;1889
32;Hauts-de-France;60;2;19;495;Plainval;410;5;415
32;Hauts-de-France;60;2;19;496;Plainville;164;1;165
32;Hauts-de-France;60;2;19;497;Le Plessier-sur-Bulles;212;1;213
32;Hauts-de-France;60;2;19;498;Le Plessier-sur-Saint-Just;532;3;535
32;Hauts-de-France;60;3;21;499;Plessis-de-Roye;231;5;236
32;Hauts-de-France;60;4;15;500;Le Plessis-Belleville;3832;54;3886
32;Hauts-de-France;60;3;21;501;Le Plessis-Brion;1332;31;1363
32;Hauts-de-France;60;3;17;502;Le Plessis-Patte-d'Oie;95;4;99
32;Hauts-de-France;60;2;10;503;Le Ployron;112;3;115
32;Hauts-de-France;60;1;04;504;Ponchon;1127;15;1142
32;Hauts-de-France;60;4;20;505;Pontarmé;872;22;894
32;Hauts-de-France;60;3;17;506;Pont-l'Évêque;679;12;691
32;Hauts-de-France;60;3;17;507;Pontoise-lès-Noyon;453;11;464
32;Hauts-de-France;60;4;18;508;Pontpoint;3235;74;3309
32;Hauts-de-France;60;4;18;509;Pont-Sainte-Maxence;12512;125;12637
32;Hauts-de-France;60;1;02;510;Porcheux;663;16;679
32;Hauts-de-France;60;3;17;511;Porquéricourt;401;11;412
32;Hauts-de-France;60;1;04;512;Pouilly;158;2;160
32;Hauts-de-France;60;4;13;513;Précy-sur-Oise;3227;71;3298
32;Hauts-de-France;60;1;11;514;Prévillers;247;1;248
32;Hauts-de-France;60;2;10;515;Pronleroy;374;13;387
32;Hauts-de-France;60;1;11;516;Puiseux-en-Bray;407;8;415
32;Hauts-de-France;60;4;12;517;Puiseux-le-Hauberger;845;12;857
32;Hauts-de-France;60;2;19;518;Puits-la-Vallée;205;4;209
32;Hauts-de-France;60;3;17;519;Quesmy;174;5;179
32;Hauts-de-France;60;2;19;520;Le Quesnel-Aubry;225;7;232
32;Hauts-de-France;60;1;11;521;Quincampoix-Fleuzy;400;17;417
32;Hauts-de-France;60;2;19;522;Quinquempoix;312;3;315
32;Hauts-de-France;60;1;02;523;Rainvillers;907;15;922
32;Hauts-de-France;60;2;05;524;Rantigny;2540;29;2569
32;Hauts-de-France;60;4;18;525;Raray;124;5;129
32;Hauts-de-France;60;2;19;526;Ravenel;1064;13;1077
32;Hauts-de-France;60;4;15;527;Réez-Fosse-Martin;143;0;143
32;Hauts-de-France;60;1;04;528;Reilly;125;4;129
32;Hauts-de-France;60;2;05;529;Rémécourt;76;2;78
32;Hauts-de-France;60;2;14;530;Rémérangles;215;9;224
32;Hauts-de-France;60;3;10;531;Remy;1960;39;1999
32;Hauts-de-France;60;3;10;533;Ressons-sur-Matz;1707;29;1736
32;Hauts-de-France;60;3;06;534;Rethondes;636;20;656
32;Hauts-de-France;60;2;19;535;Reuil-sur-Brêche;329;6;335
32;Hauts-de-France;60;4;18;536;Rhuis;134;8;142
32;Hauts-de-France;60;3;21;537;Ribécourt-Dreslincourt;3683;174;3857
32;Hauts-de-France;60;3;10;538;Ricquebourg;298;5;303
32;Hauts-de-France;60;2;18;539;Rieux;1542;21;1563
32;Hauts-de-France;60;3;10;540;Rivecourt;627;15;642
32;Hauts-de-France;60;4;18;541;Roberval;354;12;366
32;Hauts-de-France;60;1;14;542;Rochy-Condé;995;17;1012
32;Hauts-de-France;60;4;09;543;Rocquemont;118;1;119
32;Hauts-de-France;60;2;19;544;Rocquencourt;195;1;196
32;Hauts-de-France;60;1;11;545;Romescamps;529;9;538
32;Hauts-de-France;60;4;15;546;Rosières;139;4;143
32;Hauts-de-France;60;2;05;547;Rosoy;624;17;641
32;Hauts-de-France;60;4;15;548;Rosoy-en-Multien;603;7;610
32;Hauts-de-France;60;1;19;549;Rotangy;223;6;229
32;Hauts-de-France;60;1;11;550;Rothois;224;0;224
32;Hauts-de-France;60;2;13;551;Rousseloy;292;7;299
32;Hauts-de-France;60;4;15;552;Rouville;243;9;252
32;Hauts-de-France;60;2;10;553;Rouvillers;272;7;279
32;Hauts-de-France;60;4;15;554;Rouvres-en-Multien;475;9;484
32;Hauts-de-France;60;2;19;555;Rouvroy-les-Merles;59;1;60
32;Hauts-de-France;60;2;10;556;Royaucourt;202;3;205
32;Hauts-de-France;60;1;11;557;Roy-Boissy;315;8;323
32;Hauts-de-France;60;3;21;558;Roye-sur-Matz;458;19;477
32;Hauts-de-France;60;2;14;559;La Rue-Saint-Pierre;834;9;843
32;Hauts-de-France;60;4;18;560;Rully;730;33;763
32;Hauts-de-France;60;4;09;561;Russy-Bémont;209;6;215
32;Hauts-de-France;60;2;18;562;Sacy-le-Grand;1589;25;1614
32;Hauts-de-France;60;2;18;563;Sacy-le-Petit;617;7;624
32;Hauts-de-France;60;2;10;564;Sains-Morainvillers;281;3;284
32;Hauts-de-France;60;2;19;565;Saint-André-Farivillers;516;4;520
32;Hauts-de-France;60;1;11;566;Saint-Arnoult;199;3;202
32;Hauts-de-France;60;1;02;567;Saint-Aubin-en-Bray;1175;28;1203
32;Hauts-de-France;60;2;05;568;Saint-Aubin-sous-Erquery;332;8;340
32;Hauts-de-France;60;3;06;569;Saint-Crépin-aux-Bois;180;9;189
32;Hauts-de-France;60;1;04;570;Saint-Crépin-Ibouvillers;1578;23;1601
32;Hauts-de-France;60;1;11;571;Saint-Deniscourt;82;2;84
32;Hauts-de-France;60;3;07;572;Saint-Étienne-Roilaye;290;9;299
32;Hauts-de-France;60;2;19;573;Sainte-Eusoye;335;2;337
32;Hauts-de-France;60;2;14;574;Saint-Félix;620;14;634
32;Hauts-de-France;60;1;04;575;Sainte-Geneviève;3380;43;3423
32;Hauts-de-France;60;1;01;576;Saint-Germain-la-Poterie;484;14;498
32;Hauts-de-France;60;1;11;577;Saint-Germer-de-Fly;1706;34;1740
32;Hauts-de-France;60;4;09;578;Saintines;1074;17;1091
32;Hauts-de-France;60;3;07;579;Saint-Jean-aux-Bois;330;6;336
32;Hauts-de-France;60;2;19;581;Saint-Just-en-Chaussée;6056;49;6105
32;Hauts-de-France;60;3;21;582;Saint-Léger-aux-Bois;759;20;779
32;Hauts-de-France;60;1;02;583;Saint-Léger-en-Bray;365;9;374
32;Hauts-de-France;60;4;13;584;Saint-Leu-d'Esserent;4637;110;4747
32;Hauts-de-France;60;2;10;585;Saint-Martin-aux-Bois;285;5;290
32;Hauts-de-France;60;1;02;586;Saint-Martin-le-Nœud;1025;22;1047
32;Hauts-de-France;60;2;18;587;Saint-Martin-Longueau;1450;29;1479
32;Hauts-de-France;60;1;11;588;Saint-Maur;370;6;376
32;Hauts-de-France;60;4;03;589;Saint-Maximin;2907;114;3021
32;Hauts-de-France;60;1;11;590;Saint-Omer-en-Chaussée;1245;24;1269
32;Hauts-de-France;60;1;02;591;Saint-Paul;1571;65;1636
32;Hauts-de-France;60;1;11;592;Saint-Pierre-es-Champs;698;19;717
32;Hauts-de-France;60;3;06;593;Saint-Pierre-lès-Bitry;135;2;137
32;Hauts-de-France;60;1;11;594;Saint-Quentin-des-Prés;277;6;283
32;Hauts-de-France;60;2;19;595;Saint-Remy-en-l'Eau;438;3;441
32;Hauts-de-France;60;1;11;596;Saint-Samson-la-Poterie;244;2;246
32;Hauts-de-France;60;3;07;597;Saint-Sauveur;1735;33;1768
32;Hauts-de-France;60;1;04;598;Saint-Sulpice;1047;85;1132
32;Hauts-de-France;60;1;11;599;Saint-Thibault;289;5;294
32;Hauts-de-France;60;4;09;600;Saint-Vaast-de-Longmont;633;7;640
32;Hauts-de-France;60;4;13;601;Saint-Vaast-lès-Mello;1037;14;1051
32;Hauts-de-France;60;1;11;602;Saint-Valery;56;6;62
32;Hauts-de-France;60;3;17;603;Salency;898;23;921
32;Hauts-de-France;60;1;11;604;Sarcus;267;2;269
32;Hauts-de-France;60;1;11;605;Sarnois;349;5;354
32;Hauts-de-France;60;1;19;608;Le Saulchoy;106;1;107
32;Hauts-de-France;60;1;01;609;Savignies;908;25;933
32;Hauts-de-France;60;3;17;610;Sempigny;766;12;778
32;Hauts-de-France;60;1;11;611;Senantes;589;14;603
32;Hauts-de-France;60;4;20;612;Senlis;15128;581;15709
32;Hauts-de-France;60;1;04;613;Senots;344;7;351
32;Hauts-de-France;60;1;04;614;Serans;197;6;203
32;Hauts-de-France;60;2;19;615;Sérévillers;133;1;134
32;Hauts-de-France;60;1;02;616;Sérifontaine;2759;29;2788
32;Hauts-de-France;60;3;17;617;Sermaize;273;3;276
32;Hauts-de-France;60;4;09;618;Séry-Magneval;279;5;284
32;Hauts-de-France;60;4;15;619;Silly-le-Long;1185;27;1212
32;Hauts-de-France;60;1;04;620;Silly-Tillard;455;9;464
32;Hauts-de-France;60;3;21;621;Solente;138;0;138
32;Hauts-de-France;60;1;11;622;Sommereux;482;5;487
32;Hauts-de-France;60;1;11;623;Songeons;950;82;1032
32;Hauts-de-France;60;1;11;624;Sully;171;3;174
32;Hauts-de-France;60;3;17;625;Suzoy;574;13;587
32;Hauts-de-France;60;1;11;626;Talmontiers;662;17;679
32;Hauts-de-France;60;2;19;627;Tartigny;256;3;259
32;Hauts-de-France;60;1;14;628;Therdonne;1067;23;1090
32;Hauts-de-France;60;1;11;629;Thérines;195;9;204
32;Hauts-de-France;60;1;04;630;Thibivillers;196;3;199
32;Hauts-de-France;60;4;20;631;Thiers-sur-Thève;1080;23;1103
32;Hauts-de-France;60;3;21;632;Thiescourt;754;16;770
32;Hauts-de-France;60;1;11;633;Thieuloy-Saint-Antoine;406;0;406
32;Hauts-de-France;60;2;19;634;Thieux;438;9;447
32;Hauts-de-France;60;4;13;635;Thiverny;1078;10;1088
32;Hauts-de-France;60;3;21;636;Thourotte;4455;75;4530
32;Hauts-de-France;60;4;15;637;Thury-en-Valois;497;11;508
32;Hauts-de-France;60;2;14;638;Thury-sous-Clermont;675;9;684
32;Hauts-de-France;60;1;14;639;Tillé;1251;26;1277
32;Hauts-de-France;60;1;04;640;Tourly;172;1;173
32;Hauts-de-France;60;3;06;641;Tracy-le-Mont;1720;47;1767
32;Hauts-de-France;60;3;21;642;Tracy-le-Val;1063;32;1095
32;Hauts-de-France;60;2;10;643;Tricot;1369;14;1383
32;Hauts-de-France;60;1;04;644;Trie-Château;1914;33;1947
32;Hauts-de-France;60;1;04;645;Trie-la-Ville;306;6;312
32;Hauts-de-France;60;1;14;646;Troissereux;1347;35;1382
32;Hauts-de-France;60;3;06;647;Trosly-Breuil;2050;55;2105
32;Hauts-de-France;60;2;19;648;Troussencourt;321;3;324
32;Hauts-de-France;60;4;09;650;Trumilly;529;25;554
32;Hauts-de-France;60;4;13;651;Ully-Saint-Georges;1895;31;1926
32;Hauts-de-France;60;1;04;652;Valdampierre;913;10;923
32;Hauts-de-France;60;2;19;653;Valescourt;300;6;306
32;Hauts-de-France;60;3;21;654;Vandélicourt;263;5;268
32;Hauts-de-France;60;3;17;655;Varesnes;364;10;374
32;Hauts-de-France;60;4;15;656;Varinfroy;280;2;282
32;Hauts-de-France;60;3;17;657;Vauchelles;246;5;251
32;Hauts-de-France;60;4;09;658;Vauciennes;694;9;703
32;Hauts-de-France;60;1;04;659;Vaudancourt;171;2;173
32;Hauts-de-France;60;1;02;660;Le Vaumain;405;11;416
32;Hauts-de-France;60;4;09;661;Vaumoise;986;74;1060
32;Hauts-de-France;60;1;02;662;Le Vauroux;505;13;518
32;Hauts-de-France;60;1;14;663;Velennes;260;3;263
32;Hauts-de-France;60;2;19;664;Vendeuil-Caply;446;11;457
32;Hauts-de-France;60;3;07;665;Venette;2840;58;2898
32;Hauts-de-France;60;4;15;666;Ver-sur-Launette;1141;26;1167
32;Hauts-de-France;60;4;09;667;Verberie;3788;54;3842
32;Hauts-de-France;60;1;14;668;Verderel-lès-Sauqueuse;733;17;750
32;Hauts-de-France;60;2;05;669;Verderonne;490;12;502
32;Hauts-de-France;60;4;08;670;Verneuil-en-Halatte;4738;115;4853
32;Hauts-de-France;60;4;15;671;Versigny;350;19;369
32;Hauts-de-France;60;4;09;672;Vez;270;13;283
32;Hauts-de-France;60;1;19;673;Viefvillers;213;1;214
32;Hauts-de-France;60;3;07;674;Vieux-Moulin;600;31;631
32;Hauts-de-France;60;3;10;675;Vignemont;429;5;434
32;Hauts-de-France;60;3;17;676;Ville;755;17;772
32;Hauts-de-France;60;1;11;677;Villembray;253;10;263
32;Hauts-de-France;60;1;12;678;Villeneuve-les-Sablons;1153;24;1177
32;Hauts-de-France;60;4;15;679;La Villeneuve-sous-Thury;151;6;157
32;Hauts-de-France;60;4;18;680;Villeneuve-sur-Verberie;682;19;701
32;Hauts-de-France;60;1;02;681;Villers-Saint-Barthélemy;463;17;480
32;Hauts-de-France;60;4;18;682;Villers-Saint-Frambourg-Ognon;714;18;732
32;Hauts-de-France;60;4;15;683;Villers-Saint-Genest;390;16;406
32;Hauts-de-France;60;4;16;684;Villers-Saint-Paul;6442;65;6507
32;Hauts-de-France;60;1;04;685;Villers-Saint-Sépulcre;1028;10;1038
32;Hauts-de-France;60;4;13;686;Villers-sous-Saint-Leu;2307;57;2364
32;Hauts-de-France;60;1;11;687;Villers-sur-Auchy;372;10;382
32;Hauts-de-France;60;1;11;688;Villers-sur-Bonnières;159;1;160
32;Hauts-de-France;60;3;10;689;Villers-sur-Coudun;1400;48;1448
32;Hauts-de-France;60;1;11;691;Villers-Vermont;115;0;115
32;Hauts-de-France;60;2;19;692;Villers-Vicomte;143;2;145
32;Hauts-de-France;60;3;17;693;Villeselve;412;3;415
32;Hauts-de-France;60;4;20;695;Vineuil-Saint-Firmin;1397;49;1446
32;Hauts-de-France;60;1;11;697;Vrocourt;34;1;35
32;Hauts-de-France;60;2;10;698;Wacquemoulin;276;9;285
32;Hauts-de-France;60;1;11;699;Wambez;165;5;170
32;Hauts-de-France;60;1;02;700;Warluis;1200;22;1222
32;Hauts-de-France;60;2;19;701;Wavignies;1325;8;1333
32;Hauts-de-France;60;2;10;702;Welles-Pérennes;247;3;250
32;Hauts-de-France;60;1;02;703;Aux Marais;891;19;910
28;Normandie;61;1;97;001;Alençon;25744;720;26464
28;Normandie;61;1;19;002;Almenêches;647;10;657
28;Normandie;61;3;09;005;Appenai-sous-Bellême;280;8;288
28;Normandie;61;2;98;006;Argentan;13401;364;13765
28;Normandie;61;2;06;007;Athis-Val de Rouvre;4224;83;4307
28;Normandie;61;3;18;008;Aube;1258;46;1304
28;Normandie;61;3;21;010;Aubry-le-Panthou;123;6;129
28;Normandie;61;2;14;011;Aubusson;408;14;422
28;Normandie;61;3;20;012;Auguaise;210;2;212
28;Normandie;61;1;17;013;Aunay-les-Bois;138;0;138
28;Normandie;61;2;04;014;Aunou-le-Faucon;248;9;257
28;Normandie;61;1;19;015;Aunou-sur-Orne;261;5;266
28;Normandie;61;3;18;017;Les Authieux-du-Puits;82;0;82
28;Normandie;61;3;21;018;Avernes-Saint-Gourgon;65;1;66
28;Normandie;61;2;15;020;Avoine;214;7;221
28;Normandie;61;2;11;021;Avrilly;100;4;104
28;Normandie;61;2;05;023;Bailleul;612;22;634
28;Normandie;61;2;12;024;Banvou;610;16;626
28;Normandie;61;1;17;026;Barville;181;8;189
28;Normandie;61;2;06;028;Bazoches-au-Houlme;456;11;467
28;Normandie;61;3;16;029;Bazoches-sur-Hoëne;838;23;861
28;Normandie;61;2;13;030;La Bazoque;272;6;278
28;Normandie;61;3;18;032;Beaufai;329;8;337
28;Normandie;61;3;20;034;Beaulieu;199;7;206
28;Normandie;61;1;12;035;Beauvain;272;3;275
28;Normandie;61;1;19;036;Belfonds;204;0;204
28;Normandie;61;3;16;037;Bellavilliers;130;3;133
28;Normandie;61;3;09;038;Bellême;1455;20;1475
28;Normandie;61;1;19;039;La Bellière;131;1;132
28;Normandie;61;2;12;040;Bellou-en-Houlme;1053;30;1083
28;Normandie;61;3;09;041;Bellou-le-Trichard;205;4;209
28;Normandie;61;3;08;043;Berd'huis;1088;21;1109
28;Normandie;61;2;06;044;Berjou;446;15;461
28;Normandie;61;3;20;046;Bizou;134;0;134
28;Normandie;61;3;16;048;Boëcé;124;4;128
28;Normandie;61;1;19;049;Boissei-la-Lande;121;1;122
28;Normandie;61;3;08;050;Cour-Maugis sur Huisne;588;21;609
28;Normandie;61;1;19;051;Boitron;358;5;363
28;Normandie;61;3;20;052;Bonnefoi;190;4;194
28;Normandie;61;3;20;053;Bonsmoulins;233;7;240
28;Normandie;61;3;21;054;Le Bosc-Renoult;254;4;258
28;Normandie;61;2;15;055;Boucé;598;8;606
28;Normandie;61;1;19;056;Le Bouillon;167;1;168
28;Normandie;61;3;20;060;Brethel;156;5;161
28;Normandie;61;3;08;061;Bretoncelles;1475;30;1505
28;Normandie;61;2;04;062;Brieux;92;1;93
28;Normandie;61;2;06;063;Briouze;1510;38;1548
28;Normandie;61;1;17;064;Brullemail;93;1;94
28;Normandie;61;1;17;066;Buré;105;6;111
28;Normandie;61;1;17;067;Bures;163;1;164
28;Normandie;61;1;17;068;Bursard;203;1;204
28;Normandie;61;2;06;069;Cahan;164;7;171
28;Normandie;61;2;13;070;Caligny;825;23;848
28;Normandie;61;3;21;071;Camembert;170;7;177
28;Normandie;61;3;21;072;Canapville;201;4;205
28;Normandie;61;1;15;074;Carrouges;630;9;639
28;Normandie;61;1;07;075;Ceaucé;1161;26;1187
28;Normandie;61;1;19;076;Le Cercueil;138;5;143
28;Normandie;61;1;02;077;Cerisé;876;17;893
28;Normandie;61;2;13;078;Cerisy-Belle-Étoile;713;48;761
28;Normandie;61;3;09;079;Ceton;1768;24;1792
28;Normandie;61;1;15;080;Chahains;84;2;86
28;Normandie;61;1;19;081;Chailloué;894;24;918
28;Normandie;61;1;17;082;Le Chalange;86;5;91
28;Normandie;61;2;06;084;Champcerie;175;4;179
28;Normandie;61;1;15;085;Le Champ-de-la-Pierre;31;0;31
28;Normandie;61;3;21;086;Les Champeaux;102;0;102
28;Normandie;61;3;16;087;Champeaux-sur-Sarthe;160;4;164
28;Normandie;61;3;18;088;Champ-Haut;44;1;45
28;Normandie;61;3;21;089;Champosoult;96;0;96
28;Normandie;61;2;11;091;Champsecret;915;30;945
28;Normandie;61;3;01;092;Chandai;685;6;691
28;Normandie;61;2;11;093;Chanu;1259;17;1276
28;Normandie;61;2;13;094;La Chapelle-au-Moine;590;17;607
28;Normandie;61;2;13;095;La Chapelle-Biche;532;8;540
28;Normandie;61;1;07;096;Rives d'Andaine;2982;92;3074
28;Normandie;61;3;16;097;La Chapelle-Montligeon;515;14;529
28;Normandie;61;1;19;098;La Chapelle-près-Sées;461;32;493
28;Normandie;61;3;09;099;La Chapelle-Souëf;245;8;253
28;Normandie;61;3;20;100;La Chapelle-Viel;287;17;304
28;Normandie;61;1;19;101;Le Château-d'Almenêches;196;4;200
28;Normandie;61;2;13;102;Le Châtellier;404;9;413
28;Normandie;61;3;21;103;Chaumont;172;1;173
28;Normandie;61;1;15;104;La Chaux;52;1;53
28;Normandie;61;3;09;105;Chemilli;179;7;186
28;Normandie;61;1;15;107;Ciral;397;11;408
28;Normandie;61;3;21;108;Cisai-Saint-Aubin;175;4;179
28;Normandie;61;1;10;111;Colombiers;331;5;336
28;Normandie;61;3;16;113;Comblot;64;1;65
28;Normandie;61;2;04;114;Commeaux;154;5;159
28;Normandie;61;3;08;116;Sablons sur Huisne;2005;41;2046
28;Normandie;61;1;10;117;Condé-sur-Sarthe;2494;48;2542
28;Normandie;61;3;16;118;Corbon;116;5;121
28;Normandie;61;2;05;120;Coudehard;76;1;77
28;Normandie;61;3;16;121;Coulimer;297;9;306
28;Normandie;61;3;21;122;Coulmer;82;6;88
28;Normandie;61;2;05;123;Coulonces;219;5;224
28;Normandie;61;2;12;124;La Coulonche;503;5;508
28;Normandie;61;1;17;126;Coulonges-sur-Sarthe;489;10;499
28;Normandie;61;3;16;129;Courgeon;361;8;369
28;Normandie;61;3;16;130;Courgeoût;461;11;472
28;Normandie;61;1;17;133;Courtomer;708;17;725
28;Normandie;61;2;06;137;Craménil;131;4;135
28;Normandie;61;3;21;138;Croisilles;210;4;214
28;Normandie;61;3;21;139;Crouttes;301;11;312
28;Normandie;61;3;20;140;Crulai;832;21;853
28;Normandie;61;1;10;141;Cuissai;419;14;433
28;Normandie;61;3;09;142;Dame-Marie;135;4;139
28;Normandie;61;1;10;143;Damigny;2436;63;2499
28;Normandie;61;2;11;145;Domfront en Poiraie;4180;117;4297
28;Normandie;61;2;12;146;Dompierre;394;5;399
28;Normandie;61;2;06;148;Durcet;292;9;301
28;Normandie;61;2;12;149;Échalou;371;12;383
28;Normandie;61;3;18;150;Échauffour;740;13;753
28;Normandie;61;3;18;151;Écorcei;395;11;406
28;Normandie;61;2;05;152;Écorches;100;0;100
28;Normandie;61;2;15;153;Écouché-les-Vallées;2200;51;2251
28;Normandie;61;1;17;156;Essay;538;14;552
28;Normandie;61;2;06;158;Faverolles;143;3;146
28;Normandie;61;3;18;159;Fay;69;1;70
28;Normandie;61;3;16;160;Feings;184;4;188
28;Normandie;61;3;20;162;La Ferrière-au-Doyen;155;2;157
28;Normandie;61;2;12;163;La Ferrière-aux-Étangs;1552;21;1573
28;Normandie;61;1;19;164;La Ferrière-Béchet;242;2;244
28;Normandie;61;1;10;165;La Ferrière-Bochard;733;19;752
28;Normandie;61;1;17;166;Ferrières-la-Verrerie;139;3;142
28;Normandie;61;3;18;167;La Ferté-en-Ouche;3029;63;3092
28;Normandie;61;2;12;168;La Ferté Macé;5138;351;5489
28;Normandie;61;2;99;169;Flers;14589;339;14928
28;Normandie;61;2;15;170;Fleuré;199;8;207
28;Normandie;61;2;05;171;Fontaine-les-Bassets;107;2;109
28;Normandie;61;1;19;176;Francheville;139;2;141
28;Normandie;61;3;21;178;La Fresnaie-Fayel;53;1;54
28;Normandie;61;3;21;180;Fresnay-le-Samson;92;1;93
28;Normandie;61;3;21;181;Gacé;1796;59;1855
28;Normandie;61;1;10;182;Gandelain;421;5;426
28;Normandie;61;1;17;183;Gâprée;145;2;147
28;Normandie;61;3;20;187;Les Genettes;183;2;185
28;Normandie;61;3;18;188;La Genevraie;90;5;95
28;Normandie;61;2;06;189;Giel-Courteilles;468;207;675
28;Normandie;61;2;05;190;Ginai;73;1;74
28;Normandie;61;3;18;192;Godisson;105;4;109
28;Normandie;61;3;18;193;La Gonfrière;278;3;281
28;Normandie;61;2;15;194;Monts-sur-Orne;873;14;887
28;Normandie;61;2;06;195;Le Grais;197;1;198
28;Normandie;61;3;09;196;Belforêt-en-Perche;1508;51;1559
28;Normandie;61;2;05;197;Guêprei;133;4;137
28;Normandie;61;3;21;198;Guerquesalles;134;0;134
28;Normandie;61;2;06;199;Habloville;331;8;339
28;Normandie;61;1;17;202;Hauterive;462;11;473
28;Normandie;61;1;10;203;Héloup;897;25;922
28;Normandie;61;3;20;206;L'Hôme-Chamondot;252;2;254
28;Normandie;61;3;09;207;Igé;597;22;619
28;Normandie;61;3;20;208;Irai;621;15;636
28;Normandie;61;1;15;209;Joué-du-Bois;409;8;417
28;Normandie;61;2;15;210;Joué-du-Plain;246;9;255
28;Normandie;61;1;07;211;Juvigny Val d'Andaine;2124;53;2177
28;Normandie;61;2;04;212;Juvigny-sur-Orne;130;4;134
28;Normandie;61;1;10;213;Lalacelle;270;10;280
28;Normandie;61;3;01;214;L'Aigle;7903;241;8144
28;Normandie;61;1;17;215;Laleu;353;6;359
28;Normandie;61;1;15;216;La Lande-de-Goult;191;3;194
28;Normandie;61;2;15;217;La Lande-de-Lougé;54;1;55
28;Normandie;61;2;13;218;La Lande-Patry;1784;49;1833
28;Normandie;61;2;06;219;La Lande-Saint-Siméon;159;1;160
28;Normandie;61;2;14;221;Landigou;448;8;456
28;Normandie;61;2;13;222;Landisacq;765;19;784
28;Normandie;61;1;17;224;Larré;457;6;463
28;Normandie;61;3;18;225;Lignères;29;0;29
28;Normandie;61;2;06;227;Lignou;146;3;149
28;Normandie;61;1;15;228;L'Orée-d'Écouves;773;16;789
28;Normandie;61;3;16;229;Loisail;129;2;131
28;Normandie;61;3;20;230;Longny les Villages;2930;48;2978
28;Normandie;61;2;11;232;Lonlay-l'Abbaye;1117;39;1156
28;Normandie;61;2;12;233;Lonlay-le-Tesson;231;5;236
28;Normandie;61;1;10;234;Lonrai;1127;36;1163
28;Normandie;61;2;15;237;Lougé-sur-Maire;316;0;316
28;Normandie;61;2;05;238;Louvières-en-Auge;91;1;92
28;Normandie;61;1;19;240;Macé;393;10;403
28;Normandie;61;3;08;241;La Madeleine-Bouvet;410;11;421
28;Normandie;61;3;20;242;Le Mage;219;8;227
28;Normandie;61;1;15;243;Magny-le-Désert;1377;40;1417
28;Normandie;61;3;18;244;Mahéru;269;12;281
28;Normandie;61;1;07;248;Mantilly;513;10;523
28;Normandie;61;1;17;251;Marchemaisons;154;6;160
28;Normandie;61;3;21;252;Mardilly;136;4;140
28;Normandie;61;3;16;255;Mauves-sur-Huisne;529;14;543
28;Normandie;61;1;19;256;Médavy;152;5;157
28;Normandie;61;1;15;257;Méhoudin;121;0;121
28;Normandie;61;1;17;258;Le Mêle-sur-Sarthe;659;13;672
28;Normandie;61;3;20;259;Le Ménil-Bérard;71;0;71
28;Normandie;61;2;06;260;Le Ménil-de-Briouze;535;10;545
28;Normandie;61;1;17;261;Le Ménil-Broût;170;3;173
28;Normandie;61;2;11;262;Le Ménil-Ciboult;111;1;112
28;Normandie;61;1;17;263;Ménil-Erreux;202;6;208
28;Normandie;61;3;18;264;Ménil-Froger;57;1;58
28;Normandie;61;2;06;265;Ménil-Gondouin;162;3;165
28;Normandie;61;1;17;266;Le Ménil-Guyon;78;2;80
28;Normandie;61;2;06;267;Ménil-Hermei;203;3;206
28;Normandie;61;3;21;268;Ménil-Hubert-en-Exmes;109;5;114
28;Normandie;61;2;06;269;Ménil-Hubert-sur-Orne;482;8;490
28;Normandie;61;1;15;271;Le Ménil-Scelleur;84;0;84
28;Normandie;61;3;18;272;Le Ménil-Vicomte;23;0;23
28;Normandie;61;2;06;273;Ménil-Vin;51;3;54
28;Normandie;61;3;20;274;Les Menus;239;5;244
28;Normandie;61;3;18;275;Le Merlerault;753;17;770
28;Normandie;61;2;05;276;Merri;153;6;159
28;Normandie;61;3;16;277;La Mesnière;279;11;290
28;Normandie;61;2;12;278;Messei;1846;54;1900
28;Normandie;61;1;10;279;Mieuxcé;610;16;626
28;Normandie;61;2;13;281;Moncy;259;5;264
28;Normandie;61;2;04;283;Montabard;284;9;293
28;Normandie;61;1;17;284;Montchevrel;221;2;223
28;Normandie;61;3;16;286;Montgaudry;79;0;79
28;Normandie;61;2;14;287;Montilly-sur-Noireau;724;18;742
28;Normandie;61;1;19;288;Montmerrei;531;6;537
28;Normandie;61;2;05;289;Mont-Ormel;49;1;50
28;Normandie;61;2;06;290;Montreuil-au-Houlme;129;3;132
28;Normandie;61;2;05;291;Montreuil-la-Cambe;69;2;71
28;Normandie;61;2;11;292;Montsecret-Clairefougère;650;9;659
28;Normandie;61;3;16;293;Mortagne-au-Perche;3758;297;4055
28;Normandie;61;1;19;294;Mortrée;1144;23;1167
28;Normandie;61;1;15;295;La Motte-Fouquet;163;2;165
28;Normandie;61;3;20;297;Moulins-la-Marche;731;11;742
28;Normandie;61;2;04;298;Moulins-sur-Orne;316;11;327
28;Normandie;61;3;08;300;Moutiers-au-Perche;378;7;385
28;Normandie;61;1;19;301;Neauphe-sous-Essai;212;1;213
28;Normandie;61;2;05;302;Neauphe-sur-Dive;136;3;139
28;Normandie;61;2;04;303;Nécy;519;13;532
28;Normandie;61;1;17;304;Neuilly-le-Bisson;293;9;302
28;Normandie;61;3;21;307;Neuville-sur-Touques;230;2;232
28;Normandie;61;2;06;308;Neuvy-au-Houlme;204;4;208
28;Normandie;61;3;08;309;Perche en Nocé;2010;63;2073
28;Normandie;61;3;18;310;Nonant-le-Pin;421;27;448
28;Normandie;61;2;04;314;Occagnes;676;17;693
28;Normandie;61;2;05;316;Ommoy;113;3;116
28;Normandie;61;3;21;317;Orgères;182;5;187
28;Normandie;61;3;09;319;Origny-le-Roux;258;7;265
28;Normandie;61;1;10;321;Pacé;419;7;426
28;Normandie;61;3;16;322;Parfondeval;108;3;111
28;Normandie;61;3;20;323;Le Pas-Saint-l'Homer;125;2;127
28;Normandie;61;1;07;324;Passais Villages;1163;16;1179
28;Normandie;61;1;07;326;Perrou;349;5;354
28;Normandie;61;3;16;327;Pervenchères;339;11;350
28;Normandie;61;2;05;328;Le Pin-au-Haras;266;5;271
28;Normandie;61;3;16;329;Le Pin-la-Garenne;632;10;642
28;Normandie;61;3;18;330;Planches;183;3;186
28;Normandie;61;1;17;331;Le Plantis;132;2;134
28;Normandie;61;2;06;332;Pointel;311;29;340
28;Normandie;61;3;21;333;Pontchardon;167;3;170
28;Normandie;61;3;09;336;Pouvrai;102;7;109
28;Normandie;61;2;06;339;Putanges-le-Lac;2140;32;2172
28;Normandie;61;1;17;341;Écouves;1656;43;1699
28;Normandie;61;3;18;342;Rai;1416;21;1437
28;Normandie;61;2;15;344;Rânes;1033;11;1044
28;Normandie;61;3;08;345;Rémalard en Perche;1898;42;1940
28;Normandie;61;3;21;346;Le Renouard;204;6;210
28;Normandie;61;3;21;347;Résenlieu;178;0;178
28;Normandie;61;3;16;348;Réveillon;370;7;377
28;Normandie;61;2;04;349;Ri;158;3;161
28;Normandie;61;1;10;350;La Roche-Mabile;161;8;169
28;Normandie;61;3;21;351;Roiville;134;4;138
28;Normandie;61;2;04;352;Rônai;177;5;182
28;Normandie;61;1;15;357;Rouperroux;191;6;197
28;Normandie;61;2;04;358;Sai;226;5;231
28;Normandie;61;1;17;360;Saint-Agnan-sur-Sarthe;90;2;92
28;Normandie;61;2;06;361;Saint-André-de-Briouze;170;5;175
28;Normandie;61;2;12;362;Saint-André-de-Messei;529;18;547
28;Normandie;61;3;16;363;Saint-Aquilin-de-Corbion;57;1;58
28;Normandie;61;1;17;365;Saint-Aubin-d'Appenai;407;8;415
28;Normandie;61;3;21;366;Saint-Aubin-de-Bonneval;132;2;134
28;Normandie;61;3;16;367;Saint-Aubin-de-Courteraie;131;2;133
28;Normandie;61;2;11;369;Saint-Bômer-les-Forges;1027;35;1062
28;Normandie;61;2;11;370;Saint-Brice;149;2;151
28;Normandie;61;2;15;371;Saint-Brice-sous-Rânes;134;2;136
28;Normandie;61;1;10;372;Saint-Céneri-le-Gérei;112;4;116
28;Normandie;61;3;16;373;Sainte-Céronne-lès-Mortagne;246;8;254
28;Normandie;61;2;11;374;Saint-Christophe-de-Chaulieu;96;4;100
28;Normandie;61;2;04;375;Boischampré;1189;37;1226
28;Normandie;61;2;13;376;Saint-Clair-de-Halouze;849;18;867
28;Normandie;61;3;08;379;Saint-Cyr-la-Rosière;234;5;239
28;Normandie;61;3;16;381;Saint-Denis-sur-Huisne;59;4;63
28;Normandie;61;1;10;382;Saint-Denis-sur-Sarthon;1125;19;1144
28;Normandie;61;1;15;384;Saint-Ellier-les-Bois;258;2;260
28;Normandie;61;3;21;385;Saint-Evroult-de-Montfort;336;9;345
28;Normandie;61;3;18;386;Saint-Evroult-Notre-Dame-du-Bois;441;31;472
28;Normandie;61;1;07;387;Saint-Fraimbault;537;18;555
28;Normandie;61;3;09;388;Saint-Fulgent-des-Ormes;163;7;170
28;Normandie;61;3;18;389;Sainte-Gauburge-Sainte-Colombe;1022;23;1045
28;Normandie;61;2;15;390;Saint-Georges-d'Annebecq;161;0;161
28;Normandie;61;2;14;391;Saint-Georges-des-Groseillers;3164;112;3276
28;Normandie;61;3;21;392;Saint-Germain-d'Aunay;133;1;134
28;Normandie;61;3;18;393;Saint-Germain-de-Clairefeuille;134;5;139
28;Normandie;61;3;09;394;Saint-Germain-de-la-Coudre;816;21;837
28;Normandie;61;3;08;395;Saint-Germain-des-Grois;227;4;231
28;Normandie;61;3;16;396;Saint-Germain-de-Martigny;81;5;86
28;Normandie;61;1;03;397;Saint-Germain-du-Corbéis;3738;98;3836
28;Normandie;61;1;17;398;Saint-Germain-le-Vieux;60;1;61
28;Normandie;61;2;05;399;Saint-Gervais-des-Sablons;73;3;76
28;Normandie;61;1;19;400;Saint-Gervais-du-Perron;357;4;361
28;Normandie;61;2;11;401;Saint-Gilles-des-Marais;104;4;108
28;Normandie;61;2;06;402;Saint-Hilaire-de-Briouze;308;8;316
28;Normandie;61;3;16;404;Saint-Hilaire-le-Châtel;654;12;666
28;Normandie;61;3;09;405;Saint-Hilaire-sur-Erre;516;17;533
28;Normandie;61;3;20;406;Saint-Hilaire-sur-Risle;307;4;311
28;Normandie;61;2;06;407;Sainte-Honorine-la-Chardonne;692;13;705
28;Normandie;61;2;06;408;Sainte-Honorine-la-Guillaume;336;7;343
28;Normandie;61;3;16;411;Saint-Jouin-de-Blavou;289;7;296
28;Normandie;61;1;17;412;Saint-Julien-sur-Sarthe;694;14;708
28;Normandie;61;2;05;413;Saint-Lambert-sur-Dive;136;4;140
28;Normandie;61;3;16;414;Saint-Langis-lès-Mortagne;878;23;901
28;Normandie;61;1;17;415;Saint-Léger-sur-Sarthe;314;6;320
28;Normandie;61;1;17;416;Saint-Léonard-des-Parcs;77;1;78
28;Normandie;61;3;16;418;Saint-Mard-de-Réno;413;12;425
28;Normandie;61;1;15;419;Sainte-Marguerite-de-Carrouges;212;5;217
28;Normandie;61;1;15;420;Sainte-Marie-la-Robert;89;1;90
28;Normandie;61;1;07;421;Saint-Mars-d'Égrenne;653;18;671
28;Normandie;61;3;20;422;Les Aspres;611;15;626
28;Normandie;61;3;01;423;Saint-Martin-d'Écublei;637;26;663
28;Normandie;61;1;15;424;Saint-Martin-des-Landes;190;4;194
28;Normandie;61;3;16;425;Saint-Martin-des-Pézerits;137;3;140
28;Normandie;61;3;09;426;Saint-Martin-du-Vieux-Bellême;553;16;569
28;Normandie;61;1;15;427;Saint-Martin-l'Aiguillon;192;3;195
28;Normandie;61;3;20;429;Charencey;773;15;788
28;Normandie;61;3;01;432;Saint-Michel-Tubœuf;589;21;610
28;Normandie;61;1;10;433;Saint-Nicolas-des-Bois;285;8;293
28;Normandie;61;3;18;435;Saint-Nicolas-de-Sommaire;272;5;277
28;Normandie;61;2;06;436;Sainte-Opportune;237;2;239
28;Normandie;61;3;16;438;Saint-Ouen-de-Sécherouvre;172;5;177
28;Normandie;61;1;15;439;Saint-Ouen-le-Brisoult;119;4;123
28;Normandie;61;3;01;440;Saint-Ouen-sur-Iton;830;35;865
28;Normandie;61;1;15;442;Saint-Patrice-du-Désert;227;6;233
28;Normandie;61;2;13;443;Saint-Paul;694;15;709
28;Normandie;61;2;06;444;Saint-Philbert-sur-Orne;117;0;117
28;Normandie;61;2;13;445;Saint-Pierre-d'Entremont;660;9;669
28;Normandie;61;3;18;446;Saint-Pierre-des-Loges;157;6;163
28;Normandie;61;2;14;447;Saint-Pierre-du-Regard;1381;32;1413
28;Normandie;61;3;08;448;Saint-Pierre-la-Bruyère;431;6;437
28;Normandie;61;1;17;450;Saint-Quentin-de-Blavou;72;1;73
28;Normandie;61;2;11;451;Saint-Quentin-les-Chardonnets;313;6;319
28;Normandie;61;1;07;452;Saint-Roch-sur-Égrenne;166;4;170
28;Normandie;61;1;15;453;Saint-Sauveur-de-Carrouges;244;7;251
28;Normandie;61;1;17;454;Sainte-Scolasse-sur-Sarthe;586;15;601
28;Normandie;61;3;01;456;Saint-Sulpice-sur-Risle;1642;37;1679
28;Normandie;61;3;18;457;Saint-Symphorien-des-Bruyères;476;8;484
28;Normandie;61;2;12;459;Saires-la-Verrerie;304;7;311
28;Normandie;61;3;21;460;Sap-en-Auge;960;10;970
28;Normandie;61;3;21;461;Le Sap-André;127;3;130
28;Normandie;61;2;04;462;Sarceaux;1042;34;1076
28;Normandie;61;2;12;463;Les Monts d'Andaine;1737;32;1769
28;Normandie;61;1;19;464;Sées;4199;435;4634
28;Normandie;61;2;14;466;La Selle-la-Forge;1451;31;1482
28;Normandie;61;1;17;467;Semallé;333;10;343
28;Normandie;61;2;04;472;Sévigny;304;12;316
28;Normandie;61;2;15;473;Sevrai;272;5;277
28;Normandie;61;2;05;474;Gouffern en Auge;3687;81;3768
28;Normandie;61;3;16;475;Soligny-la-Trappe;667;15;682
28;Normandie;61;3;09;476;Suré;274;5;279
28;Normandie;61;2;15;479;Tanques;157;4;161
28;Normandie;61;1;19;480;Tanville;231;5;236
28;Normandie;61;1;17;481;Tellières-le-Plessis;77;3;80
28;Normandie;61;1;07;482;Tessé-Froulay;380;9;389
28;Normandie;61;1;07;483;Bagnoles de l'Orne Normandie;2720;47;2767
28;Normandie;61;3;09;484;Val-au-Perche;3410;72;3482
28;Normandie;61;3;21;485;Ticheville;193;7;200
28;Normandie;61;2;11;486;Tinchebray-Bocage;4896;86;4982
28;Normandie;61;1;07;487;Torchamp;301;4;305
28;Normandie;61;3;18;488;Touquettes;85;2;87
28;Normandie;61;2;05;490;Tournai-sur-Dive;300;4;304
28;Normandie;61;3;20;491;Tourouvre au Perche;3069;48;3117
28;Normandie;61;1;17;492;Trémont;119;3;122
28;Normandie;61;3;21;493;La Trinité-des-Laitiers;57;5;62
28;Normandie;61;2;05;494;Trun;1223;67;1290
28;Normandie;61;1;10;497;Valframbert;1760;31;1791
28;Normandie;61;3;09;498;Vaunoise;99;4;103
28;Normandie;61;1;17;499;Les Ventes-de-Bourse;145;3;148
28;Normandie;61;3;20;500;La Ventrouze;125;4;129
28;Normandie;61;3;08;501;Verrières;421;5;426
28;Normandie;61;1;17;502;Vidai;90;2;92
28;Normandie;61;2;15;503;Vieux-Pont;198;4;202
28;Normandie;61;2;05;505;Villedieu-lès-Bailleul;215;6;221
28;Normandie;61;3;16;507;Villiers-sous-Mortagne;268;6;274
28;Normandie;61;3;21;508;Vimoutiers;3096;88;3184
28;Normandie;61;3;01;510;Vitrai-sous-Laigle;225;6;231
28;Normandie;61;2;06;512;Les Yveteaux;104;2;106
32;Hauts-de-France;62;7;17;001;Ablain-Saint-Nazaire;1929;39;1968
32;Hauts-de-France;62;1;09;002;Ablainzevelle;231;3;234
32;Hauts-de-France;62;7;08;003;Acheville;599;22;621
32;Hauts-de-France;62;1;04;004;Achicourt;7981;110;8091
32;Hauts-de-France;62;1;09;005;Achiet-le-Grand;969;5;974
32;Hauts-de-France;62;1;09;006;Achiet-le-Petit;312;5;317
32;Hauts-de-France;62;1;02;007;Acq;805;5;810
32;Hauts-de-France;62;5;33;008;Acquin-Westbécourt;796;11;807
32;Hauts-de-France;62;1;07;009;Adinfer;282;7;289
32;Hauts-de-France;62;5;33;010;Affringues;256;0;256
32;Hauts-de-France;62;1;07;011;Agnez-lès-Duisans;662;16;678
32;Hauts-de-France;62;1;07;012;Agnières;255;4;259
32;Hauts-de-France;62;1;04;013;Agny;1891;35;1926
32;Hauts-de-France;62;5;01;014;Aire-sur-la-Lys;9610;259;9869
32;Hauts-de-France;62;4;10;015;Airon-Notre-Dame;245;5;250
32;Hauts-de-France;62;4;10;016;Airon-Saint-Vaast;189;5;194
32;Hauts-de-France;62;4;33;017;Aix-en-Ergny;202;1;203
32;Hauts-de-France;62;4;06;018;Aix-en-Issart;273;5;278
32;Hauts-de-France;62;7;17;019;Aix-Noulette;3917;41;3958
32;Hauts-de-France;62;6;19;020;Alembon;622;11;633
32;Hauts-de-France;62;4;33;021;Alette;385;1;386
32;Hauts-de-France;62;3;22;022;Alincthun;306;10;316
32;Hauts-de-France;62;2;31;023;Allouagne;2871;31;2902
32;Hauts-de-France;62;5;33;024;Alquines;994;13;1007
32;Hauts-de-France;62;3;22;025;Ambleteuse;1998;33;2031
32;Hauts-de-France;62;4;25;026;Ambricourt;120;9;129
32;Hauts-de-France;62;1;07;027;Ambrines;217;0;217
32;Hauts-de-France;62;2;31;028;Ames;627;8;635
32;Hauts-de-France;62;2;31;029;Amettes;461;1;462
32;Hauts-de-France;62;1;07;030;Amplier;301;4;305
32;Hauts-de-France;62;6;19;031;Andres;1552;23;1575
32;Hauts-de-France;62;7;17;032;Angres;4777;57;4834
32;Hauts-de-France;62;7;29;033;Annay;4477;25;4502
32;Hauts-de-France;62;2;23;034;Annequin;2143;13;2156
32;Hauts-de-France;62;2;11;035;Annezin;5807;50;5857
32;Hauts-de-France;62;1;38;036;Anvin;736;14;750
32;Hauts-de-France;62;1;02;037;Anzin-Saint-Aubin;2778;72;2850
32;Hauts-de-France;62;6;19;038;Ardres;4404;49;4453
32;Hauts-de-France;62;1;15;039;Arleux-en-Gohelle;886;21;907
32;Hauts-de-France;62;5;32;040;Arques;9521;120;9641
32;Hauts-de-France;62;1;96;041;Arras;42337;796;43133
32;Hauts-de-France;62;1;03;042;Athies;1058;12;1070
32;Hauts-de-France;62;6;19;043;Les Attaques;2040;20;2060
32;Hauts-de-France;62;4;10;044;Attin;811;7;818
32;Hauts-de-France;62;1;07;045;Aubigny-en-Artois;1479;17;1496
32;Hauts-de-France;62;4;06;046;Aubin-Saint-Vaast;734;6;740
32;Hauts-de-France;62;1;38;047;Aubrometz;148;1;149
32;Hauts-de-France;62;2;05;048;Auchel;10221;42;10263
32;Hauts-de-France;62;2;31;049;Auchy-au-Bois;534;1;535
32;Hauts-de-France;62;4;06;050;Auchy-lès-Hesdin;1544;15;1559
32;Hauts-de-France;62;2;23;051;Auchy-les-Mines;4656;30;4686
32;Hauts-de-France;62;3;22;052;Audembert;458;13;471
32;Hauts-de-France;62;5;25;053;Audincthun;662;5;667
32;Hauts-de-France;62;3;22;054;Audinghen;594;8;602
32;Hauts-de-France;62;5;33;055;Audrehem;522;9;531
32;Hauts-de-France;62;3;22;056;Audresselles;628;5;633
32;Hauts-de-France;62;6;34;057;Audruicq;5428;52;5480
32;Hauts-de-France;62;1;38;058;Aumerval;201;5;206
32;Hauts-de-France;62;6;19;059;Autingues;288;14;302
32;Hauts-de-France;62;1;06;060;Auxi-le-Château;2563;25;2588
32;Hauts-de-France;62;1;38;061;Averdoingt;293;7;300
32;Hauts-de-France;62;4;33;062;Avesnes;55;1;56
32;Hauts-de-France;62;1;07;063;Avesnes-le-Comte;1820;29;1849
32;Hauts-de-France;62;1;09;064;Avesnes-lès-Bapaume;167;2;169
32;Hauts-de-France;62;7;08;065;Avion;17676;136;17812
32;Hauts-de-France;62;4;25;066;Avondance;34;2;36
32;Hauts-de-France;62;5;25;067;Avroult;593;7;600
32;Hauts-de-France;62;1;09;068;Ayette;324;7;331
32;Hauts-de-France;62;4;06;069;Azincourt;311;8;319
32;Hauts-de-France;62;1;07;070;Bailleul-aux-Cornailles;263;5;268
32;Hauts-de-France;62;1;38;071;Bailleul-lès-Pernes;406;7;413
32;Hauts-de-France;62;1;07;072;Bailleulmont;220;2;222
32;Hauts-de-France;62;1;03;073;Bailleul-Sir-Berthoult;1428;25;1453
32;Hauts-de-France;62;1;07;074;Bailleulval;232;8;240
32;Hauts-de-France;62;3;14;075;Baincthun;1296;29;1325
32;Hauts-de-France;62;6;19;076;Bainghen;217;1;218
32;Hauts-de-France;62;2;16;077;Bajus;363;6;369
32;Hauts-de-France;62;6;19;078;Balinghem;1225;23;1248
32;Hauts-de-France;62;1;09;079;Bancourt;86;1;87
32;Hauts-de-France;62;1;09;080;Bapaume;3749;319;4068
32;Hauts-de-France;62;1;09;081;Baralle;463;10;473
32;Hauts-de-France;62;1;09;082;Barastre;319;4;323
32;Hauts-de-France;62;2;35;083;Barlin;7456;45;7501
32;Hauts-de-France;62;1;07;084;Barly;207;7;214
32;Hauts-de-France;62;1;07;085;Basseux;134;5;139
32;Hauts-de-France;62;1;07;086;Bavincourt;396;6;402
32;Hauts-de-France;62;5;37;087;Bayenghem-lès-Éperlecques;1010;23;1033
32;Hauts-de-France;62;5;33;088;Bayenghem-lès-Seninghem;328;6;334
32;Hauts-de-France;62;3;22;089;Bazinghen;398;9;407
32;Hauts-de-France;62;4;06;090;Béalencourt;128;4;132
32;Hauts-de-France;62;1;07;091;Beaudricourt;90;2;92
32;Hauts-de-France;62;1;07;092;Beaufort-Blavincourt;406;3;409
32;Hauts-de-France;62;1;09;093;Beaulencourt;226;0;226
32;Hauts-de-France;62;4;10;094;Beaumerie-Saint-Martin;401;9;410
32;Hauts-de-France;62;5;25;095;Beaumetz-lès-Aire;241;1;242
32;Hauts-de-France;62;1;09;096;Beaumetz-lès-Cambrai;559;9;568
32;Hauts-de-France;62;1;02;097;Beaumetz-lès-Loges;999;14;1013
32;Hauts-de-France;62;1;04;099;Beaurains;5509;62;5571
32;Hauts-de-France;62;4;06;100;Beaurainville;2071;28;2099
32;Hauts-de-France;62;1;38;101;Beauvois;136;1;137
32;Hauts-de-France;62;4;33;102;Bécourt;275;3;278
32;Hauts-de-France;62;1;09;103;Béhagnies;134;2;136
32;Hauts-de-France;62;3;22;104;Bellebrune;437;7;444
32;Hauts-de-France;62;3;22;105;Belle-et-Houllefort;565;16;581
32;Hauts-de-France;62;1;15;106;Bellonne;206;2;208
32;Hauts-de-France;62;7;39;107;Bénifontaine;350;8;358
32;Hauts-de-France;62;4;10;108;Berck;13442;336;13778
32;Hauts-de-France;62;1;38;109;Bergueneuse;218;1;219
32;Hauts-de-France;62;1;07;111;Berlencourt-le-Cauroy;280;79;359
32;Hauts-de-France;62;1;07;112;Berles-au-Bois;520;8;528
32;Hauts-de-France;62;1;07;113;Berles-Monchel;496;12;508
32;Hauts-de-France;62;1;38;114;Bermicourt;172;4;176
32;Hauts-de-France;62;1;07;115;Berneville;466;18;484
32;Hauts-de-France;62;4;10;116;Bernieulles;178;2;180
32;Hauts-de-France;62;1;09;117;Bertincourt;913;14;927
32;Hauts-de-France;62;1;07;118;Béthonsart;143;4;147
32;Hauts-de-France;62;2;11;119;Béthune;24983;331;25314
32;Hauts-de-France;62;2;16;120;Beugin;466;8;474
32;Hauts-de-France;62;1;09;121;Beugnâtre;174;4;178
32;Hauts-de-France;62;1;09;122;Beugny;358;4;362
32;Hauts-de-France;62;4;33;123;Beussent;537;4;541
32;Hauts-de-France;62;4;10;124;Beutin;446;5;451
32;Hauts-de-France;62;3;22;125;Beuvrequen;460;11;471
32;Hauts-de-France;62;2;12;126;Beuvry;9164;159;9323
32;Hauts-de-France;62;4;33;127;Bezinghem;383;12;395
32;Hauts-de-France;62;1;15;128;Biache-Saint-Vaast;4413;46;4459
32;Hauts-de-France;62;1;09;129;Biefvillers-lès-Bapaume;96;2;98
32;Hauts-de-France;62;1;07;130;Bienvillers-au-Bois;654;14;668
32;Hauts-de-France;62;1;09;131;Bihucourt;338;3;341
32;Hauts-de-France;62;2;23;132;Billy-Berclau;5034;41;5075
32;Hauts-de-France;62;7;26;133;Billy-Montigny;8185;37;8222
32;Hauts-de-France;62;4;33;134;Bimont;109;2;111
32;Hauts-de-France;62;1;07;135;Blairville;307;2;309
32;Hauts-de-France;62;1;38;137;Blangerval-Blangermont;94;0;94
32;Hauts-de-France;62;4;06;138;Blangy-sur-Ternoise;704;13;717
32;Hauts-de-France;62;5;32;139;Blendecques;4926;174;5100
32;Hauts-de-France;62;5;33;140;Bléquin;492;5;497
32;Hauts-de-France;62;2;01;141;Blessy;903;12;915
32;Hauts-de-France;62;4;06;142;Blingel;157;7;164
32;Hauts-de-France;62;1;06;143;Boffles;48;1;49
32;Hauts-de-France;62;1;04;144;Boiry-Becquerelle;469;7;476
32;Hauts-de-France;62;1;15;145;Boiry-Notre-Dame;439;6;445
32;Hauts-de-France;62;1;07;146;Boiry-Saint-Martin;268;2;270
32;Hauts-de-France;62;1;07;147;Boiry-Sainte-Rictrude;402;4;406
32;Hauts-de-France;62;7;26;148;Bois-Bernard;821;8;829
32;Hauts-de-France;62;5;33;149;Boisdinghem;244;8;252
32;Hauts-de-France;62;4;06;150;Boisjean;502;7;509
32;Hauts-de-France;62;1;04;151;Boisleux-au-Mont;510;10;520
32;Hauts-de-France;62;1;04;152;Boisleux-Saint-Marc;248;2;250
32;Hauts-de-France;62;5;25;153;Bomy;653;9;662
32;Hauts-de-France;62;1;38;154;Bonnières;682;14;696
32;Hauts-de-France;62;5;33;155;Bonningues-lès-Ardres;635;14;649
32;Hauts-de-France;62;6;18;156;Bonningues-lès-Calais;572;20;592
32;Hauts-de-France;62;4;06;157;Boubers-lès-Hesmond;75;2;77
32;Hauts-de-France;62;1;38;158;Boubers-sur-Canche;580;12;592
32;Hauts-de-France;62;3;97;160;Boulogne-sur-Mer;40588;397;40985
32;Hauts-de-France;62;6;19;161;Bouquehault;787;5;792
32;Hauts-de-France;62;2;31;162;Bourecq;589;6;595
32;Hauts-de-France;62;1;38;163;Bouret-sur-Canche;249;3;252
32;Hauts-de-France;62;1;09;164;Bourlon;1133;19;1152
32;Hauts-de-France;62;3;22;165;Bournonville;231;5;236
32;Hauts-de-France;62;1;38;166;Bours;612;10;622
32;Hauts-de-France;62;6;19;167;Boursin;254;4;258
32;Hauts-de-France;62;4;33;168;Bourthes;841;12;853
32;Hauts-de-France;62;5;33;169;Bouvelinghem;246;6;252
32;Hauts-de-France;62;7;17;170;Bouvigny-Boyeffles;2376;95;2471
32;Hauts-de-France;62;1;38;171;Boyaval;130;2;132
32;Hauts-de-France;62;1;04;172;Boyelles;362;4;366
32;Hauts-de-France;62;1;15;173;Brebières;5128;73;5201
32;Hauts-de-France;62;6;19;174;Brêmes;1294;12;1306
32;Hauts-de-France;62;4;06;175;Brévillers;158;4;162
32;Hauts-de-France;62;4;24;176;Bréxent-Énocq;642;18;660
32;Hauts-de-France;62;4;06;177;Brimeux;861;17;878
32;Hauts-de-France;62;2;16;178;Bruay-la-Buissière;21953;353;22306
32;Hauts-de-France;62;3;22;179;Brunembert;408;7;415
32;Hauts-de-France;62;1;38;180;Brias;293;5;298
32;Hauts-de-France;62;1;09;181;Bucquoy;1454;108;1562
32;Hauts-de-France;62;1;06;182;Buire-au-Bois;239;7;246
32;Hauts-de-France;62;4;06;183;Buire-le-Sec;759;3;762
32;Hauts-de-France;62;1;09;184;Buissy;294;3;297
32;Hauts-de-France;62;1;09;185;Bullecourt;227;2;229
32;Hauts-de-France;62;7;17;186;Bully-les-Mines;12080;72;12152
32;Hauts-de-France;62;1;38;187;Buneville;182;2;184
32;Hauts-de-France;62;2;31;188;Burbure;2812;28;2840
32;Hauts-de-France;62;1;09;189;Bus;132;2;134
32;Hauts-de-France;62;2;31;190;Busnes;1244;17;1261
32;Hauts-de-France;62;6;19;191;Caffiers;728;3;731
32;Hauts-de-France;62;1;15;192;Cagnicourt;426;11;437
32;Hauts-de-France;62;6;98;193;Calais;67544;649;68193
32;Hauts-de-France;62;2;05;194;Calonne-Ricouart;5511;28;5539
32;Hauts-de-France;62;2;31;195;Calonne-sur-la-Lys;1543;20;1563
32;Hauts-de-France;62;4;10;196;La Calotterie;599;11;610
32;Hauts-de-France;62;2;05;197;Camblain-Châtelain;1774;17;1791
32;Hauts-de-France;62;1;07;198;Cambligneul;338;10;348
32;Hauts-de-France;62;1;07;199;Camblain-l'Abbé;671;122;793
32;Hauts-de-France;62;2;23;200;Cambrin;1221;13;1234
32;Hauts-de-France;62;4;24;201;Camiers;2707;39;2746
32;Hauts-de-France;62;4;33;202;Campagne-lès-Boulonnais;676;98;774
32;Hauts-de-France;62;6;19;203;Campagne-lès-Guines;437;6;443
32;Hauts-de-France;62;4;06;204;Campagne-lès-Hesdin;1945;30;1975
32;Hauts-de-France;62;5;32;205;Campagne-lès-Wardrecques;1288;27;1315
32;Hauts-de-France;62;4;10;206;Campigneulles-les-Grandes;284;15;299
32;Hauts-de-France;62;4;10;207;Campigneulles-les-Petites;544;14;558
32;Hauts-de-France;62;1;07;208;Canettemont;71;2;73
32;Hauts-de-France;62;4;25;209;Canlers;152;10;162
32;Hauts-de-France;62;1;07;211;Capelle-Fermont;217;4;221
32;Hauts-de-France;62;4;06;212;Capelle-lès-Hesdin;507;11;518
32;Hauts-de-France;62;7;17;213;Carency;796;11;807
32;Hauts-de-France;62;3;22;214;Carly;607;11;618
32;Hauts-de-France;62;7;21;215;Carvin;17667;94;17761
32;Hauts-de-France;62;1;07;216;La Cauchie;208;2;210
32;Hauts-de-France;62;2;05;217;Cauchy-à-la-Tour;2723;14;2737
32;Hauts-de-France;62;2;16;218;Caucourt;334;8;342
32;Hauts-de-France;62;4;06;219;Caumont;158;4;162
32;Hauts-de-France;62;4;06;220;Cavron-Saint-Martin;445;5;450
32;Hauts-de-France;62;1;07;221;Chelers;245;5;250
32;Hauts-de-France;62;4;06;222;Chériennes;159;1;160
32;Hauts-de-France;62;1;09;223;Chérisy;290;5;295
32;Hauts-de-France;62;2;11;224;Chocques;2821;27;2848
32;Hauts-de-France;62;5;37;225;Clairmarais;600;11;611
32;Hauts-de-France;62;4;33;227;Clenleu;185;2;187
32;Hauts-de-France;62;5;33;228;Clerques;320;4;324
32;Hauts-de-France;62;5;33;229;Cléty;804;16;820
32;Hauts-de-France;62;3;22;230;Colembert;950;15;965
32;Hauts-de-France;62;4;10;231;Colline-Beaumont;128;0;128
32;Hauts-de-France;62;2;16;232;La Comté;892;15;907
32;Hauts-de-France;62;4;10;233;Conchil-le-Temple;1113;14;1127
32;Hauts-de-France;62;1;38;234;Conchy-sur-Canche;221;4;225
32;Hauts-de-France;62;3;36;235;Condette;2482;89;2571
32;Hauts-de-France;62;4;06;236;Contes;343;8;351
32;Hauts-de-France;62;3;13;237;Conteville-lès-Boulogne;518;10;528
32;Hauts-de-France;62;1;38;238;Conteville-en-Ternois;81;1;82
32;Hauts-de-France;62;6;18;239;Coquelles;2601;34;2635
32;Hauts-de-France;62;1;15;240;Corbehem;2272;15;2287
32;Hauts-de-France;62;4;24;241;Cormont;312;5;317
32;Hauts-de-France;62;1;07;242;Couin;88;5;93
32;Hauts-de-France;62;1;07;243;Coullemont;125;3;128
32;Hauts-de-France;62;6;19;244;Coulogne;5451;207;5658
32;Hauts-de-France;62;5;33;245;Coulomby;763;7;770
32;Hauts-de-France;62;4;25;246;Coupelle-Neuve;150;0;150
32;Hauts-de-France;62;4;25;247;Coupelle-Vieille;602;11;613
32;Hauts-de-France;62;1;09;248;Courcelles-le-Comte;473;6;479
32;Hauts-de-France;62;7;28;249;Courcelles-lès-Lens;8166;38;8204
32;Hauts-de-France;62;7;21;250;Courrières;10360;95;10455
32;Hauts-de-France;62;3;22;251;Courset;512;191;703
32;Hauts-de-France;62;2;12;252;La Couture;2643;70;2713
32;Hauts-de-France;62;1;07;253;Couturelle;74;0;74
32;Hauts-de-France;62;5;25;254;Coyecques;602;13;615
32;Hauts-de-France;62;3;22;255;Crémarest;796;15;811
32;Hauts-de-France;62;4;25;256;Crépy;153;2;155
32;Hauts-de-France;62;4;25;257;Créquy;463;10;473
32;Hauts-de-France;62;1;38;258;Croisette;265;5;270
32;Hauts-de-France;62;1;09;259;Croisilles;1961;24;1985
32;Hauts-de-France;62;1;38;260;Croix-en-Ternois;330;3;333
32;Hauts-de-France;62;4;24;261;Cucq;5094;84;5178
32;Hauts-de-France;62;2;23;262;Cuinchy;1751;22;1773
32;Hauts-de-France;62;1;02;263;Dainville;5689;102;5791
32;Hauts-de-France;62;3;36;264;Dannes;1332;4;1336
32;Hauts-de-France;62;5;25;265;Delettes;1192;16;1208
32;Hauts-de-France;62;1;07;266;Denier;90;2;92
32;Hauts-de-France;62;5;25;267;Dennebrœucq;400;6;406
32;Hauts-de-France;62;3;22;268;Desvres;4861;37;4898
32;Hauts-de-France;62;2;05;269;Diéval;725;11;736
32;Hauts-de-France;62;2;05;270;Divion;6957;37;6994
32;Hauts-de-France;62;5;33;271;Dohem;834;18;852
32;Hauts-de-France;62;1;09;272;Douchy-lès-Ayette;314;2;316
32;Hauts-de-France;62;3;22;273;Doudeauville;630;9;639
32;Hauts-de-France;62;7;27;274;Dourges;5927;40;5967
32;Hauts-de-France;62;4;06;275;Douriez;300;7;307
32;Hauts-de-France;62;2;23;276;Douvrin;5733;48;5781
32;Hauts-de-France;62;7;28;277;Drocourt;2935;16;2951
32;Hauts-de-France;62;2;35;278;Drouvin-le-Marais;610;20;630
32;Hauts-de-France;62;1;07;279;Duisans;1374;66;1440
32;Hauts-de-France;62;1;15;280;Dury;318;2;320
32;Hauts-de-France;62;3;14;281;Echinghen;384;9;393
32;Hauts-de-France;62;4;06;282;Éclimeux;181;0;181
32;Hauts-de-France;62;1;38;283;Écoivres;131;0;131
32;Hauts-de-France;62;1;09;284;Écourt-Saint-Quentin;1686;19;1705
32;Hauts-de-France;62;1;09;285;Écoust-Saint-Mein;490;10;500
32;Hauts-de-France;62;2;31;286;Ecquedecques;506;4;510
32;Hauts-de-France;62;5;25;288;Ecques;2178;44;2222
32;Hauts-de-France;62;4;10;289;Écuires;694;21;715
32;Hauts-de-France;62;1;02;290;Écurie;380;7;387
32;Hauts-de-France;62;7;30;291;Éleu-dit-Leauwette;2844;31;2875
32;Hauts-de-France;62;5;33;292;Elnes;868;14;882
32;Hauts-de-France;62;4;25;293;Embry;231;5;236
32;Hauts-de-France;62;5;25;295;Enquin-lez-Guinegatte;1613;26;1639
32;Hauts-de-France;62;4;33;296;Enquin-sur-Baillons;268;9;277
32;Hauts-de-France;62;5;37;297;Éperlecques;3745;45;3790
32;Hauts-de-France;62;1;09;298;Épinoy;549;13;562
32;Hauts-de-France;62;1;38;299;Eps;246;6;252
32;Hauts-de-France;62;3;36;300;Équihen-Plage;2624;28;2652
32;Hauts-de-France;62;1;38;301;Équirre;81;1;82
32;Hauts-de-France;62;4;33;302;Ergny;236;2;238
32;Hauts-de-France;62;1;38;303;Érin;237;3;240
32;Hauts-de-France;62;5;25;304;Erny-Saint-Julien;335;2;337
32;Hauts-de-France;62;1;09;306;Ervillers;391;3;394
32;Hauts-de-France;62;6;18;307;Escalles;219;9;228
32;Hauts-de-France;62;5;33;308;Escœuilles;476;10;486
32;Hauts-de-France;62;5;33;309;Esquerdes;1631;21;1652
32;Hauts-de-France;62;2;12;310;Essars;1758;19;1777
32;Hauts-de-France;62;7;39;311;Estevelles;2031;8;2039
32;Hauts-de-France;62;4;10;312;Estrée;290;6;296
32;Hauts-de-France;62;2;01;313;Estrée-Blanche;915;6;921
32;Hauts-de-France;62;2;16;314;Estrée-Cauchy;357;2;359
32;Hauts-de-France;62;4;10;315;Estréelles;346;9;355
32;Hauts-de-France;62;1;07;316;Estrée-Wamin;208;6;214
32;Hauts-de-France;62;1;15;317;Étaing;455;3;458
32;Hauts-de-France;62;4;24;318;Étaples;10813;115;10928
32;Hauts-de-France;62;1;15;319;Éterpigny;258;3;261
32;Hauts-de-France;62;1;02;320;Étrun;316;5;321
32;Hauts-de-France;62;7;28;321;Évin-Malmaison;4662;26;4688
32;Hauts-de-France;62;1;07;322;Famechon;111;1;112
32;Hauts-de-France;62;1;03;323;Fampoux;1209;19;1228
32;Hauts-de-France;62;1;03;324;Farbus;604;11;615
32;Hauts-de-France;62;5;25;325;Fauquembergues;949;17;966
32;Hauts-de-France;62;1;09;326;Favreuil;245;5;250
32;Hauts-de-France;62;5;25;327;Febvin-Palfart;614;4;618
32;Hauts-de-France;62;2;31;328;Ferfay;895;7;902
32;Hauts-de-France;62;3;22;329;Ferques;1751;20;1771
32;Hauts-de-France;62;2;23;330;Festubert;1268;24;1292
32;Hauts-de-France;62;1;03;331;Feuchy;1027;20;1047
32;Hauts-de-France;62;1;07;332;Ficheux;501;10;511
32;Hauts-de-France;62;1;38;333;Fiefs;390;6;396
32;Hauts-de-France;62;6;19;334;Fiennes;856;16;872
32;Hauts-de-France;62;4;06;335;Fillièvres;514;5;519
32;Hauts-de-France;62;5;25;336;Fléchin;480;7;487
32;Hauts-de-France;62;1;38;337;Flers;222;5;227
32;Hauts-de-France;62;2;12;338;Fleurbaix;2779;51;2830
32;Hauts-de-France;62;1;38;339;Fleury;109;1;110
32;Hauts-de-France;62;1;38;340;Floringhem;883;7;890
32;Hauts-de-France;62;1;07;341;Foncquevillers;412;8;420
32;Hauts-de-France;62;1;38;342;Fontaine-lès-Boulans;106;1;107
32;Hauts-de-France;62;1;09;343;Fontaine-lès-Croisilles;262;2;264
32;Hauts-de-France;62;1;38;344;Fontaine-lès-Hermans;111;3;114
32;Hauts-de-France;62;1;06;345;Fontaine-l'Étalon;97;1;98
32;Hauts-de-France;62;1;38;346;Fortel-en-Artois;216;4;220
32;Hauts-de-France;62;1;07;347;Fosseux;128;3;131
32;Hauts-de-France;62;1;38;348;Foufflin-Ricametz;159;2;161
32;Hauts-de-France;62;2;35;349;Fouquereuil;1629;23;1652
32;Hauts-de-France;62;2;35;350;Fouquières-lès-Béthune;1124;20;1144
32;Hauts-de-France;62;7;26;351;Fouquières-lès-Lens;6333;35;6368
32;Hauts-de-France;62;1;38;352;Framecourt;109;3;112
32;Hauts-de-France;62;1;09;353;Frémicourt;237;3;240
32;Hauts-de-France;62;4;24;354;Frencq;896;18;914
32;Hauts-de-France;62;1;15;355;Fresnes-lès-Montauban;590;5;595
32;Hauts-de-France;62;2;16;356;Fresnicourt-le-Dolmen;801;8;809
32;Hauts-de-France;62;4;06;357;Fresnoy;71;1;72
32;Hauts-de-France;62;1;15;358;Fresnoy-en-Gohelle;235;6;241
32;Hauts-de-France;62;4;25;359;Fressin;583;12;595
32;Hauts-de-France;62;6;18;360;Fréthun;1390;14;1404
32;Hauts-de-France;62;1;38;361;Frévent;3348;47;3395
32;Hauts-de-France;62;1;07;362;Frévillers;240;3;243
32;Hauts-de-France;62;1;07;363;Frévin-Capelle;380;9;389
32;Hauts-de-France;62;4;25;364;Fruges;2338;242;2580
32;Hauts-de-France;62;4;06;365;Galametz;201;0;201
32;Hauts-de-France;62;2;16;366;Gauchin-Légal;308;7;315
32;Hauts-de-France;62;1;38;367;Gauchin-Verloingt;811;18;829
32;Hauts-de-France;62;1;07;368;Gaudiempré;210;0;210
32;Hauts-de-France;62;1;03;369;Gavrelle;817;17;834
32;Hauts-de-France;62;1;06;370;Gennes-Ivergny;124;1;125
32;Hauts-de-France;62;7;30;371;Givenchy-en-Gohelle;2003;45;2048
32;Hauts-de-France;62;1;07;372;Givenchy-le-Noble;150;3;153
32;Hauts-de-France;62;2;23;373;Givenchy-lès-la-Bassée;1023;11;1034
32;Hauts-de-France;62;1;09;374;Gomiécourt;153;1;154
32;Hauts-de-France;62;1;07;375;Gommecourt;89;1;90
32;Hauts-de-France;62;2;31;376;Gonnehem;2512;38;2550
32;Hauts-de-France;62;2;35;377;Gosnay;949;7;956
32;Hauts-de-France;62;1;07;378;Gouves;200;4;204
32;Hauts-de-France;62;1;07;379;Gouy-en-Artois;325;8;333
32;Hauts-de-France;62;7;17;380;Gouy-Servins;350;1;351
32;Hauts-de-France;62;1;38;381;Gouy-en-Ternois;132;1;133
32;Hauts-de-France;62;4;06;382;Gouy-Saint-André;652;13;665
32;Hauts-de-France;62;1;15;383;Gouy-sous-Bellonne;1392;18;1410
32;Hauts-de-France;62;1;09;384;Graincourt-lès-Havrincourt;649;8;657
32;Hauts-de-France;62;1;07;385;Grand-Rullecourt;381;4;385
32;Hauts-de-France;62;7;39;386;Grenay;6748;30;6778
32;Hauts-de-France;62;1;09;387;Grévillers;358;10;368
32;Hauts-de-France;62;4;06;388;Grigny;295;3;298
32;Hauts-de-France;62;1;07;389;Grincourt-lès-Pas;29;2;31
32;Hauts-de-France;62;4;10;390;Groffliers;1514;37;1551
32;Hauts-de-France;62;2;01;391;Guarbecque;1388;13;1401
32;Hauts-de-France;62;1;04;392;Guémappe;378;9;387
32;Hauts-de-France;62;6;34;393;Guemps;1112;22;1134
32;Hauts-de-France;62;4;06;395;Guigny;130;4;134
32;Hauts-de-France;62;1;38;396;Guinecourt;15;1;16
32;Hauts-de-France;62;6;19;397;Guînes;5581;73;5654
32;Hauts-de-France;62;4;06;398;Guisy;270;12;282
32;Hauts-de-France;62;1;07;399;Habarcq;658;14;672
32;Hauts-de-France;62;2;35;400;Haillicourt;4864;36;4900
32;Hauts-de-France;62;2;23;401;Haisnes;4416;30;4446
32;Hauts-de-France;62;3;22;402;Halinghen;310;6;316
32;Hauts-de-France;62;5;32;403;Hallines;1211;15;1226
32;Hauts-de-France;62;1;07;404;Halloy;202;2;204
32;Hauts-de-France;62;1;15;405;Hamblain-les-Prés;470;10;480
32;Hauts-de-France;62;1;09;406;Hamelincourt;267;8;275
32;Hauts-de-France;62;2;31;407;Ham-en-Artois;947;13;960
32;Hauts-de-France;62;6;18;408;Hames-Boucres;1457;18;1475
32;Hauts-de-France;62;1;07;409;Hannescamps;196;3;199
32;Hauts-de-France;62;1;09;410;Haplincourt;185;3;188
32;Hauts-de-France;62;1;06;411;Haravesnes;54;0;54
32;Hauts-de-France;62;6;19;412;Hardinghen;1217;6;1223
32;Hauts-de-France;62;7;26;413;Harnes;12277;92;12369
32;Hauts-de-France;62;1;15;414;Haucourt;213;2;215
32;Hauts-de-France;62;1;07;415;Haute-Avesnes;437;9;446
32;Hauts-de-France;62;1;38;416;Hautecloque;216;2;218
32;Hauts-de-France;62;1;07;418;Hauteville;308;8;316
32;Hauts-de-France;62;5;33;419;Haut-Loquin;176;1;177
32;Hauts-de-France;62;1;09;421;Havrincourt;389;5;394
32;Hauts-de-France;62;1;07;422;Hébuterne;521;5;526
32;Hauts-de-France;62;5;32;423;Helfaut;1737;29;1766
32;Hauts-de-France;62;1;15;424;Hendecourt-lès-Cagnicourt;316;11;327
32;Hauts-de-France;62;1;07;425;Hendecourt-lès-Ransart;139;4;143
32;Hauts-de-France;62;1;04;426;Héninel;186;2;188
32;Hauts-de-France;62;7;99;427;Hénin-Beaumont;25886;372;26258
32;Hauts-de-France;62;1;04;428;Hénin-sur-Cojeul;527;7;534
32;Hauts-de-France;62;3;22;429;Henneveux;280;4;284
32;Hauts-de-France;62;1;07;430;Hénu;161;1;162
32;Hauts-de-France;62;6;19;432;Herbinghen;405;8;413
32;Hauts-de-France;62;1;38;433;Héricourt;83;6;89
32;Hauts-de-France;62;1;07;434;La Herlière;139;2;141
32;Hauts-de-France;62;1;38;435;Herlincourt;107;0;107
32;Hauts-de-France;62;1;38;436;Herlin-le-Sec;161;3;164
32;Hauts-de-France;62;4;33;437;Herly;308;7;315
32;Hauts-de-France;62;1;07;438;Hermaville;536;8;544
32;Hauts-de-France;62;6;19;439;Hermelinghen;418;7;425
32;Hauts-de-France;62;1;09;440;Hermies;1159;25;1184
32;Hauts-de-France;62;2;16;441;Hermin;209;2;211
32;Hauts-de-France;62;1;38;442;Hernicourt;548;11;559
32;Hauts-de-France;62;2;35;443;Hersin-Coupigny;6196;43;6239
32;Hauts-de-France;62;3;22;444;Hervelinghen;225;6;231
32;Hauts-de-France;62;2;35;445;Hesdigneul-lès-Béthune;827;17;844
32;Hauts-de-France;62;3;36;446;Hesdigneul-lès-Boulogne;805;23;828
32;Hauts-de-France;62;4;06;447;Hesdin;2218;11;2229
32;Hauts-de-France;62;3;36;448;Hesdin-l'Abbé;1891;29;1920
32;Hauts-de-France;62;4;06;449;Hesmond;159;6;165
32;Hauts-de-France;62;1;38;450;Hestrus;225;6;231
32;Hauts-de-France;62;1;38;451;Heuchin;492;10;502
32;Hauts-de-France;62;5;25;452;Heuringhem;1371;36;1407
32;Hauts-de-France;62;4;25;453;Hézecques;128;3;131
32;Hauts-de-France;62;2;12;454;Hinges;2413;50;2463
32;Hauts-de-France;62;6;19;455;Hocquinghen;111;1;112
32;Hauts-de-France;62;2;35;456;Houchin;718;7;725
32;Hauts-de-France;62;2;16;457;Houdain;7066;59;7125
32;Hauts-de-France;62;5;37;458;Houlle;1163;12;1175
32;Hauts-de-France;62;1;07;459;Houvin-Houvigneul;238;3;241
32;Hauts-de-France;62;4;10;460;Hubersent;270;5;275
32;Hauts-de-France;62;4;06;461;Huby-Saint-Leu;869;7;876
32;Hauts-de-France;62;1;38;462;Huclier;154;5;159
32;Hauts-de-France;62;4;33;463;Hucqueliers;454;50;504
32;Hauts-de-France;62;7;39;464;Hulluch;3380;19;3399
32;Hauts-de-France;62;1;07;465;Humbercamps;218;0;218
32;Hauts-de-France;62;4;33;466;Humbert;238;1;239
32;Hauts-de-France;62;1;38;467;Humerœuille;180;1;181
32;Hauts-de-France;62;1;38;468;Humières;214;1;215
32;Hauts-de-France;62;1;09;469;Inchy-en-Artois;578;7;585
32;Hauts-de-France;62;4;06;470;Incourt;86;0;86
32;Hauts-de-France;62;5;25;471;Bellinghem;1084;21;1105
32;Hauts-de-France;62;4;10;472;Inxent;160;6;166
32;Hauts-de-France;62;2;01;473;Isbergues;8683;77;8760
32;Hauts-de-France;62;3;36;474;Isques;1154;21;1175
32;Hauts-de-France;62;1;07;475;Ivergny;243;3;246
32;Hauts-de-France;62;1;15;476;Izel-lès-Équerchin;1056;11;1067
32;Hauts-de-France;62;1;07;477;Izel-lès-Hameau;730;17;747
32;Hauts-de-France;62;5;33;478;Journy;288;3;291
32;Hauts-de-France;62;2;11;479;Labeuvrière;1662;14;1676
32;Hauts-de-France;62;2;35;480;Labourse;2912;23;2935
32;Hauts-de-France;62;4;06;481;Labroye;150;3;153
32;Hauts-de-France;62;3;22;483;Lacres;248;2;250
32;Hauts-de-France;62;1;09;484;Lagnicourt-Marcel;319;6;325
32;Hauts-de-France;62;5;25;485;Laires;369;3;372
32;Hauts-de-France;62;2;01;486;Lambres;1058;13;1071
32;Hauts-de-France;62;3;22;487;Landrethun-le-Nord;1252;22;1274
32;Hauts-de-France;62;6;19;488;Landrethun-lès-Ardres;775;20;795
32;Hauts-de-France;62;2;11;489;Lapugnoy;3525;29;3554
32;Hauts-de-France;62;1;07;490;Lattre-Saint-Quentin;279;3;282
32;Hauts-de-France;62;2;12;491;Laventie;4969;83;5052
32;Hauts-de-France;62;4;25;492;Lebiez;240;3;243
32;Hauts-de-France;62;1;09;493;Lebucquière;233;4;237
32;Hauts-de-France;62;1;09;494;Léchelle;46;0;46
32;Hauts-de-France;62;5;33;495;Ledinghem;327;6;333
32;Hauts-de-France;62;4;24;496;Lefaux;230;6;236
32;Hauts-de-France;62;7;28;497;Leforest;7236;49;7285
32;Hauts-de-France;62;7;29;498;Lens;32458;193;32651
32;Hauts-de-France;62;4;10;499;Lépine;289;8;297
32;Hauts-de-France;62;2;31;500;Lespesses;404;3;407
32;Hauts-de-France;62;4;06;501;Lespinoy;227;4;231
32;Hauts-de-France;62;2;31;502;Lestrem;5104;84;5188
32;Hauts-de-France;62;3;22;503;Leubringhen;297;6;303
32;Hauts-de-France;62;5;33;504;Leulinghem;258;5;263
32;Hauts-de-France;62;3;22;505;Leulinghen-Bernes;512;9;521
32;Hauts-de-France;62;6;19;506;Licques;1639;20;1659
32;Hauts-de-France;62;1;07;507;Liencourt;297;7;304
32;Hauts-de-France;62;2;31;508;Lières;367;7;374
32;Hauts-de-France;62;2;01;509;Liettres;343;9;352
32;Hauts-de-France;62;7;30;510;Liévin;30102;330;30432
32;Hauts-de-France;62;1;07;511;Lignereuil;141;1;142
32;Hauts-de-France;62;2;01;512;Ligny-lès-Aire;568;15;583
32;Hauts-de-France;62;1;38;513;Ligny-sur-Canche;187;6;193
32;Hauts-de-France;62;1;38;514;Ligny-Saint-Flochel;244;3;247
32;Hauts-de-France;62;1;09;515;Ligny-Thilloy;521;17;538
32;Hauts-de-France;62;2;31;516;Lillers;9866;91;9957
32;Hauts-de-France;62;2;01;517;Linghem;192;6;198
32;Hauts-de-France;62;1;38;518;Linzeux;171;1;172
32;Hauts-de-France;62;1;38;519;Lisbourg;609;8;617
32;Hauts-de-France;62;2;12;520;Locon;2361;56;2417
32;Hauts-de-France;62;4;06;521;La Loge;205;5;210
32;Hauts-de-France;62;4;06;522;Loison-sur-Créquoise;278;3;281
32;Hauts-de-France;62;7;29;523;Loison-sous-Lens;5308;35;5343
32;Hauts-de-France;62;3;22;524;Longfossé;1504;17;1521
32;Hauts-de-France;62;5;32;525;Longuenesse;10600;478;11078
32;Hauts-de-France;62;3;22;526;Longueville;147;2;149
32;Hauts-de-France;62;4;24;527;Longvilliers;256;5;261
32;Hauts-de-France;62;7;39;528;Loos-en-Gohelle;6904;62;6966
32;Hauts-de-France;62;2;23;529;Lorgies;1589;19;1608
32;Hauts-de-France;62;3;22;530;Lottinghen;533;9;542
32;Hauts-de-France;62;6;19;531;Louches;945;19;964
32;Hauts-de-France;62;2;05;532;Lozinghem;1300;13;1313
32;Hauts-de-France;62;4;25;533;Lugy;145;2;147
32;Hauts-de-France;62;5;33;534;Lumbres;3582;69;3651
32;Hauts-de-France;62;4;10;535;La Madelaine-sous-Montreuil;151;8;159
32;Hauts-de-France;62;1;07;536;Magnicourt-en-Comte;640;5;645
32;Hauts-de-France;62;1;07;537;Magnicourt-sur-Canche;103;3;106
32;Hauts-de-France;62;4;06;538;Maintenay;456;9;465
32;Hauts-de-France;62;1;38;539;Maisnil;238;3;241
32;Hauts-de-France;62;2;16;540;Maisnil-lès-Ruitz;1698;15;1713
32;Hauts-de-France;62;4;06;541;Maisoncelle;121;4;125
32;Hauts-de-France;62;1;07;542;Maizières;203;4;207
32;Hauts-de-France;62;5;25;543;Mametz;2006;32;2038
32;Hauts-de-France;62;1;07;544;Manin;181;1;182
32;Hauts-de-France;62;4;33;545;Maninghem;145;0;145
32;Hauts-de-France;62;3;22;546;Maninghen-Henne;307;9;316
32;Hauts-de-France;62;4;06;547;Marant;60;1;61
32;Hauts-de-France;62;6;34;548;Marck;10523;142;10665
32;Hauts-de-France;62;4;06;549;Marconne;1070;64;1134
32;Hauts-de-France;62;4;06;550;Marconnelle;1090;20;1110
32;Hauts-de-France;62;4;06;551;Marenla;240;2;242
32;Hauts-de-France;62;4;06;552;Maresquel-Ecquemicourt;1038;8;1046
32;Hauts-de-France;62;1;38;553;Marest;282;6;288
32;Hauts-de-France;62;4;24;554;Maresville;101;4;105
32;Hauts-de-France;62;2;05;555;Marles-les-Mines;5524;25;5549
32;Hauts-de-France;62;4;06;556;Marles-sur-Canche;313;5;318
32;Hauts-de-France;62;1;02;557;Marœuil;2454;56;2510
32;Hauts-de-France;62;1;38;558;Marquay;179;0;179
32;Hauts-de-France;62;1;09;559;Marquion;976;13;989
32;Hauts-de-France;62;3;22;560;Marquise;5072;61;5133
32;Hauts-de-France;62;1;09;561;Martinpuich;192;1;193
32;Hauts-de-France;62;4;25;562;Matringhem;175;3;178
32;Hauts-de-France;62;7;17;563;Mazingarbe;8029;39;8068
32;Hauts-de-France;62;2;01;564;Mazinghem;466;9;475
32;Hauts-de-France;62;4;25;565;Mencas;76;0;76
32;Hauts-de-France;62;3;22;566;Menneville;664;16;680
32;Hauts-de-France;62;5;37;567;Mentque-Nortbécourt;647;7;654
32;Hauts-de-France;62;1;04;568;Mercatel;726;9;735
32;Hauts-de-France;62;5;25;569;Merck-Saint-Liévin;668;6;674
32;Hauts-de-France;62;7;08;570;Méricourt;11374;58;11432
32;Hauts-de-France;62;4;24;571;Merlimont;3389;70;3459
32;Hauts-de-France;62;1;09;572;Metz-en-Couture;615;10;625
32;Hauts-de-France;62;7;39;573;Meurchin;3728;24;3752
32;Hauts-de-France;62;1;07;574;Mingoval;233;5;238
32;Hauts-de-France;62;1;38;576;Moncheaux-lès-Frévent;146;0;146
32;Hauts-de-France;62;1;38;577;Monchel-sur-Canche;77;2;79
32;Hauts-de-France;62;1;07;578;Monchiet;98;4;102
32;Hauts-de-France;62;1;07;579;Monchy-au-Bois;545;3;548
32;Hauts-de-France;62;1;38;580;Monchy-Breton;526;8;534
32;Hauts-de-France;62;1;38;581;Monchy-Cayeux;297;2;299
32;Hauts-de-France;62;1;03;582;Monchy-le-Preux;657;37;694
32;Hauts-de-France;62;1;07;583;Mondicourt;561;9;570
32;Hauts-de-France;62;2;31;584;Mont-Bernanchon;1326;32;1358
32;Hauts-de-France;62;4;10;585;Montcavrel;396;5;401
32;Hauts-de-France;62;1;07;586;Montenescourt;446;5;451
32;Hauts-de-France;62;7;27;587;Montigny-en-Gohelle;10086;42;10128
32;Hauts-de-France;62;4;10;588;Montreuil;1913;123;2036
32;Hauts-de-France;62;1;02;589;Mont-Saint-Éloi;1016;21;1037
32;Hauts-de-France;62;1;38;590;Monts-en-Ternois;63;0;63
32;Hauts-de-France;62;1;09;591;Morchies;209;5;214
32;Hauts-de-France;62;5;37;592;Moringhem;556;12;568
32;Hauts-de-France;62;1;09;593;Morval;89;0;89
32;Hauts-de-France;62;1;09;594;Mory;308;3;311
32;Hauts-de-France;62;5;37;595;Moulle;1136;30;1166
32;Hauts-de-France;62;4;06;596;Mouriez;241;5;246
32;Hauts-de-France;62;1;09;597;Moyenneville;286;3;289
32;Hauts-de-France;62;6;34;598;Muncq-Nieurlet;712;12;724
32;Hauts-de-France;62;3;22;599;Nabringhen;224;7;231
32;Hauts-de-France;62;1;38;600;Nédon;152;3;155
32;Hauts-de-France;62;1;38;601;Nédonchel;350;5;355
32;Hauts-de-France;62;4;10;602;Nempont-Saint-Firmin;202;3;205
32;Hauts-de-France;62;3;36;603;Nesles;1067;7;1074
32;Hauts-de-France;62;3;36;604;Neufchâtel-Hardelot;3748;70;3818
32;Hauts-de-France;62;4;06;605;Neulette;25;0;25
32;Hauts-de-France;62;2;12;606;Neuve-Chapelle;1435;23;1458
32;Hauts-de-France;62;1;38;607;Neuville-au-Cornet;64;3;67
32;Hauts-de-France;62;1;09;608;Neuville-Bourjonval;168;1;169
32;Hauts-de-France;62;1;02;609;Neuville-Saint-Vaast;1594;37;1631
32;Hauts-de-France;62;4;10;610;Neuville-sous-Montreuil;650;9;659
32;Hauts-de-France;62;1;04;611;Neuville-Vitasse;496;13;509
32;Hauts-de-France;62;1;15;612;Neuvireuil;585;12;597
32;Hauts-de-France;62;5;33;613;Nielles-lès-Bléquin;898;8;906
32;Hauts-de-France;62;6;19;614;Nielles-lès-Ardres;592;14;606
32;Hauts-de-France;62;6;18;615;Nielles-lès-Calais;286;6;292
32;Hauts-de-France;62;1;06;616;Nœux-lès-Auxi;184;2;186
32;Hauts-de-France;62;2;35;617;Nœux-les-Mines;11638;52;11690
32;Hauts-de-France;62;5;37;618;Nordausques;1336;15;1351
32;Hauts-de-France;62;1;09;619;Noreuil;141;2;143
32;Hauts-de-France;62;2;31;620;Norrent-Fontes;1377;22;1399
32;Hauts-de-France;62;6;34;621;Nortkerque;1743;31;1774
32;Hauts-de-France;62;5;37;622;Nort-Leulinghem;266;3;269
32;Hauts-de-France;62;6;34;623;Nouvelle-Église;710;10;720
32;Hauts-de-France;62;7;28;624;Noyelles-Godault;5864;28;5892
32;Hauts-de-France;62;4;06;625;Noyelles-lès-Humières;56;2;58
32;Hauts-de-France;62;2;23;626;Noyelles-lès-Vermelles;2297;21;2318
32;Hauts-de-France;62;1;15;627;Noyelles-sous-Bellonne;829;14;843
32;Hauts-de-France;62;7;26;628;Noyelles-sous-Lens;6590;44;6634
32;Hauts-de-France;62;1;07;629;Noyellette;161;1;162
32;Hauts-de-France;62;1;07;630;Noyelle-Vion;297;5;302
32;Hauts-de-France;62;1;38;631;Nuncq-Hautecôte;488;7;495
32;Hauts-de-France;62;2;11;632;Oblinghem;381;6;387
32;Hauts-de-France;62;1;38;633;Œuf-en-Ternois;256;2;258
32;Hauts-de-France;62;6;34;634;Offekerque;1214;10;1224
32;Hauts-de-France;62;4;06;635;Offin;199;2;201
32;Hauts-de-France;62;3;22;636;Offrethun;269;2;271
32;Hauts-de-France;62;7;27;637;Oignies;10130;43;10173
32;Hauts-de-France;62;1;09;638;Oisy-le-Verger;1175;14;1189
32;Hauts-de-France;62;1;15;639;Oppy;383;9;392
32;Hauts-de-France;62;1;07;640;Orville;370;1;371
32;Hauts-de-France;62;1;38;641;Ostreville;213;3;216
32;Hauts-de-France;62;2;05;642;Ourton;750;5;755
32;Hauts-de-France;62;3;36;643;Outreau;13178;162;13340
32;Hauts-de-France;62;5;33;644;Ouve-Wirquin;503;7;510
32;Hauts-de-France;62;6;34;645;Oye-Plage;5630;83;5713
32;Hauts-de-France;62;1;09;646;Palluel;573;7;580
32;Hauts-de-France;62;4;06;647;Le Parcq;738;15;753
32;Hauts-de-France;62;4;33;648;Parenty;522;9;531
32;Hauts-de-France;62;1;07;649;Pas-en-Artois;754;10;764
32;Hauts-de-France;62;1;15;650;Pelves;765;8;773
32;Hauts-de-France;62;1;07;651;Penin;488;7;495
32;Hauts-de-France;62;1;38;652;Pernes;1606;29;1635
32;Hauts-de-France;62;3;13;653;Pernes-lès-Boulogne;414;19;433
32;Hauts-de-France;62;6;18;654;Peuplingues;784;13;797
32;Hauts-de-France;62;1;38;655;Pierremont;316;8;324
32;Hauts-de-France;62;5;33;656;Pihem;947;27;974
32;Hauts-de-France;62;6;18;657;Pihen-lès-Guînes;503;7;510
32;Hauts-de-France;62;3;13;658;Pittefaux;117;9;126
32;Hauts-de-France;62;4;25;659;Planques;102;3;105
32;Hauts-de-France;62;1;15;660;Plouvain;457;7;464
32;Hauts-de-France;62;4;06;661;Bouin-Plumoison;507;0;507
32;Hauts-de-France;62;6;34;662;Polincove;870;21;891
32;Hauts-de-France;62;1;07;663;Pommera;310;4;314
32;Hauts-de-France;62;1;07;664;Pommier;234;6;240
32;Hauts-de-France;62;1;06;665;Le Ponchel;213;6;219
32;Hauts-de-France;62;7;39;666;Pont-à-Vendin;3116;18;3134
32;Hauts-de-France;62;3;14;667;Le Portel;8985;113;9098
32;Hauts-de-France;62;1;38;668;Prédefin;189;1;190
32;Hauts-de-France;62;1;38;669;Pressy;309;5;314
32;Hauts-de-France;62;4;33;670;Preures;623;7;630
32;Hauts-de-France;62;1;09;671;Pronville-en-Artois;316;5;321
32;Hauts-de-France;62;1;07;672;Puisieux;647;5;652
32;Hauts-de-France;62;1;09;673;Quéant;643;8;651
32;Hauts-de-France;62;5;33;674;Quelmes;544;18;562
32;Hauts-de-France;62;5;33;675;Quercamps;275;2;277
32;Hauts-de-France;62;2;01;676;Quernes;448;7;455
32;Hauts-de-France;62;4;06;677;Le Quesnoy-en-Artois;340;5;345
32;Hauts-de-France;62;3;22;678;Quesques;701;9;710
32;Hauts-de-France;62;3;22;679;Questrecques;324;8;332
32;Hauts-de-France;62;1;15;680;Quiéry-la-Motte;729;13;742
32;Hauts-de-France;62;5;25;681;Quiestède;625;22;647
32;Hauts-de-France;62;4;33;682;Quilen;66;0;66
32;Hauts-de-France;62;1;06;683;Quœux-Haut-Maînil;226;2;228
32;Hauts-de-France;62;5;25;684;Racquinghem;2218;30;2248
32;Hauts-de-France;62;4;25;685;Radinghem;270;163;433
32;Hauts-de-France;62;1;38;686;Ramecourt;348;6;354
32;Hauts-de-France;62;4;10;688;Rang-du-Fliers;4329;119;4448
32;Hauts-de-France;62;1;07;689;Ransart;395;2;397
32;Hauts-de-France;62;4;06;690;Raye-sur-Authie;233;6;239
32;Hauts-de-France;62;5;25;691;Saint-Augustin;824;12;836
32;Hauts-de-France;62;5;33;692;Rebergues;374;4;378
32;Hauts-de-France;62;2;16;693;Rebreuve-Ranchicourt;1071;22;1093
32;Hauts-de-France;62;1;07;694;Rebreuve-sur-Canche;188;2;190
32;Hauts-de-France;62;1;07;695;Rebreuviette;261;2;263
32;Hauts-de-France;62;5;25;696;Reclinghem;233;3;236
32;Hauts-de-France;62;1;15;697;Récourt;248;0;248
32;Hauts-de-France;62;4;10;698;Recques-sur-Course;272;5;277
32;Hauts-de-France;62;6;34;699;Recques-sur-Hem;655;13;668
32;Hauts-de-France;62;4;06;700;Regnauville;213;1;214
32;Hauts-de-France;62;2;01;701;Rely;453;2;455
32;Hauts-de-France;62;5;33;702;Remilly-Wirquin;358;4;362
32;Hauts-de-France;62;1;15;703;Rémy;378;3;381
32;Hauts-de-France;62;5;25;704;Renty;588;18;606
32;Hauts-de-France;62;3;22;705;Rety;2087;16;2103
32;Hauts-de-France;62;2;12;706;Richebourg;2628;58;2686
32;Hauts-de-France;62;1;09;708;Riencourt-lès-Bapaume;31;1;32
32;Hauts-de-France;62;1;15;709;Riencourt-lès-Cagnicourt;249;5;254
32;Hauts-de-France;62;4;25;710;Rimboval;182;4;186
32;Hauts-de-France;62;3;22;711;Rinxent;3048;31;3079
32;Hauts-de-France;62;1;07;712;Rivière;1125;29;1154
32;Hauts-de-France;62;2;31;713;Robecq;1335;23;1358
32;Hauts-de-France;62;1;02;714;Roclincourt;783;18;801
32;Hauts-de-France;62;1;09;715;Rocquigny;289;0;289
32;Hauts-de-France;62;6;19;716;Rodelinghem;550;6;556
32;Hauts-de-France;62;1;38;717;Roëllecourt;528;9;537
32;Hauts-de-France;62;1;15;718;Rœux;1404;22;1426
32;Hauts-de-France;62;4;06;719;Rollancourt;280;35;315
32;Hauts-de-France;62;2;01;720;Rombly;43;2;45
32;Hauts-de-France;62;5;01;721;Roquetoire;1947;47;1994
32;Hauts-de-France;62;1;06;722;Rougefay;89;3;92
32;Hauts-de-France;62;4;06;723;Roussent;238;1;239
32;Hauts-de-France;62;7;26;724;Rouvroy;8925;35;8960
32;Hauts-de-France;62;4;25;725;Royon;140;0;140
32;Hauts-de-France;62;4;25;726;Ruisseauville;204;5;209
32;Hauts-de-France;62;2;35;727;Ruitz;1521;23;1544
32;Hauts-de-France;62;1;09;728;Rumaucourt;693;11;704
32;Hauts-de-France;62;4;33;729;Rumilly;246;8;254
32;Hauts-de-France;62;6;34;730;Ruminghem;1612;23;1635
32;Hauts-de-France;62;1;09;731;Ruyaulcourt;281;3;284
32;Hauts-de-France;62;1;38;732;Sachin;323;2;325
32;Hauts-de-France;62;1;07;733;Sailly-au-Bois;301;3;304
32;Hauts-de-France;62;1;15;734;Sailly-en-Ostrevent;672;8;680
32;Hauts-de-France;62;2;23;735;Sailly-Labourse;2520;19;2539
32;Hauts-de-France;62;2;12;736;Sailly-sur-la-Lys;3900;72;3972
32;Hauts-de-France;62;7;17;737;Sains-en-Gohelle;6035;34;6069
32;Hauts-de-France;62;4;25;738;Sains-lès-Fressin;155;1;156
32;Hauts-de-France;62;1;09;739;Sains-lès-Marquion;327;3;330
32;Hauts-de-France;62;1;38;740;Sains-lès-Pernes;306;9;315
32;Hauts-de-France;62;1;07;741;Saint-Amand;117;3;120
32;Hauts-de-France;62;4;24;742;Saint-Aubin;270;6;276
32;Hauts-de-France;62;4;06;743;Sainte-Austreberthe;380;9;389
32;Hauts-de-France;62;1;02;744;Sainte-Catherine;3653;60;3713
32;Hauts-de-France;62;4;06;745;Saint-Denœux;159;6;165
32;Hauts-de-France;62;3;36;746;Saint-Étienne-au-Mont;5094;65;5159
32;Hauts-de-France;62;2;31;747;Saint-Floris;625;16;641
32;Hauts-de-France;62;6;34;748;Saint-Folquin;2318;40;2358
32;Hauts-de-France;62;4;06;749;Saint-Georges;338;6;344
32;Hauts-de-France;62;2;01;750;Saint-Hilaire-Cottes;817;9;826
32;Hauts-de-France;62;3;22;751;Saint-Inglevert;801;9;810
32;Hauts-de-France;62;4;24;752;Saint-Josse;1105;41;1146
32;Hauts-de-France;62;1;03;753;Saint-Laurent-Blangy;6522;56;6578
32;Hauts-de-France;62;1;09;754;Saint-Léger;495;3;498
32;Hauts-de-France;62;3;36;755;Saint-Léonard;3377;50;3427
32;Hauts-de-France;62;6;34;756;Sainte-Marie-Kerque;1671;17;1688
32;Hauts-de-France;62;5;37;757;Saint-Martin-lez-Tatinghem;5970;134;6104
32;Hauts-de-France;62;3;14;758;Saint-Martin-Boulogne;11165;173;11338
32;Hauts-de-France;62;3;22;759;Saint-Martin-Choquel;463;10;473
32;Hauts-de-France;62;5;25;760;Saint-Martin-d'Hardinghem;275;6;281
32;Hauts-de-France;62;1;04;761;Saint-Martin-sur-Cojeul;211;4;215
32;Hauts-de-France;62;4;33;762;Saint-Michel-sous-Bois;122;5;127
32;Hauts-de-France;62;1;38;763;Saint-Michel-sur-Ternoise;854;15;869
32;Hauts-de-France;62;1;03;764;Saint-Nicolas;4659;51;4710
32;Hauts-de-France;62;5;37;765;Saint-Omer;14782;646;15428
32;Hauts-de-France;62;6;34;766;Saint-Omer-Capelle;1109;12;1121
32;Hauts-de-France;62;1;38;767;Saint-Pol-sur-Ternoise;4870;153;5023
32;Hauts-de-France;62;4;06;768;Saint-Rémy-au-Bois;105;2;107
32;Hauts-de-France;62;6;18;769;Saint-Tricat;765;14;779
32;Hauts-de-France;62;2;31;770;Saint-Venant;3041;95;3136
32;Hauts-de-France;62;7;08;771;Sallaumines;9575;43;9618
32;Hauts-de-France;62;5;37;772;Salperwick;492;10;502
32;Hauts-de-France;62;3;22;773;Samer;4656;138;4794
32;Hauts-de-France;62;6;18;774;Sangatte;4840;129;4969
32;Hauts-de-France;62;6;19;775;Sanghen;351;2;353
32;Hauts-de-France;62;1;09;776;Sapignies;193;4;197
32;Hauts-de-France;62;1;09;777;Le Sars;160;1;161
32;Hauts-de-France;62;1;07;778;Sars-le-Bois;77;1;78
32;Hauts-de-France;62;1;07;779;Sarton;189;1;190
32;Hauts-de-France;62;1;09;780;Sauchy-Cauchy;364;3;367
32;Hauts-de-France;62;1;09;781;Sauchy-Lestrée;466;3;469
32;Hauts-de-France;62;1;15;782;Saudemont;433;6;439
32;Hauts-de-France;62;4;06;783;Saulchoy;317;4;321
32;Hauts-de-France;62;1;07;784;Saulty;771;12;783
32;Hauts-de-France;62;1;07;785;Savy-Berlette;891;185;1076
32;Hauts-de-France;62;3;22;786;Selles;320;4;324
32;Hauts-de-France;62;4;06;787;Sempy;319;3;322
32;Hauts-de-France;62;5;33;788;Seninghem;694;17;711
32;Hauts-de-France;62;3;22;789;Senlecques;268;5;273
32;Hauts-de-France;62;4;25;790;Senlis;162;7;169
32;Hauts-de-France;62;1;38;791;Séricourt;49;0;49
32;Hauts-de-France;62;5;37;792;Serques;1151;32;1183
32;Hauts-de-France;62;7;17;793;Servins;1133;18;1151
32;Hauts-de-France;62;5;33;794;Setques;589;11;600
32;Hauts-de-France;62;1;38;795;Sibiville;110;2;112
32;Hauts-de-France;62;1;07;796;Simencourt;557;12;569
32;Hauts-de-France;62;1;38;797;Siracourt;278;3;281
32;Hauts-de-France;62;1;07;798;Sombrin;228;5;233
32;Hauts-de-France;62;4;10;799;Sorrus;914;28;942
32;Hauts-de-France;62;1;07;800;Souastre;378;3;381
32;Hauts-de-France;62;7;17;801;Souchez;2643;50;2693
32;Hauts-de-France;62;1;07;802;Le Souich;185;2;187
32;Hauts-de-France;62;5;33;803;Surques;640;5;645
32;Hauts-de-France;62;1;07;804;Sus-Saint-Léger;365;5;370
32;Hauts-de-France;62;1;38;805;Tangry;267;4;271
32;Hauts-de-France;62;3;22;806;Tardinghen;150;5;155
32;Hauts-de-France;62;1;38;808;Teneur;258;2;260
32;Hauts-de-France;62;1;38;809;Ternas;139;3;142
32;Hauts-de-France;62;1;03;810;Thélus;1239;23;1262
32;Hauts-de-France;62;5;25;811;Thérouanne;1101;26;1127
32;Hauts-de-France;62;5;25;812;Thiembronne;835;7;842
32;Hauts-de-France;62;1;38;813;La Thieuloye;494;2;496
32;Hauts-de-France;62;1;07;814;Thièvres;97;1;98
32;Hauts-de-France;62;4;10;815;Tigny-Noyelle;174;0;174
32;Hauts-de-France;62;1;07;816;Tilloy-lès-Hermaville;218;5;223
32;Hauts-de-France;62;1;04;817;Tilloy-lès-Mofflaines;1475;110;1585
32;Hauts-de-France;62;1;38;818;Tilly-Capelle;155;1;156
32;Hauts-de-France;62;5;37;819;Tilques;1077;30;1107
32;Hauts-de-France;62;1;07;820;Tincques;811;18;829
32;Hauts-de-France;62;3;22;821;Tingry;294;7;301
32;Hauts-de-France;62;1;06;822;Tollent;92;3;95
32;Hauts-de-France;62;4;25;823;Torcy;172;5;177
32;Hauts-de-France;62;4;06;824;Tortefontaine;219;5;224
32;Hauts-de-France;62;1;15;825;Tortequesne;839;8;847
32;Hauts-de-France;62;4;24;826;Le Touquet-Paris-Plage;4226;301;4527
32;Hauts-de-France;62;5;37;827;Tournehem-sur-la-Hem;1391;17;1408
32;Hauts-de-France;62;4;06;828;Tramecourt;57;0;57
32;Hauts-de-France;62;1;09;829;Le Transloy;430;4;434
32;Hauts-de-France;62;1;09;830;Trescault;175;2;177
32;Hauts-de-France;62;1;38;831;Troisvaux;296;10;306
32;Hauts-de-France;62;4;24;832;Tubersent;575;19;594
32;Hauts-de-France;62;1;38;833;Vacquerie-le-Boucq;75;2;77
32;Hauts-de-France;62;4;06;834;Vacqueriette-Erquières;252;4;256
32;Hauts-de-France;62;1;38;835;Valhuon;551;17;568
32;Hauts-de-France;62;2;35;836;Vaudricourt;1079;19;1098
32;Hauts-de-France;62;5;33;837;Vaudringhem;501;8;509
32;Hauts-de-France;62;1;06;838;Vaulx;90;3;93
32;Hauts-de-France;62;1;09;839;Vaulx-Vraucourt;1047;8;1055
32;Hauts-de-France;62;1;09;840;Vélu;132;0;132
32;Hauts-de-France;62;2;11;841;Vendin-lès-Béthune;2413;24;2437
32;Hauts-de-France;62;7;39;842;Vendin-le-Vieil;8419;46;8465
32;Hauts-de-France;62;4;25;843;Verchin;233;2;235
32;Hauts-de-France;62;4;33;844;Verchocq;631;14;645
32;Hauts-de-France;62;3;22;845;Verlincthun;502;4;506
32;Hauts-de-France;62;2;23;846;Vermelles;4767;42;4809
32;Hauts-de-France;62;2;12;847;Verquigneul;2021;24;2045
32;Hauts-de-France;62;2;12;848;Verquin;3477;37;3514
32;Hauts-de-France;62;4;10;849;Verton;2510;55;2565
32;Hauts-de-France;62;4;06;850;Vieil-Hesdin;344;6;350
32;Hauts-de-France;62;2;12;851;Vieille-Chapelle;833;17;850
32;Hauts-de-France;62;6;34;852;Vieille-Église;1440;11;1451
32;Hauts-de-France;62;3;22;853;Vieil-Moutier;376;10;386
32;Hauts-de-France;62;7;17;854;Villers-au-Bois;614;9;623
32;Hauts-de-France;62;1;09;855;Villers-au-Flos;246;1;247
32;Hauts-de-France;62;1;07;856;Villers-Brûlin;368;3;371
32;Hauts-de-France;62;1;07;857;Villers-Châtel;130;9;139
32;Hauts-de-France;62;1;15;858;Villers-lès-Cagnicourt;256;5;261
32;Hauts-de-France;62;1;06;859;Villers-l'Hôpital;260;4;264
32;Hauts-de-France;62;1;07;860;Villers-Sir-Simon;126;3;129
32;Hauts-de-France;62;7;30;861;Vimy;4332;58;4390
32;Hauts-de-France;62;4;25;862;Vincly;154;3;157
32;Hauts-de-France;62;2;23;863;Violaines;3814;29;3843
32;Hauts-de-France;62;1;15;864;Vis-en-Artois;644;15;659
32;Hauts-de-France;62;1;15;865;Vitry-en-Artois;4732;49;4781
32;Hauts-de-France;62;4;10;866;Waben;435;15;450
32;Hauts-de-France;62;3;22;867;Wacquinghen;264;7;271
32;Hauts-de-France;62;4;06;868;Wail;257;6;263
32;Hauts-de-France;62;1;02;869;Wailly;1076;33;1109
32;Hauts-de-France;62;4;10;870;Wailly-Beaucamp;1041;26;1067
32;Hauts-de-France;62;4;06;871;Wambercourt;261;1;262
32;Hauts-de-France;62;4;06;872;Wamin;233;5;238
32;Hauts-de-France;62;1;04;873;Wancourt;637;10;647
32;Hauts-de-France;62;1;07;874;Wanquetin;716;15;731
32;Hauts-de-France;62;5;25;875;Wardrecques;1354;18;1372
32;Hauts-de-France;62;1;09;876;Warlencourt-Eaucourt;132;2;134
32;Hauts-de-France;62;1;07;877;Warlincourt-lès-Pas;156;5;161
32;Hauts-de-France;62;1;07;878;Warlus;382;7;389
32;Hauts-de-France;62;1;07;879;Warluzel;224;3;227
32;Hauts-de-France;62;3;22;880;Le Wast;198;3;201
32;Hauts-de-France;62;1;06;881;Beauvoir-Wavans;374;9;383
32;Hauts-de-France;62;5;33;882;Wavrans-sur-l'Aa;1240;33;1273
32;Hauts-de-France;62;1;38;883;Wavrans-sur-Ternoise;195;2;197
32;Hauts-de-France;62;2;31;885;Westrehem;253;2;255
32;Hauts-de-France;62;4;33;886;Wicquinghem;271;3;274
32;Hauts-de-France;62;4;24;887;Widehem;245;1;246
32;Hauts-de-France;62;3;22;888;Wierre-au-Bois;226;9;235
32;Hauts-de-France;62;3;22;889;Wierre-Effroy;867;19;886
32;Hauts-de-France;62;4;06;890;Willeman;183;3;186
32;Hauts-de-France;62;1;06;891;Willencourt;137;4;141
32;Hauts-de-France;62;1;03;892;Willerval;657;10;667
32;Hauts-de-France;62;3;13;893;Wimereux;6311;164;6475
32;Hauts-de-France;62;3;13;894;Wimille;3937;52;3989
32;Hauts-de-France;62;7;39;895;Wingles;8750;47;8797
32;Hauts-de-France;62;3;22;896;Wirwignes;748;20;768
32;Hauts-de-France;62;5;33;897;Wismes;512;9;521
32;Hauts-de-France;62;5;33;898;Wisques;224;9;233
32;Hauts-de-France;62;3;22;899;Wissant;850;16;866
32;Hauts-de-France;62;2;01;900;Witternesse;599;15;614
32;Hauts-de-France;62;5;01;901;Wittes;999;13;1012
32;Hauts-de-France;62;5;32;902;Wizernes;3308;41;3349
32;Hauts-de-France;62;4;33;903;Zoteux;609;13;622
32;Hauts-de-France;62;5;37;904;Zouafques;596;9;605
32;Hauts-de-France;62;5;33;905;Zudausques;1033;50;1083
32;Hauts-de-France;62;6;34;906;Zutkerque;1788;11;1799
32;Hauts-de-France;62;7;21;907;Libercourt;8230;41;8271
32;Hauts-de-France;62;3;13;908;La Capelle-lès-Boulogne;1610;38;1648
32;Hauts-de-France;62;1;09;909;Ytres;433;5;438
84;Auvergne-Rhône-Alpes;63;4;01;001;Aigueperse;2770;34;2804
84;Auvergne-Rhône-Alpes;63;1;22;002;Aix-la-Fayette;96;3;99
84;Auvergne-Rhône-Alpes;63;1;02;003;Ambert;6636;241;6877
84;Auvergne-Rhône-Alpes;63;4;27;004;Les Ancizes-Comps;1705;31;1736
84;Auvergne-Rhône-Alpes;63;3;06;005;Antoingt;411;5;416
84;Auvergne-Rhône-Alpes;63;3;06;006;Anzat-le-Luguet;173;2;175
84;Auvergne-Rhône-Alpes;63;3;06;007;Apchat;161;3;164
84;Auvergne-Rhône-Alpes;63;5;30;008;Arconsat;585;11;596
84;Auvergne-Rhône-Alpes;63;3;06;009;Ardes;598;5;603
84;Auvergne-Rhône-Alpes;63;1;02;010;Arlanc;1803;38;1841
84;Auvergne-Rhône-Alpes;63;4;26;011;Ars-les-Favets;219;13;232
84;Auvergne-Rhône-Alpes;63;4;01;012;Artonne;918;18;936
84;Auvergne-Rhône-Alpes;63;4;01;013;Aubiat;955;9;964
84;Auvergne-Rhône-Alpes;63;2;03;014;Aubière;10581;175;10756
84;Auvergne-Rhône-Alpes;63;5;22;015;Aubusson-d'Auvergne;223;2;225
84;Auvergne-Rhône-Alpes;63;5;22;016;Augerolles;879;20;899
84;Auvergne-Rhône-Alpes;63;3;06;017;Augnat;193;1;194
84;Auvergne-Rhône-Alpes;63;2;17;019;Aulnat;4103;39;4142
84;Auvergne-Rhône-Alpes;63;3;23;020;Aurières;369;13;382
84;Auvergne-Rhône-Alpes;63;2;21;021;Authezat;680;15;695
84;Auvergne-Rhône-Alpes;63;3;06;022;Auzat-la-Combelle;1985;25;2010
84;Auvergne-Rhône-Alpes;63;1;22;023;Auzelles;381;10;391
84;Auvergne-Rhône-Alpes;63;3;29;024;Avèze;174;3;177
84;Auvergne-Rhône-Alpes;63;4;26;025;Ayat-sur-Sioule;137;5;142
84;Auvergne-Rhône-Alpes;63;2;23;026;Aydat;2511;45;2556
84;Auvergne-Rhône-Alpes;63;1;02;027;Baffie;111;1;112
84;Auvergne-Rhône-Alpes;63;3;29;028;Bagnols;405;12;417
84;Auvergne-Rhône-Alpes;63;3;06;029;Bansat;261;3;264
84;Auvergne-Rhône-Alpes;63;4;20;030;Bas-et-Lezat;342;4;346
84;Auvergne-Rhône-Alpes;63;3;06;031;Beaulieu;477;5;482
84;Auvergne-Rhône-Alpes;63;2;04;032;Beaumont;10630;218;10848
84;Auvergne-Rhône-Alpes;63;4;20;033;Beaumont-lès-Randan;310;3;313
84;Auvergne-Rhône-Alpes;63;2;05;034;Beauregard-l'Évêque;1547;25;1572
84;Auvergne-Rhône-Alpes;63;4;27;035;Beauregard-Vendon;1269;19;1288
84;Auvergne-Rhône-Alpes;63;3;06;036;Bergonne;320;4;324
84;Auvergne-Rhône-Alpes;63;1;22;037;Bertignat;455;13;468
84;Auvergne-Rhône-Alpes;63;3;29;038;Besse-et-Saint-Anastaise;1476;67;1543
84;Auvergne-Rhône-Alpes;63;1;02;039;Beurières;285;10;295
84;Auvergne-Rhône-Alpes;63;2;05;040;Billom;4790;95;4885
84;Auvergne-Rhône-Alpes;63;4;26;041;Biollet;319;9;328
84;Auvergne-Rhône-Alpes;63;2;07;042;Blanzat;3795;39;3834
84;Auvergne-Rhône-Alpes;63;4;27;043;Blot-l'Église;445;4;449
84;Auvergne-Rhône-Alpes;63;2;05;044;Bongheat;427;7;434
84;Auvergne-Rhône-Alpes;63;5;19;045;Bort-l'Étang;705;17;722
84;Auvergne-Rhône-Alpes;63;3;06;046;Boudes;282;5;287
84;Auvergne-Rhône-Alpes;63;3;29;047;La Bourboule;1757;33;1790
84;Auvergne-Rhône-Alpes;63;4;28;048;Bourg-Lastic;867;17;884
84;Auvergne-Rhône-Alpes;63;2;05;049;Bouzel;730;6;736
84;Auvergne-Rhône-Alpes;63;3;06;050;Brassac-les-Mines;3373;133;3506
84;Auvergne-Rhône-Alpes;63;3;18;051;Brenat;629;13;642
84;Auvergne-Rhône-Alpes;63;3;06;052;Le Breuil-sur-Couze;1046;88;1134
84;Auvergne-Rhône-Alpes;63;4;28;053;Briffons;262;7;269
84;Auvergne-Rhône-Alpes;63;3;18;054;Le Broc;661;16;677
84;Auvergne-Rhône-Alpes;63;4;28;055;Bromont-Lamothe;994;14;1008
84;Auvergne-Rhône-Alpes;63;1;22;056;Brousse;330;4;334
84;Auvergne-Rhône-Alpes;63;1;22;057;Le Brugeron;243;6;249
84;Auvergne-Rhône-Alpes;63;5;19;058;Bulhon;550;10;560
84;Auvergne-Rhône-Alpes;63;2;31;059;Busséol;218;5;223
84;Auvergne-Rhône-Alpes;63;4;26;060;Bussières;96;1;97
84;Auvergne-Rhône-Alpes;63;4;01;061;Bussières-et-Pruns;481;7;488
84;Auvergne-Rhône-Alpes;63;4;26;062;Buxières-sous-Montaigut;235;2;237
84;Auvergne-Rhône-Alpes;63;2;07;063;Cébazat;8951;124;9075
84;Auvergne-Rhône-Alpes;63;4;28;064;La Celle;79;0;79
84;Auvergne-Rhône-Alpes;63;1;22;065;Ceilloux;172;2;174
84;Auvergne-Rhône-Alpes;63;5;30;066;Celles-sur-Durolle;1646;29;1675
84;Auvergne-Rhône-Alpes;63;4;26;067;La Cellette;162;2;164
84;Auvergne-Rhône-Alpes;63;2;16;069;Le Cendre;5525;53;5578
84;Auvergne-Rhône-Alpes;63;2;04;070;Ceyrat;6338;135;6473
84;Auvergne-Rhône-Alpes;63;3;23;071;Ceyssat;691;13;704
84;Auvergne-Rhône-Alpes;63;5;30;072;Chabreloche;1189;14;1203
84;Auvergne-Rhône-Alpes;63;3;31;073;Chadeleuf;434;13;447
84;Auvergne-Rhône-Alpes;63;3;06;074;Chalus;182;0;182
84;Auvergne-Rhône-Alpes;63;2;08;075;Chamalières;17196;560;17756
84;Auvergne-Rhône-Alpes;63;1;22;076;Chambon-sur-Dolore;143;3;146
84;Auvergne-Rhône-Alpes;63;3;29;077;Chambon-sur-Lac;418;13;431
84;Auvergne-Rhône-Alpes;63;3;06;079;Champagnat-le-Jeune;151;2;153
84;Auvergne-Rhône-Alpes;63;3;29;080;Champeix;1424;23;1447
84;Auvergne-Rhône-Alpes;63;1;02;081;Champétières;275;4;279
84;Auvergne-Rhône-Alpes;63;4;27;082;Champs;403;8;411
84;Auvergne-Rhône-Alpes;63;4;23;083;Chanat-la-Mouteyre;932;28;960
84;Auvergne-Rhône-Alpes;63;2;21;084;Chanonat;1712;38;1750
84;Auvergne-Rhône-Alpes;63;4;28;085;Chapdes-Beaufort;1136;8;1144
84;Auvergne-Rhône-Alpes;63;1;22;086;La Chapelle-Agnon;332;13;345
84;Auvergne-Rhône-Alpes;63;3;06;087;La Chapelle-Marcousse;68;1;69
84;Auvergne-Rhône-Alpes;63;3;06;088;La Chapelle-sur-Usson;84;0;84
84;Auvergne-Rhône-Alpes;63;4;01;089;Chappes;1632;29;1661
84;Auvergne-Rhône-Alpes;63;4;01;090;Chaptuzat;509;7;516
84;Auvergne-Rhône-Alpes;63;3;06;091;Charbonnier-les-Mines;919;16;935
84;Auvergne-Rhône-Alpes;63;4;28;092;Charbonnières-les-Varennes;1840;28;1868
84;Auvergne-Rhône-Alpes;63;4;27;093;Charbonnières-les-Vieilles;1145;22;1167
84;Auvergne-Rhône-Alpes;63;4;26;094;Charensat;480;5;485
84;Auvergne-Rhône-Alpes;63;5;20;095;Charnat;206;3;209
84;Auvergne-Rhône-Alpes;63;2;05;096;Chas;381;8;389
84;Auvergne-Rhône-Alpes;63;3;06;097;Chassagne;80;2;82
84;Auvergne-Rhône-Alpes;63;3;29;098;Chastreix;227;5;232
84;Auvergne-Rhône-Alpes;63;2;09;099;Châteaugay;3104;52;3156
84;Auvergne-Rhône-Alpes;63;4;26;100;Châteauneuf-les-Bains;328;3;331
84;Auvergne-Rhône-Alpes;63;4;26;101;Château-sur-Cher;68;2;70
84;Auvergne-Rhône-Alpes;63;5;20;102;Châteldon;776;15;791
84;Auvergne-Rhône-Alpes;63;4;09;103;Châtel-Guyon;6283;178;6461
84;Auvergne-Rhône-Alpes;63;1;02;104;La Chaulme;113;5;118
84;Auvergne-Rhône-Alpes;63;1;02;105;Chaumont-le-Bourg;228;6;234
84;Auvergne-Rhône-Alpes;63;2;05;106;Chauriat;1731;16;1747
84;Auvergne-Rhône-Alpes;63;4;01;107;Chavaroux;516;10;526
84;Auvergne-Rhône-Alpes;63;4;25;108;Le Cheix;681;18;699
84;Auvergne-Rhône-Alpes;63;3;29;109;Chidrac;531;13;544
84;Auvergne-Rhône-Alpes;63;4;28;110;Cisternes-la-Forêt;464;7;471
84;Auvergne-Rhône-Alpes;63;3;29;111;Clémensat;120;5;125
84;Auvergne-Rhône-Alpes;63;4;01;112;Clerlande;627;18;645
84;Auvergne-Rhône-Alpes;63;2;99;113;Clermont-Ferrand;147284;2614;149898
84;Auvergne-Rhône-Alpes;63;3;06;114;Collanges;157;2;159
84;Auvergne-Rhône-Alpes;63;4;28;115;Combrailles;218;5;223
84;Auvergne-Rhône-Alpes;63;4;27;116;Combronde;2143;36;2179
84;Auvergne-Rhône-Alpes;63;3;29;117;Compains;127;4;131
84;Auvergne-Rhône-Alpes;63;4;28;118;Condat-en-Combraille;410;7;417
84;Auvergne-Rhône-Alpes;63;1;22;119;Condat-lès-Montboissier;228;7;235
84;Auvergne-Rhône-Alpes;63;2;21;120;Corent;766;9;775
84;Auvergne-Rhône-Alpes;63;3;31;121;Coudes;1273;14;1287
84;Auvergne-Rhône-Alpes;63;3;29;122;Courgoul;61;1;62
84;Auvergne-Rhône-Alpes;63;2;23;123;Cournols;233;6;239
84;Auvergne-Rhône-Alpes;63;2;16;124;Cournon-d'Auvergne;20356;356;20712
84;Auvergne-Rhône-Alpes;63;5;22;125;Courpière;4005;143;4148
84;Auvergne-Rhône-Alpes;63;2;21;126;Le Crest;1279;22;1301
84;Auvergne-Rhône-Alpes;63;5;19;128;Crevant-Laveine;968;15;983
84;Auvergne-Rhône-Alpes;63;3;29;129;Cros;167;0;167
84;Auvergne-Rhône-Alpes;63;4;26;130;La Crouzille;259;10;269
84;Auvergne-Rhône-Alpes;63;5;19;131;Culhat;1139;19;1158
84;Auvergne-Rhône-Alpes;63;1;22;132;Cunlhat;1319;23;1342
84;Auvergne-Rhône-Alpes;63;3;06;134;Dauzat-sur-Vodable;68;3;71
84;Auvergne-Rhône-Alpes;63;4;27;135;Davayat;606;6;612
84;Auvergne-Rhône-Alpes;63;1;22;136;Domaize;382;8;390
84;Auvergne-Rhône-Alpes;63;1;02;137;Doranges;174;3;177
84;Auvergne-Rhône-Alpes;63;5;30;138;Dorat;725;10;735
84;Auvergne-Rhône-Alpes;63;1;02;139;Dore-l'Église;660;8;668
84;Auvergne-Rhône-Alpes;63;4;26;140;Durmignat;213;5;218
84;Auvergne-Rhône-Alpes;63;2;07;141;Durtol;2065;44;2109
84;Auvergne-Rhône-Alpes;63;1;22;142;Échandelys;249;12;261
84;Auvergne-Rhône-Alpes;63;4;01;143;Effiat;1134;19;1153
84;Auvergne-Rhône-Alpes;63;3;29;144;Égliseneuve-d'Entraigues;338;6;344
84;Auvergne-Rhône-Alpes;63;3;06;145;Égliseneuve-des-Liards;153;5;158
84;Auvergne-Rhône-Alpes;63;2;05;146;Égliseneuve-près-Billom;808;65;873
84;Auvergne-Rhône-Alpes;63;1;02;147;Églisolles;272;5;277
84;Auvergne-Rhône-Alpes;63;4;01;148;Ennezat;2532;59;2591
84;Auvergne-Rhône-Alpes;63;4;01;149;Entraigues;697;12;709
84;Auvergne-Rhône-Alpes;63;4;09;150;Enval;1556;22;1578
84;Auvergne-Rhône-Alpes;63;5;30;151;Escoutoux;1348;39;1387
84;Auvergne-Rhône-Alpes;63;4;26;152;Espinasse;286;4;290
84;Auvergne-Rhône-Alpes;63;3;29;153;Espinchal;95;3;98
84;Auvergne-Rhône-Alpes;63;2;05;154;Espirat;436;8;444
84;Auvergne-Rhône-Alpes;63;2;05;155;Estandeuil;491;14;505
84;Auvergne-Rhône-Alpes;63;3;06;156;Esteil;57;0;57
84;Auvergne-Rhône-Alpes;63;2;05;157;Fayet-le-Château;372;7;379
84;Auvergne-Rhône-Alpes;63;1;22;158;Fayet-Ronaye;107;4;111
84;Auvergne-Rhône-Alpes;63;4;28;159;Fernoël;135;0;135
84;Auvergne-Rhône-Alpes;63;3;18;160;Aulhat-Flat;930;33;963
84;Auvergne-Rhône-Alpes;63;1;02;161;La Forie;319;12;331
84;Auvergne-Rhône-Alpes;63;1;22;162;Fournols;315;10;325
84;Auvergne-Rhône-Alpes;63;3;23;163;Gelles;940;61;1001
84;Auvergne-Rhône-Alpes;63;2;17;164;Gerzat;10395;96;10491
84;Auvergne-Rhône-Alpes;63;4;28;165;Giat;796;35;831
84;Auvergne-Rhône-Alpes;63;3;06;166;Gignat;249;5;254
84;Auvergne-Rhône-Alpes;63;4;27;167;Gimeaux;398;5;403
84;Auvergne-Rhône-Alpes;63;2;05;168;Glaine-Montaigut;589;11;600
84;Auvergne-Rhône-Alpes;63;3;06;169;La Godivelle;16;0;16
84;Auvergne-Rhône-Alpes;63;4;28;170;La Goutelle;622;12;634
84;Auvergne-Rhône-Alpes;63;4;26;171;Gouttières;326;13;339
84;Auvergne-Rhône-Alpes;63;3;29;172;Grandeyrolles;53;1;54
84;Auvergne-Rhône-Alpes;63;1;02;173;Grandrif;201;7;208
84;Auvergne-Rhône-Alpes;63;1;22;174;Grandval;119;3;122
84;Auvergne-Rhône-Alpes;63;4;28;175;Herment;230;8;238
84;Auvergne-Rhône-Alpes;63;3;23;176;Heume-l'Église;108;3;111
84;Auvergne-Rhône-Alpes;63;2;05;177;Isserteaux;412;8;420
84;Auvergne-Rhône-Alpes;63;3;18;178;Issoire;15297;384;15681
84;Auvergne-Rhône-Alpes;63;1;02;179;Job;1013;30;1043
84;Auvergne-Rhône-Alpes;63;5;19;180;Joze;1145;18;1163
84;Auvergne-Rhône-Alpes;63;4;27;181;Jozerand;549;13;562
84;Auvergne-Rhône-Alpes;63;3;06;182;Jumeaux;566;14;580
84;Auvergne-Rhône-Alpes;63;3;29;183;Labessette;67;1;68
84;Auvergne-Rhône-Alpes;63;5;20;184;Lachaux;278;5;283
84;Auvergne-Rhône-Alpes;63;3;06;185;Lamontgie;641;12;653
84;Auvergne-Rhône-Alpes;63;4;28;186;Landogne;223;8;231
84;Auvergne-Rhône-Alpes;63;4;26;187;Lapeyrouse;520;11;531
84;Auvergne-Rhône-Alpes;63;2;31;188;Laps;586;16;602
84;Auvergne-Rhône-Alpes;63;3;23;189;Laqueuille;364;14;378
84;Auvergne-Rhône-Alpes;63;3;29;190;Larodde;284;4;288
84;Auvergne-Rhône-Alpes;63;4;28;191;Lastic;102;3;105
84;Auvergne-Rhône-Alpes;63;3;29;192;La Tour-d'Auvergne;629;33;662
84;Auvergne-Rhône-Alpes;63;2;24;193;Lempdes;8669;436;9105
84;Auvergne-Rhône-Alpes;63;5;19;194;Lempty;398;6;404
84;Auvergne-Rhône-Alpes;63;5;19;195;Lezoux;6287;68;6355
84;Auvergne-Rhône-Alpes;63;4;20;196;Limons;747;14;761
84;Auvergne-Rhône-Alpes;63;4;27;197;Lisseuil;121;3;124
84;Auvergne-Rhône-Alpes;63;4;27;198;Loubeyrat;1418;21;1439
84;Auvergne-Rhône-Alpes;63;3;29;199;Ludesse;509;5;514
84;Auvergne-Rhône-Alpes;63;4;01;200;Lussat;925;17;942
84;Auvergne-Rhône-Alpes;63;4;20;201;Luzillat;1145;19;1164
84;Auvergne-Rhône-Alpes;63;3;06;202;Madriat;117;2;119
84;Auvergne-Rhône-Alpes;63;4;09;203;Malauzat;1160;18;1178
84;Auvergne-Rhône-Alpes;63;4;17;204;Malintrat;1134;19;1153
84;Auvergne-Rhône-Alpes;63;2;31;205;Manglieu;469;9;478
84;Auvergne-Rhône-Alpes;63;4;27;206;Manzat;1395;21;1416
84;Auvergne-Rhône-Alpes;63;1;22;207;Marat;814;11;825
84;Auvergne-Rhône-Alpes;63;4;27;208;Marcillat;309;3;312
84;Auvergne-Rhône-Alpes;63;3;06;209;Mareugheol;215;5;220
84;Auvergne-Rhône-Alpes;63;4;20;210;Maringues;3112;53;3165
84;Auvergne-Rhône-Alpes;63;1;02;211;Marsac-en-Livradois;1434;40;1474
84;Auvergne-Rhône-Alpes;63;4;09;212;Marsat;1456;38;1494
84;Auvergne-Rhône-Alpes;63;4;01;213;Les Martres-d'Artière;2185;22;2207
84;Auvergne-Rhône-Alpes;63;2;21;214;Les Martres-de-Veyre;3941;63;4004
84;Auvergne-Rhône-Alpes;63;4;01;215;Martres-sur-Morge;680;7;687
84;Auvergne-Rhône-Alpes;63;2;05;216;Mauzun;116;2;118
84;Auvergne-Rhône-Alpes;63;1;02;218;Mayres;197;6;203
84;Auvergne-Rhône-Alpes;63;3;23;219;Mazaye;707;11;718
84;Auvergne-Rhône-Alpes;63;3;06;220;Mazoires;96;3;99
84;Auvergne-Rhône-Alpes;63;1;02;221;Medeyrolles;125;2;127
84;Auvergne-Rhône-Alpes;63;3;18;222;Meilhaud;485;8;493
84;Auvergne-Rhône-Alpes;63;4;26;223;Menat;536;13;549
84;Auvergne-Rhône-Alpes;63;4;09;224;Ménétrol;1643;24;1667
84;Auvergne-Rhône-Alpes;63;4;28;225;Messeix;1034;20;1054
84;Auvergne-Rhône-Alpes;63;2;24;226;Mur-sur-Allier;3313;63;3376
84;Auvergne-Rhône-Alpes;63;2;31;227;Mirefleurs;2353;57;2410
84;Auvergne-Rhône-Alpes;63;4;28;228;Miremont;292;10;302
84;Auvergne-Rhône-Alpes;63;5;19;229;Moissat;1245;22;1267
84;Auvergne-Rhône-Alpes;63;1;22;230;Le Monestier;236;5;241
84;Auvergne-Rhône-Alpes;63;5;30;231;La Monnerie-le-Montel;1669;30;1699
84;Auvergne-Rhône-Alpes;63;4;20;232;Mons;553;14;567
84;Auvergne-Rhône-Alpes;63;4;26;233;Montaigut;985;7;992
84;Auvergne-Rhône-Alpes;63;3;29;234;Montaigut-le-Blanc;891;28;919
84;Auvergne-Rhône-Alpes;63;4;27;235;Montcel;546;6;552
84;Auvergne-Rhône-Alpes;63;3;29;236;Mont-Dore;1274;18;1292
84;Auvergne-Rhône-Alpes;63;4;28;237;Montel-de-Gelat;422;6;428
84;Auvergne-Rhône-Alpes;63;4;28;238;Montfermy;229;1;230
84;Auvergne-Rhône-Alpes;63;2;05;239;Montmorin;727;25;752
84;Auvergne-Rhône-Alpes;63;4;01;240;Montpensier;466;8;474
84;Auvergne-Rhône-Alpes;63;3;31;241;Montpeyroux;324;14;338
84;Auvergne-Rhône-Alpes;63;3;06;242;Moriat;387;10;397
84;Auvergne-Rhône-Alpes;63;4;26;243;Moureuille;385;6;391
84;Auvergne-Rhône-Alpes;63;4;25;244;Chambaron sur Morge;1805;27;1832
84;Auvergne-Rhône-Alpes;63;4;09;245;Mozac;3874;68;3942
84;Auvergne-Rhône-Alpes;63;3;29;246;Murat-le-Quaire;488;18;506
84;Auvergne-Rhône-Alpes;63;3;29;247;Murol;610;11;621
84;Auvergne-Rhône-Alpes;63;3;23;248;Nébouzat;853;22;875
84;Auvergne-Rhône-Alpes;63;5;22;249;Néronde-sur-Dore;510;10;520
84;Auvergne-Rhône-Alpes;63;3;31;250;Neschers;855;18;873
84;Auvergne-Rhône-Alpes;63;4;26;251;Neuf-Église;297;5;302
84;Auvergne-Rhône-Alpes;63;2;05;252;Neuville;378;9;387
84;Auvergne-Rhône-Alpes;63;5;20;253;Noalhat;235;2;237
84;Auvergne-Rhône-Alpes;63;2;07;254;Nohanent;2223;35;2258
84;Auvergne-Rhône-Alpes;63;3;06;255;Nonette-Orsonnette;599;16;615
84;Auvergne-Rhône-Alpes;63;1;02;256;Novacelles;151;3;154
84;Auvergne-Rhône-Alpes;63;3;23;257;Olby;840;10;850
84;Auvergne-Rhône-Alpes;63;1;22;258;Olliergues;750;20;770
84;Auvergne-Rhône-Alpes;63;2;23;259;Olloix;312;9;321
84;Auvergne-Rhône-Alpes;63;5;22;260;Olmet;156;5;161
84;Auvergne-Rhône-Alpes;63;3;18;261;Orbeil;859;24;883
84;Auvergne-Rhône-Alpes;63;2;21;262;Orcet;2781;40;2821
84;Auvergne-Rhône-Alpes;63;2;23;263;Orcines;3545;109;3654
84;Auvergne-Rhône-Alpes;63;3;23;264;Orcival;247;1;248
84;Auvergne-Rhône-Alpes;63;5;19;265;Orléat;2218;44;2262
84;Auvergne-Rhône-Alpes;63;5;30;267;Palladuc;524;19;543
84;Auvergne-Rhône-Alpes;63;3;18;268;Pardines;296;4;300
84;Auvergne-Rhône-Alpes;63;3;31;269;Parent;887;15;902
84;Auvergne-Rhône-Alpes;63;3;06;270;Parentignat;488;15;503
84;Auvergne-Rhône-Alpes;63;5;20;271;Paslières;1478;40;1518
84;Auvergne-Rhône-Alpes;63;2;03;272;Pérignat-lès-Sarliève;2718;52;2770
84;Auvergne-Rhône-Alpes;63;2;31;273;Pérignat-sur-Allier;1504;23;1527
84;Auvergne-Rhône-Alpes;63;3;23;274;Perpezat;426;15;441
84;Auvergne-Rhône-Alpes;63;3;18;275;Perrier;890;20;910
84;Auvergne-Rhône-Alpes;63;5;19;276;Peschadoires;2115;42;2157
84;Auvergne-Rhône-Alpes;63;3;06;277;Peslières;61;1;62
84;Auvergne-Rhône-Alpes;63;4;25;278;Pessat-Villeneuve;719;13;732
84;Auvergne-Rhône-Alpes;63;3;29;279;Picherande;318;10;328
84;Auvergne-Rhône-Alpes;63;2;31;280;Pignols;346;6;352
84;Auvergne-Rhône-Alpes;63;4;26;281;Pionsat;1057;19;1076
84;Auvergne-Rhône-Alpes;63;3;31;282;Plauzat;1758;22;1780
84;Auvergne-Rhône-Alpes;63;4;28;283;Pontaumur;632;116;748
84;Auvergne-Rhône-Alpes;63;2;24;284;Pont-du-Château;12324;317;12641
84;Auvergne-Rhône-Alpes;63;4;28;285;Pontgibaud;746;4;750
84;Auvergne-Rhône-Alpes;63;4;27;286;Pouzol;267;3;270
84;Auvergne-Rhône-Alpes;63;3;06;287;Les Pradeaux;345;7;352
84;Auvergne-Rhône-Alpes;63;4;27;288;Prompsat;458;12;470
84;Auvergne-Rhône-Alpes;63;4;28;289;Prondines;265;7;272
84;Auvergne-Rhône-Alpes;63;4;28;290;Pulvérières;402;8;410
84;Auvergne-Rhône-Alpes;63;5;20;291;Puy-Guillaume;2735;48;2783
84;Auvergne-Rhône-Alpes;63;4;28;292;Puy-Saint-Gulmier;145;3;148
84;Auvergne-Rhône-Alpes;63;4;26;293;Le Quartier;215;10;225
84;Auvergne-Rhône-Alpes;63;4;27;294;Queuille;288;5;293
84;Auvergne-Rhône-Alpes;63;4;20;295;Randan;1618;14;1632
84;Auvergne-Rhône-Alpes;63;5;19;296;Ravel;783;14;797
84;Auvergne-Rhône-Alpes;63;2;05;297;Reignat;379;3;382
84;Auvergne-Rhône-Alpes;63;5;22;298;La Renaudie;128;4;132
84;Auvergne-Rhône-Alpes;63;3;06;299;Rentières;102;0;102
84;Auvergne-Rhône-Alpes;63;4;25;300;Riom;18733;743;19476
84;Auvergne-Rhône-Alpes;63;5;20;301;Ris;739;9;748
84;Auvergne-Rhône-Alpes;63;2;21;302;La Roche-Blanche;3498;64;3562
84;Auvergne-Rhône-Alpes;63;3;06;303;Roche-Charles-la-Mayrand;42;1;43
84;Auvergne-Rhône-Alpes;63;4;26;304;Roche-d'Agoux;110;0;110
84;Auvergne-Rhône-Alpes;63;3;23;305;Rochefort-Montagne;850;145;995
84;Auvergne-Rhône-Alpes;63;2;31;306;La Roche-Noire;624;13;637
84;Auvergne-Rhône-Alpes;63;2;03;307;Romagnat;7833;154;7987
84;Auvergne-Rhône-Alpes;63;2;08;308;Royat;4395;119;4514
84;Auvergne-Rhône-Alpes;63;1;02;309;Saillant;306;3;309
84;Auvergne-Rhône-Alpes;63;5;30;310;Sainte-Agathe;170;3;173
84;Auvergne-Rhône-Alpes;63;4;01;311;Saint-Agoulin;330;12;342
84;Auvergne-Rhône-Alpes;63;1;02;312;Saint-Alyre-d'Arlanc;141;3;144
84;Auvergne-Rhône-Alpes;63;3;06;313;Saint-Alyre-ès-Montagne;107;7;114
84;Auvergne-Rhône-Alpes;63;1;22;314;Saint-Amant-Roche-Savine;513;14;527
84;Auvergne-Rhône-Alpes;63;2;21;315;Saint-Amant-Tallende;1752;38;1790
84;Auvergne-Rhône-Alpes;63;4;20;317;Saint-André-le-Coq;535;2;537
84;Auvergne-Rhône-Alpes;63;4;27;318;Saint-Angel;464;9;473
84;Auvergne-Rhône-Alpes;63;1;02;319;Saint-Anthème;707;23;730
84;Auvergne-Rhône-Alpes;63;4;28;320;Saint-Avit;213;6;219
84;Auvergne-Rhône-Alpes;63;3;18;321;Saint-Babel;933;16;949
84;Auvergne-Rhône-Alpes;63;4;17;322;Saint-Beauzire;2214;28;2242
84;Auvergne-Rhône-Alpes;63;1;22;323;Saint-Bonnet-le-Bourg;169;4;173
84;Auvergne-Rhône-Alpes;63;1;22;324;Saint-Bonnet-le-Chastel;204;6;210
84;Auvergne-Rhône-Alpes;63;2;05;325;Saint-Bonnet-lès-Allier;420;6;426
84;Auvergne-Rhône-Alpes;63;3;23;326;Saint-Bonnet-près-Orcival;533;8;541
84;Auvergne-Rhône-Alpes;63;4;25;327;Saint-Bonnet-près-Riom;2033;39;2072
84;Auvergne-Rhône-Alpes;63;1;22;328;Sainte-Catherine;51;2;53
84;Auvergne-Rhône-Alpes;63;4;26;329;Sainte-Christine;127;5;132
84;Auvergne-Rhône-Alpes;63;3;29;330;Saint-Cirgues-sur-Couze;351;7;358
84;Auvergne-Rhône-Alpes;63;1;02;331;Saint-Clément-de-Valorgue;233;6;239
84;Auvergne-Rhône-Alpes;63;4;20;332;Saint-Clément-de-Régnat;530;9;539
84;Auvergne-Rhône-Alpes;63;4;20;333;Saint-Denis-Combarnazat;236;3;239
84;Auvergne-Rhône-Alpes;63;2;05;334;Saint-Dier-d'Auvergne;544;19;563
84;Auvergne-Rhône-Alpes;63;3;29;335;Saint-Diéry;530;16;546
84;Auvergne-Rhône-Alpes;63;3;29;336;Saint-Donat;200;4;204
84;Auvergne-Rhône-Alpes;63;1;22;337;Saint-Éloy-la-Glacière;64;1;65
84;Auvergne-Rhône-Alpes;63;4;26;338;Saint-Éloy-les-Mines;3492;144;3636
84;Auvergne-Rhône-Alpes;63;4;28;339;Saint-Étienne-des-Champs;130;2;132
84;Auvergne-Rhône-Alpes;63;3;06;340;Saint-Étienne-sur-Usson;257;3;260
84;Auvergne-Rhône-Alpes;63;1;02;341;Saint-Ferréol-des-Côtes;549;16;565
84;Auvergne-Rhône-Alpes;63;3;29;342;Saint-Floret;246;4;250
84;Auvergne-Rhône-Alpes;63;5;22;343;Saint-Flour-l'Étang;277;6;283
84;Auvergne-Rhône-Alpes;63;4;27;344;Saint-Gal-sur-Sioule;149;4;153
84;Auvergne-Rhône-Alpes;63;2;04;345;Saint-Genès-Champanelle;3791;106;3897
84;Auvergne-Rhône-Alpes;63;3;29;346;Saint-Genès-Champespe;216;7;223
84;Auvergne-Rhône-Alpes;63;4;01;347;Saint-Genès-du-Retz;461;18;479
84;Auvergne-Rhône-Alpes;63;3;06;348;Saint-Genès-la-Tourette;182;1;183
84;Auvergne-Rhône-Alpes;63;4;27;349;Saint-Georges-de-Mons;1914;48;1962
84;Auvergne-Rhône-Alpes;63;2;31;350;Saint-Georges-sur-Allier;1307;18;1325
84;Auvergne-Rhône-Alpes;63;4;28;351;Saint-Germain-près-Herment;66;2;68
84;Auvergne-Rhône-Alpes;63;3;06;352;Saint-Germain-Lembron;2012;42;2054
84;Auvergne-Rhône-Alpes;63;1;22;353;Saint-Germain-l'Herm;485;30;515
84;Auvergne-Rhône-Alpes;63;4;26;354;Saint-Gervais-d'Auvergne;1239;163;1402
84;Auvergne-Rhône-Alpes;63;1;22;355;Saint-Gervais-sous-Meymont;218;4;222
84;Auvergne-Rhône-Alpes;63;3;06;356;Saint-Gervazy;335;14;349
84;Auvergne-Rhône-Alpes;63;3;06;357;Saint-Hérent;114;4;118
84;Auvergne-Rhône-Alpes;63;4;27;358;Saint-Hilaire-la-Croix;364;10;374
84;Auvergne-Rhône-Alpes;63;4;28;359;Saint-Hilaire-les-Monges;86;0;86
84;Auvergne-Rhône-Alpes;63;4;26;360;Saint-Hilaire;150;3;153
84;Auvergne-Rhône-Alpes;63;4;01;362;Saint-Ignat;921;15;936
84;Auvergne-Rhône-Alpes;63;4;28;363;Saint-Jacques-d'Ambur;282;8;290
84;Auvergne-Rhône-Alpes;63;5;19;364;Saint-Jean-d'Heurs;675;15;690
84;Auvergne-Rhône-Alpes;63;2;05;365;Saint-Jean-des-Ollières;423;12;435
84;Auvergne-Rhône-Alpes;63;3;06;366;Saint-Jean-en-Val;352;2;354
84;Auvergne-Rhône-Alpes;63;3;06;367;Saint-Jean-Saint-Gervais;125;1;126
84;Auvergne-Rhône-Alpes;63;2;05;368;Saint-Julien-de-Coppel;1309;30;1339
84;Auvergne-Rhône-Alpes;63;4;26;369;Saint-Julien-la-Geneste;120;3;123
84;Auvergne-Rhône-Alpes;63;3;28;370;Saint-Julien-Puy-Lavèze;368;5;373
84;Auvergne-Rhône-Alpes;63;1;02;371;Saint-Just;152;5;157
84;Auvergne-Rhône-Alpes;63;4;01;372;Saint-Laure;667;7;674
84;Auvergne-Rhône-Alpes;63;4;26;373;Saint-Maigner;189;4;193
84;Auvergne-Rhône-Alpes;63;1;02;374;Saint-Martin-des-Olmes;295;3;298
84;Auvergne-Rhône-Alpes;63;3;06;375;Saint-Martin-des-Plains;170;6;176
84;Auvergne-Rhône-Alpes;63;3;06;376;Saint-Martin-d'Ollières;147;6;153
84;Auvergne-Rhône-Alpes;63;4;26;377;Saint-Maurice-près-Pionsat;372;6;378
84;Auvergne-Rhône-Alpes;63;2;31;378;Saint-Maurice;963;9;972
84;Auvergne-Rhône-Alpes;63;4;27;379;Saint-Myon;528;6;534
84;Auvergne-Rhône-Alpes;63;3;29;380;Saint-Nectaire;765;3;768
84;Auvergne-Rhône-Alpes;63;4;28;381;Saint-Ours;1665;23;1688
84;Auvergne-Rhône-Alpes;63;4;27;382;Saint-Pardoux;406;13;419
84;Auvergne-Rhône-Alpes;63;3;29;383;Saint-Pierre-Colamine;250;5;255
84;Auvergne-Rhône-Alpes;63;1;22;384;Saint-Pierre-la-Bourlhonne;134;5;139
84;Auvergne-Rhône-Alpes;63;4;28;385;Saint-Pierre-le-Chastel;442;11;453
84;Auvergne-Rhône-Alpes;63;3;23;386;Saint-Pierre-Roche;494;6;500
84;Auvergne-Rhône-Alpes;63;4;20;387;Saint-Priest-Bramefant;866;16;882
84;Auvergne-Rhône-Alpes;63;4;26;388;Saint-Priest-des-Champs;703;16;719
84;Auvergne-Rhône-Alpes;63;3;06;389;Saint-Quentin-sur-Sauxillanges;110;2;112
84;Auvergne-Rhône-Alpes;63;4;27;390;Saint-Quintin-sur-Sioule;386;13;399
84;Auvergne-Rhône-Alpes;63;4;27;391;Saint-Rémy-de-Blot;242;4;246
84;Auvergne-Rhône-Alpes;63;3;06;392;Saint-Rémy-de-Chargnat;595;7;602
84;Auvergne-Rhône-Alpes;63;5;30;393;Saint-Rémy-sur-Durolle;1753;33;1786
84;Auvergne-Rhône-Alpes;63;1;02;394;Saint-Romain;204;6;210
84;Auvergne-Rhône-Alpes;63;2;23;395;Saint-Sandoux;980;21;1001
84;Auvergne-Rhône-Alpes;63;2;23;396;Saint-Saturnin;1160;62;1222
84;Auvergne-Rhône-Alpes;63;3;29;397;Saint-Sauves-d'Auvergne;1127;21;1148
84;Auvergne-Rhône-Alpes;63;1;02;398;Saint-Sauveur-la-Sagne;85;3;88
84;Auvergne-Rhône-Alpes;63;4;28;399;Saint-Sulpice;84;4;88
84;Auvergne-Rhône-Alpes;63;4;20;400;Saint-Sylvestre-Pragoulin;1069;23;1092
84;Auvergne-Rhône-Alpes;63;3;29;401;Saint-Victor-la-Rivière;249;7;256
84;Auvergne-Rhône-Alpes;63;5;30;402;Saint-Victor-Montvianeix;255;7;262
84;Auvergne-Rhône-Alpes;63;3;29;403;Saint-Vincent;416;11;427
84;Auvergne-Rhône-Alpes;63;3;18;404;Saint-Yvoine;590;15;605
84;Auvergne-Rhône-Alpes;63;2;31;405;Sallèdes;582;13;595
84;Auvergne-Rhône-Alpes;63;4;01;406;Sardon;297;6;303
84;Auvergne-Rhône-Alpes;63;3;23;407;Saulzet-le-Froid;284;7;291
84;Auvergne-Rhône-Alpes;63;4;26;408;Sauret-Besserve;167;5;172
84;Auvergne-Rhône-Alpes;63;3;29;409;Saurier;269;0;269
84;Auvergne-Rhône-Alpes;63;4;28;410;Sauvagnat;143;3;146
84;Auvergne-Rhône-Alpes;63;3;31;411;Sauvagnat-Sainte-Marthe;472;15;487
84;Auvergne-Rhône-Alpes;63;1;02;412;Sauvessanges;530;10;540
84;Auvergne-Rhône-Alpes;63;2;21;413;La Sauvetat;706;11;717
84;Auvergne-Rhône-Alpes;63;5;22;414;Sauviat;563;11;574
84;Auvergne-Rhône-Alpes;63;3;06;415;Sauxillanges;1311;13;1324
84;Auvergne-Rhône-Alpes;63;4;28;416;Savennes;93;2;95
84;Auvergne-Rhône-Alpes;63;4;07;417;Sayat;2472;46;2518
84;Auvergne-Rhône-Alpes;63;5;22;418;Sermentizon;576;9;585
84;Auvergne-Rhône-Alpes;63;4;26;419;Servant;557;12;569
84;Auvergne-Rhône-Alpes;63;5;19;420;Seychalles;791;9;800
84;Auvergne-Rhône-Alpes;63;3;29;421;Singles;157;4;161
84;Auvergne-Rhône-Alpes;63;3;29;422;Solignat;518;10;528
84;Auvergne-Rhône-Alpes;63;3;06;423;Sugères;601;8;609
84;Auvergne-Rhône-Alpes;63;4;01;424;Surat;591;10;601
84;Auvergne-Rhône-Alpes;63;2;21;425;Tallende;1502;42;1544
84;Auvergne-Rhône-Alpes;63;3;29;426;Tauves;719;18;737
84;Auvergne-Rhône-Alpes;63;4;27;427;Teilhède;493;16;509
84;Auvergne-Rhône-Alpes;63;4;26;428;Teilhet;282;2;284
84;Auvergne-Rhône-Alpes;63;3;06;429;Ternant-les-Eaux;29;2;31
84;Auvergne-Rhône-Alpes;63;5;30;430;Thiers;11470;371;11841
84;Auvergne-Rhône-Alpes;63;1;02;431;Thiolières;162;1;163
84;Auvergne-Rhône-Alpes;63;4;01;432;Thuret;920;37;957
84;Auvergne-Rhône-Alpes;63;4;28;433;Tortebesse;76;3;79
84;Auvergne-Rhône-Alpes;63;1;22;434;Tours-sur-Meymont;522;15;537
84;Auvergne-Rhône-Alpes;63;3;29;435;Tourzel-Ronzières;200;6;206
84;Auvergne-Rhône-Alpes;63;4;28;436;Tralaigues;72;0;72
84;Auvergne-Rhône-Alpes;63;3;29;437;Trémouille-Saint-Loup;153;5;158
84;Auvergne-Rhône-Alpes;63;2;05;438;Trézioux;489;8;497
84;Auvergne-Rhône-Alpes;63;3;06;439;Usson;301;2;303
84;Auvergne-Rhône-Alpes;63;3;29;440;Valbeleix;132;0;132
84;Auvergne-Rhône-Alpes;63;1;02;441;Valcivières;215;4;219
84;Auvergne-Rhône-Alpes;63;3;06;442;Valz-sous-Châteauneuf;53;2;55
84;Auvergne-Rhône-Alpes;63;4;01;443;Varennes-sur-Morge;424;12;436
84;Auvergne-Rhône-Alpes;63;3;06;444;Varennes-sur-Usson;308;4;312
84;Auvergne-Rhône-Alpes;63;2;05;445;Vassel;300;4;304
84;Auvergne-Rhône-Alpes;63;4;01;446;Vensat;528;6;534
84;Auvergne-Rhône-Alpes;63;4;26;447;Vergheas;66;5;71
84;Auvergne-Rhône-Alpes;63;3;06;448;Le Vernet-Chaméane;792;85;877
84;Auvergne-Rhône-Alpes;63;3;23;449;Le Vernet-Sainte-Marguerite;311;8;319
84;Auvergne-Rhône-Alpes;63;4;28;450;Verneugheol;233;2;235
84;Auvergne-Rhône-Alpes;63;3;23;451;Vernines;417;17;434
84;Auvergne-Rhône-Alpes;63;3;29;452;Verrières;72;1;73
84;Auvergne-Rhône-Alpes;63;2;05;453;Vertaizon;3301;29;3330
84;Auvergne-Rhône-Alpes;63;1;22;454;Vertolaye;540;11;551
84;Auvergne-Rhône-Alpes;63;2;21;455;Veyre-Monton;3664;59;3723
84;Auvergne-Rhône-Alpes;63;3;06;456;Vichel;338;14;352
84;Auvergne-Rhône-Alpes;63;2;31;457;Vic-le-Comte;5188;95;5283
84;Auvergne-Rhône-Alpes;63;3;06;458;Villeneuve;146;1;147
84;Auvergne-Rhône-Alpes;63;4;20;459;Villeneuve-les-Cerfs;519;5;524
84;Auvergne-Rhône-Alpes;63;4;28;460;Villossanges;369;11;380
84;Auvergne-Rhône-Alpes;63;5;19;461;Vinzelles;363;3;366
84;Auvergne-Rhône-Alpes;63;4;26;462;Virlet;266;5;271
84;Auvergne-Rhône-Alpes;63;5;30;463;Viscomtat;511;9;520
84;Auvergne-Rhône-Alpes;63;4;27;464;Vitrac;343;13;356
84;Auvergne-Rhône-Alpes;63;1;02;465;Viverols;418;9;427
84;Auvergne-Rhône-Alpes;63;3;29;466;Vodable;193;3;196
84;Auvergne-Rhône-Alpes;63;4;28;467;Voingt;39;2;41
84;Auvergne-Rhône-Alpes;63;5;30;468;Vollore-Montagne;304;10;314
84;Auvergne-Rhône-Alpes;63;5;22;469;Vollore-Ville;715;17;732
84;Auvergne-Rhône-Alpes;63;4;09;470;Volvic;4702;76;4778
84;Auvergne-Rhône-Alpes;63;4;26;471;Youx;895;19;914
84;Auvergne-Rhône-Alpes;63;2;31;472;Yronde-et-Buron;649;16;665
84;Auvergne-Rhône-Alpes;63;4;27;473;Yssac-la-Tourette;393;7;400
75;Nouvelle-Aquitaine;64;3;27;001;Aast;188;7;195
75;Nouvelle-Aquitaine;64;3;23;002;Abère;165;1;166
75;Nouvelle-Aquitaine;64;3;09;003;Abidos;212;8;220
75;Nouvelle-Aquitaine;64;2;16;004;Abitain;107;1;108
75;Nouvelle-Aquitaine;64;3;09;005;Abos;537;8;545
75;Nouvelle-Aquitaine;64;2;14;006;Accous;459;12;471
75;Nouvelle-Aquitaine;64;2;14;007;Agnos;1039;27;1066
75;Nouvelle-Aquitaine;64;1;12;008;Ahaxe-Alciette-Bascassan;266;9;275
75;Nouvelle-Aquitaine;64;1;26;009;Ahetze;2027;30;2057
75;Nouvelle-Aquitaine;64;1;22;010;Aïcirits-Camou-Suhast;678;23;701
75;Nouvelle-Aquitaine;64;1;12;011;Aincille;115;6;121
75;Nouvelle-Aquitaine;64;2;12;012;Ainharp;133;4;137
75;Nouvelle-Aquitaine;64;1;12;013;Ainhice-Mongelos;172;5;177
75;Nouvelle-Aquitaine;64;1;26;014;Ainhoa;668;7;675
75;Nouvelle-Aquitaine;64;2;12;015;Alçay-Alçabéhéty-Sunharette;209;2;211
75;Nouvelle-Aquitaine;64;1;12;016;Aldudes;324;6;330
75;Nouvelle-Aquitaine;64;2;12;017;Alos-Sibas-Abense;334;4;338
75;Nouvelle-Aquitaine;64;1;22;018;Amendeuix-Oneix;455;9;464
75;Nouvelle-Aquitaine;64;1;22;019;Amorots-Succos;233;1;234
75;Nouvelle-Aquitaine;64;3;23;021;Andoins;675;23;698
75;Nouvelle-Aquitaine;64;2;16;022;Andrein;138;3;141
75;Nouvelle-Aquitaine;64;3;27;023;Angaïs;908;23;931
75;Nouvelle-Aquitaine;64;1;96;024;Anglet;40310;1078;41388
75;Nouvelle-Aquitaine;64;2;09;025;Angous;95;5;100
75;Nouvelle-Aquitaine;64;1;12;026;Anhaux;376;11;387
75;Nouvelle-Aquitaine;64;3;23;027;Anos;188;3;191
75;Nouvelle-Aquitaine;64;3;25;028;Anoye;132;2;134
75;Nouvelle-Aquitaine;64;2;14;029;Aramits;662;15;677
75;Nouvelle-Aquitaine;64;1;22;031;Arancou;177;3;180
75;Nouvelle-Aquitaine;64;2;09;032;Araujuzon;178;8;186
75;Nouvelle-Aquitaine;64;2;09;033;Araux;133;1;134
75;Nouvelle-Aquitaine;64;1;22;034;Arbérats-Sillègue;317;5;322
75;Nouvelle-Aquitaine;64;1;26;035;Arbonne;2339;64;2403
75;Nouvelle-Aquitaine;64;1;22;036;Arbouet-Sussaute;314;6;320
75;Nouvelle-Aquitaine;64;3;11;037;Arbus;1254;23;1277
75;Nouvelle-Aquitaine;64;1;26;038;Arcangues;3326;68;3394
75;Nouvelle-Aquitaine;64;2;14;039;Aren;245;8;253
75;Nouvelle-Aquitaine;64;2;14;040;Arette;1071;33;1104
75;Nouvelle-Aquitaine;64;3;17;041;Aressy;796;13;809
75;Nouvelle-Aquitaine;64;3;02;042;Argagnon;702;9;711
75;Nouvelle-Aquitaine;64;3;25;043;Argelos;296;4;300
75;Nouvelle-Aquitaine;64;3;02;044;Arget;79;1;80
75;Nouvelle-Aquitaine;64;1;22;045;Arhansus;74;0;74
75;Nouvelle-Aquitaine;64;1;22;046;Armendarits;390;5;395
75;Nouvelle-Aquitaine;64;1;12;047;Arnéguy;237;2;239
75;Nouvelle-Aquitaine;64;3;02;048;Arnos;134;1;135
75;Nouvelle-Aquitaine;64;1;22;049;Aroue-Ithorots-Olhaïby;231;8;239
75;Nouvelle-Aquitaine;64;2;12;050;Arrast-Larrebieu;94;3;97
75;Nouvelle-Aquitaine;64;1;22;051;Arraute-Charritte;417;5;422
75;Nouvelle-Aquitaine;64;3;25;052;Arricau-Bordes;107;4;111
75;Nouvelle-Aquitaine;64;3;23;053;Arrien;192;3;195
75;Nouvelle-Aquitaine;64;3;17;054;Arros-de-Nay;783;19;802
75;Nouvelle-Aquitaine;64;3;25;056;Arrosès;138;9;147
75;Nouvelle-Aquitaine;64;3;02;057;Arthez-de-Béarn;1829;41;1870
75;Nouvelle-Aquitaine;64;3;17;058;Arthez-d'Asson;464;10;474
75;Nouvelle-Aquitaine;64;3;23;059;Artigueloutan;1077;28;1105
75;Nouvelle-Aquitaine;64;3;11;060;Artiguelouve;1982;55;2037
75;Nouvelle-Aquitaine;64;3;02;061;Artix;3434;62;3496
75;Nouvelle-Aquitaine;64;2;15;062;Arudy;2253;47;2300
75;Nouvelle-Aquitaine;64;3;02;063;Arzacq-Arraziguet;1054;20;1074
75;Nouvelle-Aquitaine;64;2;14;064;Asasp-Arros;445;9;454
75;Nouvelle-Aquitaine;64;1;26;065;Ascain;4368;115;4483
75;Nouvelle-Aquitaine;64;1;12;066;Ascarat;334;10;344
75;Nouvelle-Aquitaine;64;3;17;067;Assat;2025;48;2073
75;Nouvelle-Aquitaine;64;3;17;068;Asson;1998;49;2047
75;Nouvelle-Aquitaine;64;2;15;069;Aste-Béon;230;6;236
75;Nouvelle-Aquitaine;64;3;25;070;Astis;321;2;323
75;Nouvelle-Aquitaine;64;2;16;071;Athos-Aspis;210;3;213
75;Nouvelle-Aquitaine;64;3;08;072;Aubertin;649;14;663
75;Nouvelle-Aquitaine;64;3;25;073;Aubin;264;5;269
75;Nouvelle-Aquitaine;64;3;25;074;Aubous;44;1;45
75;Nouvelle-Aquitaine;64;2;09;075;Audaux;165;1;166
75;Nouvelle-Aquitaine;64;3;25;077;Auga;176;3;179
75;Nouvelle-Aquitaine;64;3;25;078;Auriac;226;6;232
75;Nouvelle-Aquitaine;64;3;25;079;Aurions-Idernes;101;3;104
75;Nouvelle-Aquitaine;64;3;02;080;Aussevielle;805;24;829
75;Nouvelle-Aquitaine;64;2;12;081;Aussurucq;238;3;241
75;Nouvelle-Aquitaine;64;2;16;082;Auterrive;141;3;144
75;Nouvelle-Aquitaine;64;2;16;083;Autevielle-Saint-Martin-Bideren;201;3;204
75;Nouvelle-Aquitaine;64;3;25;084;Aydie;141;2;143
75;Nouvelle-Aquitaine;64;2;14;085;Aydius;106;1;107
75;Nouvelle-Aquitaine;64;1;22;086;Ayherre;1120;34;1154
75;Nouvelle-Aquitaine;64;3;16;087;Baigts-de-Béarn;866;21;887
75;Nouvelle-Aquitaine;64;3;02;088;Balansun;305;9;314
75;Nouvelle-Aquitaine;64;3;23;089;Baleix;139;4;143
75;Nouvelle-Aquitaine;64;3;25;090;Baliracq-Maumusson;120;2;122
75;Nouvelle-Aquitaine;64;3;17;091;Baliros;503;7;510
75;Nouvelle-Aquitaine;64;1;12;092;Banca;348;7;355
75;Nouvelle-Aquitaine;64;2;12;093;Barcus;640;5;645
75;Nouvelle-Aquitaine;64;1;13;094;Bardos;1838;48;1886
75;Nouvelle-Aquitaine;64;3;23;095;Barinque;592;12;604
75;Nouvelle-Aquitaine;64;2;16;096;Barraute-Camu;179;2;181
75;Nouvelle-Aquitaine;64;3;27;097;Barzun;618;11;629
75;Nouvelle-Aquitaine;64;3;25;098;Bassillon-Vauzé;65;2;67
75;Nouvelle-Aquitaine;64;2;09;099;Bastanès;97;4;101
75;Nouvelle-Aquitaine;64;1;26;100;Bassussarry;3261;95;3356
75;Nouvelle-Aquitaine;64;3;27;101;Baudreix;575;108;683
75;Nouvelle-Aquitaine;64;1;97;102;Bayonne;52006;1290;53296
75;Nouvelle-Aquitaine;64;3;23;103;Bédeille;207;3;210
75;Nouvelle-Aquitaine;64;2;14;104;Bedous;592;13;605
75;Nouvelle-Aquitaine;64;1;22;105;Béguios;269;12;281
75;Nouvelle-Aquitaine;64;1;22;106;Béhasque-Lapiste;514;10;524
75;Nouvelle-Aquitaine;64;1;12;107;Béhorléguy;71;3;74
75;Nouvelle-Aquitaine;64;3;16;108;Bellocq;913;10;923
75;Nouvelle-Aquitaine;64;3;27;109;Bénéjacq;1951;44;1995
75;Nouvelle-Aquitaine;64;2;15;110;Béost;221;2;223
75;Nouvelle-Aquitaine;64;3;23;111;Bentayou-Sérée;109;3;112
75;Nouvelle-Aquitaine;64;2;16;112;Bérenx;423;4;427
75;Nouvelle-Aquitaine;64;1;22;113;Bergouey-Viellenave;116;7;123
75;Nouvelle-Aquitaine;64;3;23;114;Bernadets;586;2;588
75;Nouvelle-Aquitaine;64;2;12;115;Berrogain-Laruns;160;67;227
75;Nouvelle-Aquitaine;64;2;15;116;Bescat;245;5;250
75;Nouvelle-Aquitaine;64;3;09;117;Bésingrand;145;4;149
75;Nouvelle-Aquitaine;64;3;25;118;Bétracq;50;0;50
75;Nouvelle-Aquitaine;64;3;27;119;Beuste;674;11;685
75;Nouvelle-Aquitaine;64;1;22;120;Beyrie-sur-Joyeuse;538;11;549
75;Nouvelle-Aquitaine;64;3;02;121;Beyrie-en-Béarn;191;2;193
75;Nouvelle-Aquitaine;64;1;07;122;Biarritz;25885;698;26583
75;Nouvelle-Aquitaine;64;1;22;123;Bidache;1353;25;1378
75;Nouvelle-Aquitaine;64;1;12;124;Bidarray;662;15;677
75;Nouvelle-Aquitaine;64;1;24;125;Bidart;7224;130;7354
75;Nouvelle-Aquitaine;64;2;14;126;Bidos;1109;33;1142
75;Nouvelle-Aquitaine;64;2;15;127;Bielle;390;14;404
75;Nouvelle-Aquitaine;64;2;15;128;Bilhères;159;5;164
75;Nouvelle-Aquitaine;64;3;08;129;Billère;13229;220;13449
75;Nouvelle-Aquitaine;64;1;10;130;Biriatou;1231;20;1251
75;Nouvelle-Aquitaine;64;3;09;131;Biron;617;21;638
75;Nouvelle-Aquitaine;64;3;20;132;Bizanos;4522;125;4647
75;Nouvelle-Aquitaine;64;3;27;133;Boeil-Bezing;1342;23;1365
75;Nouvelle-Aquitaine;64;1;22;134;Bonloc;369;7;376
75;Nouvelle-Aquitaine;64;3;02;135;Bonnut;813;14;827
75;Nouvelle-Aquitaine;64;2;14;136;Borce;129;2;131
75;Nouvelle-Aquitaine;64;3;27;137;Bordères;673;20;693
75;Nouvelle-Aquitaine;64;3;27;138;Bordes;2888;51;2939
75;Nouvelle-Aquitaine;64;3;17;139;Bosdarros;976;23;999
75;Nouvelle-Aquitaine;64;1;05;140;Boucau;8764;171;8935
75;Nouvelle-Aquitaine;64;3;25;141;Boueilh-Boueilho-Lasque;386;9;395
75;Nouvelle-Aquitaine;64;3;02;142;Bougarber;835;27;862
75;Nouvelle-Aquitaine;64;3;02;143;Bouillon;157;0;157
75;Nouvelle-Aquitaine;64;3;02;144;Boumourt;167;2;169
75;Nouvelle-Aquitaine;64;3;17;145;Bourdettes;512;8;520
75;Nouvelle-Aquitaine;64;3;25;146;Bournos;337;4;341
75;Nouvelle-Aquitaine;64;1;13;147;Briscous;2882;45;2927
75;Nouvelle-Aquitaine;64;3;17;148;Bruges-Capbis-Mifaget;862;25;887
75;Nouvelle-Aquitaine;64;2;09;149;Bugnein;245;6;251
75;Nouvelle-Aquitaine;64;1;22;150;Bunus;133;2;135
75;Nouvelle-Aquitaine;64;2;16;151;Burgaronne;99;5;104
75;Nouvelle-Aquitaine;64;3;23;152;Buros;1940;54;1994
75;Nouvelle-Aquitaine;64;3;25;153;Burosse-Mendousse;72;1;73
75;Nouvelle-Aquitaine;64;1;12;154;Bussunarits-Sarrasquette;208;2;210
75;Nouvelle-Aquitaine;64;1;12;155;Bustince-Iriberry;105;1;106
75;Nouvelle-Aquitaine;64;2;15;156;Buziet;474;14;488
75;Nouvelle-Aquitaine;64;2;15;157;Buzy;996;21;1017
75;Nouvelle-Aquitaine;64;3;02;158;Cabidos;173;7;180
75;Nouvelle-Aquitaine;64;3;25;159;Cadillon;119;4;123
75;Nouvelle-Aquitaine;64;1;03;160;Cambo-les-Bains;6623;108;6731
75;Nouvelle-Aquitaine;64;1;22;161;Came;1017;20;1037
75;Nouvelle-Aquitaine;64;2;12;162;Camou-Cihigue;101;3;104
75;Nouvelle-Aquitaine;64;3;09;165;Cardesse;299;10;309
75;Nouvelle-Aquitaine;64;1;12;166;Caro;187;9;196
75;Nouvelle-Aquitaine;64;3;25;167;Carrère;217;2;219
75;Nouvelle-Aquitaine;64;2;16;168;Carresse-Cassaber;664;15;679
75;Nouvelle-Aquitaine;64;2;16;170;Castagnède;201;1;202
75;Nouvelle-Aquitaine;64;3;02;171;Casteide-Cami;266;2;268
75;Nouvelle-Aquitaine;64;3;02;172;Casteide-Candau;312;3;315
75;Nouvelle-Aquitaine;64;3;23;173;Casteide-Doat;161;1;162
75;Nouvelle-Aquitaine;64;3;23;174;Castéra-Loubix;51;1;52
75;Nouvelle-Aquitaine;64;2;15;175;Castet;150;4;154
75;Nouvelle-Aquitaine;64;2;16;176;Castetbon;159;3;162
75;Nouvelle-Aquitaine;64;3;02;177;Castétis;636;26;662
75;Nouvelle-Aquitaine;64;2;09;178;Castetnau-Camblong;463;15;478
75;Nouvelle-Aquitaine;64;3;09;179;Castetner;134;6;140
75;Nouvelle-Aquitaine;64;3;25;180;Castetpugon;209;5;214
75;Nouvelle-Aquitaine;64;3;02;181;Castillon (Canton d'Arthez-de-Béarn);335;4;339
75;Nouvelle-Aquitaine;64;3;25;182;Castillon (Canton de Lembeye);71;2;73
75;Nouvelle-Aquitaine;64;3;25;183;Caubios-Loos;626;19;645
75;Nouvelle-Aquitaine;64;3;02;184;Cescau;619;28;647
75;Nouvelle-Aquitaine;64;2;14;185;Cette-Eygun;60;1;61
75;Nouvelle-Aquitaine;64;2;09;186;Charre;218;3;221
75;Nouvelle-Aquitaine;64;2;12;187;Charritte-de-Bas;251;8;259
75;Nouvelle-Aquitaine;64;2;12;188;Chéraute;1067;158;1225
75;Nouvelle-Aquitaine;64;1;24;189;Ciboure;6109;132;6241
75;Nouvelle-Aquitaine;64;3;25;190;Claracq;240;9;249
75;Nouvelle-Aquitaine;64;3;27;191;Coarraze;2168;141;2309
75;Nouvelle-Aquitaine;64;3;25;192;Conchez-de-Béarn;111;0;111
75;Nouvelle-Aquitaine;64;3;25;193;Corbère-Abères;97;2;99
75;Nouvelle-Aquitaine;64;3;25;194;Coslédaà-Lube-Boast;376;10;386
75;Nouvelle-Aquitaine;64;3;02;195;Coublucq;92;2;94
75;Nouvelle-Aquitaine;64;3;25;196;Crouseilles;120;3;123
75;Nouvelle-Aquitaine;64;3;09;197;Cuqueron;189;5;194
75;Nouvelle-Aquitaine;64;3;02;198;Denguin;1775;50;1825
75;Nouvelle-Aquitaine;64;3;25;199;Diusse;141;4;145
75;Nouvelle-Aquitaine;64;3;02;200;Doazon;178;3;181
75;Nouvelle-Aquitaine;64;2;09;201;Dognen;229;8;237
75;Nouvelle-Aquitaine;64;1;22;202;Domezain-Berraute;464;13;477
75;Nouvelle-Aquitaine;64;3;25;203;Doumy;322;6;328
75;Nouvelle-Aquitaine;64;2;15;204;Eaux-Bonnes;191;3;194
75;Nouvelle-Aquitaine;64;2;16;205;Escos;237;2;239
75;Nouvelle-Aquitaine;64;2;14;206;Escot;122;1;123
75;Nouvelle-Aquitaine;64;2;15;207;Escou;428;12;440
75;Nouvelle-Aquitaine;64;3;23;208;Escoubès;427;8;435
75;Nouvelle-Aquitaine;64;2;15;209;Escout;435;8;443
75;Nouvelle-Aquitaine;64;3;25;210;Escurès;143;1;144
75;Nouvelle-Aquitaine;64;3;23;211;Eslourenties-Daban;369;4;373
75;Nouvelle-Aquitaine;64;3;23;212;Espéchède;141;2;143
75;Nouvelle-Aquitaine;64;1;03;213;Espelette;2036;48;2084
75;Nouvelle-Aquitaine;64;2;12;214;Espès-Undurein;490;15;505
75;Nouvelle-Aquitaine;64;2;16;215;Espiute;104;3;107
75;Nouvelle-Aquitaine;64;3;27;216;Espoey;1195;47;1242
75;Nouvelle-Aquitaine;64;2;14;217;Esquiule;536;12;548
75;Nouvelle-Aquitaine;64;1;12;218;Estérençuby;319;2;321
75;Nouvelle-Aquitaine;64;2;15;219;Estialescq;259;6;265
75;Nouvelle-Aquitaine;64;2;15;220;Estos;495;11;506
75;Nouvelle-Aquitaine;64;1;22;221;Etcharry;154;29;183
75;Nouvelle-Aquitaine;64;2;12;222;Etchebar;75;0;75
75;Nouvelle-Aquitaine;64;2;14;223;Etsaut;55;2;57
75;Nouvelle-Aquitaine;64;2;14;224;Eysus;632;18;650
75;Nouvelle-Aquitaine;64;2;14;225;Ance Féas;615;14;629
75;Nouvelle-Aquitaine;64;3;02;226;Fichous-Riumayou;186;2;188
75;Nouvelle-Aquitaine;64;3;23;227;Gabaston;667;14;681
75;Nouvelle-Aquitaine;64;1;22;228;Gabat;273;2;275
75;Nouvelle-Aquitaine;64;1;12;229;Gamarthe;130;5;135
75;Nouvelle-Aquitaine;64;3;17;230;Gan;5594;111;5705
75;Nouvelle-Aquitaine;64;2;12;231;Garindein;485;9;494
75;Nouvelle-Aquitaine;64;3;25;232;Garlède-Mondebat;220;2;222
75;Nouvelle-Aquitaine;64;3;25;233;Garlin;1351;24;1375
75;Nouvelle-Aquitaine;64;3;02;234;Garos;264;8;272
75;Nouvelle-Aquitaine;64;1;22;235;Garris;293;7;300
75;Nouvelle-Aquitaine;64;3;25;236;Gayon;55;1;56
75;Nouvelle-Aquitaine;64;3;21;237;Gelos;3639;129;3768
75;Nouvelle-Aquitaine;64;3;27;238;Ger;2004;52;2056
75;Nouvelle-Aquitaine;64;3;25;239;Gerderest;138;1;139
75;Nouvelle-Aquitaine;64;2;15;240;Gère-Bélesten;179;7;186
75;Nouvelle-Aquitaine;64;2;14;241;Géronce;478;9;487
75;Nouvelle-Aquitaine;64;2;09;242;Gestas;76;0;76
75;Nouvelle-Aquitaine;64;3;02;243;Géus-d'Arzacq;203;3;206
75;Nouvelle-Aquitaine;64;2;14;244;Geüs-d'Oloron;259;10;269
75;Nouvelle-Aquitaine;64;2;15;245;Goès;552;13;565
75;Nouvelle-Aquitaine;64;3;27;246;Gomer;301;7;308
75;Nouvelle-Aquitaine;64;2;12;247;Gotein-Libarrenx;472;13;485
75;Nouvelle-Aquitaine;64;1;24;249;Guéthary;1328;37;1365
75;Nouvelle-Aquitaine;64;1;13;250;Guiche;1006;31;1037
75;Nouvelle-Aquitaine;64;2;16;251;Guinarthe-Parenties;222;9;231
75;Nouvelle-Aquitaine;64;2;14;252;Gurmençon;878;27;905
75;Nouvelle-Aquitaine;64;2;09;253;Gurs;417;10;427
75;Nouvelle-Aquitaine;64;3;02;254;Hagetaubin;578;17;595
75;Nouvelle-Aquitaine;64;1;03;255;Halsou;637;6;643
75;Nouvelle-Aquitaine;64;1;03;256;Hasparren;7538;270;7808
75;Nouvelle-Aquitaine;64;3;17;257;Haut-de-Bosdarros;341;3;344
75;Nouvelle-Aquitaine;64;2;12;258;Haux;85;1;86
75;Nouvelle-Aquitaine;64;1;22;259;Hélette;747;16;763
75;Nouvelle-Aquitaine;64;1;10;260;Hendaye;17621;450;18071
75;Nouvelle-Aquitaine;64;2;15;261;Herrère;389;6;395
75;Nouvelle-Aquitaine;64;3;23;262;Higuères-Souye;276;6;282
75;Nouvelle-Aquitaine;64;2;16;263;L'Hôpital-d'Orion;128;4;132
75;Nouvelle-Aquitaine;64;2;12;264;L'Hôpital-Saint-Blaise;59;2;61
75;Nouvelle-Aquitaine;64;1;22;265;Hosta;100;0;100
75;Nouvelle-Aquitaine;64;3;27;266;Hours;231;9;240
75;Nouvelle-Aquitaine;64;1;22;267;Ibarrolle;75;1;76
75;Nouvelle-Aquitaine;64;2;12;268;Idaux-Mendy;275;4;279
75;Nouvelle-Aquitaine;64;3;19;269;Idron;4915;163;5078
75;Nouvelle-Aquitaine;64;3;27;270;Igon;986;49;1035
75;Nouvelle-Aquitaine;64;1;22;271;Iholdy;538;17;555
75;Nouvelle-Aquitaine;64;1;22;272;Ilharre;147;1;148
75;Nouvelle-Aquitaine;64;1;22;273;Irissarry;921;13;934
75;Nouvelle-Aquitaine;64;1;12;274;Irouléguy;367;2;369
75;Nouvelle-Aquitaine;64;1;12;275;Ispoure;674;13;687
75;Nouvelle-Aquitaine;64;2;14;276;Issor;236;6;242
75;Nouvelle-Aquitaine;64;1;22;277;Isturits;518;13;531
75;Nouvelle-Aquitaine;64;1;03;279;Itxassou;2163;67;2230
75;Nouvelle-Aquitaine;64;2;15;280;Izeste;435;3;438
75;Nouvelle-Aquitaine;64;2;09;281;Jasses;146;3;149
75;Nouvelle-Aquitaine;64;1;03;282;Jatxou;1176;30;1206
75;Nouvelle-Aquitaine;64;1;12;283;Jaxu;201;1;202
75;Nouvelle-Aquitaine;64;3;08;284;Jurançon;7083;237;7320
75;Nouvelle-Aquitaine;64;1;22;285;Juxue;204;8;212
75;Nouvelle-Aquitaine;64;3;09;286;Laà-Mondrans;437;13;450
75;Nouvelle-Aquitaine;64;2;16;287;Laàs;139;3;142
75;Nouvelle-Aquitaine;64;3;02;288;Labastide-Cézéracq;557;14;571
75;Nouvelle-Aquitaine;64;1;22;289;La Bastide-Clairence;969;24;993
75;Nouvelle-Aquitaine;64;3;02;290;Labastide-Monréjeau;599;17;616
75;Nouvelle-Aquitaine;64;2;16;291;Labastide-Villefranche;318;6;324
75;Nouvelle-Aquitaine;64;3;27;292;Labatmale;260;2;262
75;Nouvelle-Aquitaine;64;3;23;293;Labatut-Figuières;169;2;171
75;Nouvelle-Aquitaine;64;1;22;294;Labets-Biscay;154;2;156
75;Nouvelle-Aquitaine;64;3;02;295;Labeyrie;111;3;114
75;Nouvelle-Aquitaine;64;3;02;296;Lacadée;148;5;153
75;Nouvelle-Aquitaine;64;1;12;297;Lacarre;179;4;183
75;Nouvelle-Aquitaine;64;2;12;298;Lacarry-Arhan-Charritte-de-Haut;131;0;131
75;Nouvelle-Aquitaine;64;3;09;299;Lacommande;183;7;190
75;Nouvelle-Aquitaine;64;3;02;300;Lacq;729;14;743
75;Nouvelle-Aquitaine;64;3;09;301;Lagor;1140;30;1170
75;Nouvelle-Aquitaine;64;3;27;302;Lagos;465;11;476
75;Nouvelle-Aquitaine;64;2;12;303;Laguinge-Restoue;156;8;164
75;Nouvelle-Aquitaine;64;1;13;304;Lahonce;2549;57;2606
75;Nouvelle-Aquitaine;64;2;16;305;Lahontan;522;12;534
75;Nouvelle-Aquitaine;64;3;09;306;Lahourcade;702;20;722
75;Nouvelle-Aquitaine;64;3;25;307;Lalongue;206;3;209
75;Nouvelle-Aquitaine;64;3;25;308;Lalonquette;262;5;267
75;Nouvelle-Aquitaine;64;3;23;309;Lamayou;208;5;213
75;Nouvelle-Aquitaine;64;2;14;310;Lanne-en-Barétous;489;8;497
75;Nouvelle-Aquitaine;64;3;25;311;Lannecaube;152;3;155
75;Nouvelle-Aquitaine;64;3;16;312;Lanneplaà;304;9;313
75;Nouvelle-Aquitaine;64;1;22;313;Lantabat;280;5;285
75;Nouvelle-Aquitaine;64;1;22;314;Larceveau-Arros-Cibits;441;3;444
75;Nouvelle-Aquitaine;64;3;08;315;Laroin;1088;29;1117
75;Nouvelle-Aquitaine;64;2;12;316;Larrau;194;2;196
75;Nouvelle-Aquitaine;64;1;03;317;Larressore;2134;51;2185
75;Nouvelle-Aquitaine;64;3;02;318;Larreule;185;2;187
75;Nouvelle-Aquitaine;64;1;22;319;Larribar-Sorhapuru;181;0;181
75;Nouvelle-Aquitaine;64;2;15;320;Laruns;1181;24;1205
75;Nouvelle-Aquitaine;64;3;25;321;Lasclaveries;244;2;246
75;Nouvelle-Aquitaine;64;1;12;322;Lasse;342;6;348
75;Nouvelle-Aquitaine;64;3;25;323;Lasserre;109;3;112
75;Nouvelle-Aquitaine;64;2;15;324;Lasseube;1746;51;1797
75;Nouvelle-Aquitaine;64;2;15;325;Lasseubetat;209;4;213
75;Nouvelle-Aquitaine;64;2;09;326;Lay-Lamidou;119;4;123
75;Nouvelle-Aquitaine;64;1;12;327;Lecumberry;170;5;175
75;Nouvelle-Aquitaine;64;2;15;328;Ledeuix;1025;31;1056
75;Nouvelle-Aquitaine;64;3;23;329;Lée;1257;60;1317
75;Nouvelle-Aquitaine;64;2;14;330;Lées-Athas;242;9;251
75;Nouvelle-Aquitaine;64;3;25;331;Lembeye;768;17;785
75;Nouvelle-Aquitaine;64;3;25;332;Lème;166;5;171
75;Nouvelle-Aquitaine;64;2;16;334;Léren;214;3;217
75;Nouvelle-Aquitaine;64;3;11;335;Lescar;9590;417;10007
75;Nouvelle-Aquitaine;64;2;14;336;Lescun;169;1;170
75;Nouvelle-Aquitaine;64;3;25;337;Lespielle;152;3;155
75;Nouvelle-Aquitaine;64;3;23;338;Lespourcy;188;6;194
75;Nouvelle-Aquitaine;64;3;27;339;Lestelle-Bétharram;821;81;902
75;Nouvelle-Aquitaine;64;2;12;340;Lichans-Sunhar;86;1;87
75;Nouvelle-Aquitaine;64;2;12;341;Lichos;136;1;137
75;Nouvelle-Aquitaine;64;2;12;342;Licq-Athérey;198;7;205
75;Nouvelle-Aquitaine;64;3;27;343;Limendous;743;8;751
75;Nouvelle-Aquitaine;64;3;27;344;Livron;374;15;389
75;Nouvelle-Aquitaine;64;1;22;345;Lohitzun-Oyhercq;200;5;205
75;Nouvelle-Aquitaine;64;3;23;346;Lombia;209;1;210
75;Nouvelle-Aquitaine;64;3;02;347;Lonçon;213;3;216
75;Nouvelle-Aquitaine;64;3;11;348;Lons;13843;278;14121
75;Nouvelle-Aquitaine;64;3;09;349;Loubieng;497;18;515
75;Nouvelle-Aquitaine;64;1;03;350;Louhossoa;864;19;883
75;Nouvelle-Aquitaine;64;2;14;351;Lourdios-Ichère;134;9;143
75;Nouvelle-Aquitaine;64;3;27;352;Lourenties;405;11;416
75;Nouvelle-Aquitaine;64;2;15;353;Louvie-Juzon;1052;40;1092
75;Nouvelle-Aquitaine;64;2;15;354;Louvie-Soubiron;124;1;125
75;Nouvelle-Aquitaine;64;3;02;355;Louvigny;138;2;140
75;Nouvelle-Aquitaine;64;3;25;356;Luc-Armau;109;0;109
75;Nouvelle-Aquitaine;64;3;25;357;Lucarré;63;0;63
75;Nouvelle-Aquitaine;64;3;27;358;Lucgarier;249;2;251
75;Nouvelle-Aquitaine;64;3;09;359;Lucq-de-Béarn;921;30;951
75;Nouvelle-Aquitaine;64;2;14;360;Lurbe-Saint-Christau;196;8;204
75;Nouvelle-Aquitaine;64;3;25;361;Lussagnet-Lusson;182;7;189
75;Nouvelle-Aquitaine;64;1;22;362;Luxe-Sumberraute;412;23;435
75;Nouvelle-Aquitaine;64;2;15;363;Lys;325;3;328
75;Nouvelle-Aquitaine;64;1;03;364;Macaye;582;10;592
75;Nouvelle-Aquitaine;64;3;02;365;Malaussanne;420;8;428
75;Nouvelle-Aquitaine;64;3;25;366;Mascaraàs-Haron;120;1;121
75;Nouvelle-Aquitaine;64;3;09;367;Maslacq;881;25;906
75;Nouvelle-Aquitaine;64;1;22;368;Masparraute;253;8;261
75;Nouvelle-Aquitaine;64;3;25;369;Maspie-Lalonquère-Juillacq;244;11;255
75;Nouvelle-Aquitaine;64;3;23;370;Maucor;566;16;582
75;Nouvelle-Aquitaine;64;2;12;371;Mauléon-Licharre;2953;236;3189
75;Nouvelle-Aquitaine;64;3;23;372;Maure;91;1;92
75;Nouvelle-Aquitaine;64;3;20;373;Mazères-Lezons;1817;41;1858
75;Nouvelle-Aquitaine;64;3;02;374;Mazerolles;1155;24;1179
75;Nouvelle-Aquitaine;64;1;22;375;Méharin;284;4;288
75;Nouvelle-Aquitaine;64;3;17;376;Meillon;935;26;961
75;Nouvelle-Aquitaine;64;1;22;377;Mendionde;836;24;860
75;Nouvelle-Aquitaine;64;2;12;378;Menditte;204;128;332
75;Nouvelle-Aquitaine;64;1;12;379;Mendive;156;5;161
75;Nouvelle-Aquitaine;64;3;02;380;Méracq;233;5;238
75;Nouvelle-Aquitaine;64;2;09;381;Méritein;279;9;288
75;Nouvelle-Aquitaine;64;3;02;382;Mesplède;334;9;343
75;Nouvelle-Aquitaine;64;3;02;383;Mialos;137;1;138
75;Nouvelle-Aquitaine;64;3;25;385;Miossens-Lanusse;277;7;284
75;Nouvelle-Aquitaine;64;3;27;386;Mirepeix;1250;25;1275
75;Nouvelle-Aquitaine;64;3;02;387;Momas;627;12;639
75;Nouvelle-Aquitaine;64;3;23;388;Momy;114;1;115
75;Nouvelle-Aquitaine;64;3;25;389;Monassut-Audiracq;369;6;375
75;Nouvelle-Aquitaine;64;3;25;390;Moncaup;157;12;169
75;Nouvelle-Aquitaine;64;2;12;391;Moncayolle-Larrory-Mendibieu;300;9;309
75;Nouvelle-Aquitaine;64;3;25;392;Moncla;81;2;83
75;Nouvelle-Aquitaine;64;3;09;393;Monein;4417;103;4520
75;Nouvelle-Aquitaine;64;3;25;394;Monpezat;84;2;86
75;Nouvelle-Aquitaine;64;3;23;395;Monségur;127;1;128
75;Nouvelle-Aquitaine;64;3;02;396;Mont;1131;94;1225
75;Nouvelle-Aquitaine;64;3;02;397;Montagut;119;6;125
75;Nouvelle-Aquitaine;64;3;23;398;Montaner;433;9;442
75;Nouvelle-Aquitaine;64;3;25;399;Montardon;2340;304;2644
75;Nouvelle-Aquitaine;64;3;27;400;Montaut;1109;45;1154
75;Nouvelle-Aquitaine;64;3;25;401;Mont-Disse;81;1;82
75;Nouvelle-Aquitaine;64;2;16;403;Montfort;176;3;179
75;Nouvelle-Aquitaine;64;2;12;404;Montory;311;8;319
75;Nouvelle-Aquitaine;64;3;23;405;Morlaàs;4353;234;4587
75;Nouvelle-Aquitaine;64;3;02;406;Morlanne;614;16;630
75;Nouvelle-Aquitaine;64;1;13;407;Mouguerre;5299;149;5448
75;Nouvelle-Aquitaine;64;3;25;408;Mouhous;62;0;62
75;Nouvelle-Aquitaine;64;2;14;409;Moumour;826;22;848
75;Nouvelle-Aquitaine;64;3;09;410;Mourenx;5903;172;6075
75;Nouvelle-Aquitaine;64;2;12;411;Musculdy;234;3;237
75;Nouvelle-Aquitaine;64;2;09;412;Nabas;88;1;89
75;Nouvelle-Aquitaine;64;3;17;413;Narcastet;765;12;777
75;Nouvelle-Aquitaine;64;2;16;414;Narp;116;4;120
75;Nouvelle-Aquitaine;64;3;25;415;Navailles-Angos;1523;33;1556
75;Nouvelle-Aquitaine;64;2;09;416;Navarrenx;1053;23;1076
75;Nouvelle-Aquitaine;64;3;17;417;Nay;3245;219;3464
75;Nouvelle-Aquitaine;64;3;09;418;Noguères;137;3;140
75;Nouvelle-Aquitaine;64;3;27;419;Nousty;1596;30;1626
75;Nouvelle-Aquitaine;64;2;09;420;Ogenne-Camptort;245;5;250
75;Nouvelle-Aquitaine;64;2;15;421;Ogeu-les-Bains;1275;29;1304
75;Nouvelle-Aquitaine;64;2;98;422;Oloron-Sainte-Marie;10653;656;11309
75;Nouvelle-Aquitaine;64;2;16;423;Oraàs;184;3;187
75;Nouvelle-Aquitaine;64;2;12;424;Ordiarp;543;4;547
75;Nouvelle-Aquitaine;64;1;22;425;Orègue;490;9;499
75;Nouvelle-Aquitaine;64;2;14;426;Orin;262;11;273
75;Nouvelle-Aquitaine;64;2;16;427;Orion;150;2;152
75;Nouvelle-Aquitaine;64;2;16;428;Orriule;143;1;144
75;Nouvelle-Aquitaine;64;1;22;429;Orsanco;110;2;112
75;Nouvelle-Aquitaine;64;3;16;430;Orthez;10466;640;11106
75;Nouvelle-Aquitaine;64;3;09;431;Os-Marsillon;537;9;546
75;Nouvelle-Aquitaine;64;2;12;432;Ossas-Suhare;86;1;87
75;Nouvelle-Aquitaine;64;2;14;433;Osse-en-Aspe;333;19;352
75;Nouvelle-Aquitaine;64;2;16;434;Ossenx;49;0;49
75;Nouvelle-Aquitaine;64;1;22;435;Osserain-Rivareyte;214;10;224
75;Nouvelle-Aquitaine;64;1;12;436;Ossès;837;18;855
75;Nouvelle-Aquitaine;64;1;22;437;Ostabat-Asme;205;7;212
75;Nouvelle-Aquitaine;64;3;23;438;Ouillon;545;15;560
75;Nouvelle-Aquitaine;64;3;23;439;Ousse;1672;51;1723
75;Nouvelle-Aquitaine;64;3;09;440;Ozenx-Montestrucq;389;17;406
75;Nouvelle-Aquitaine;64;1;22;441;Pagolle;261;5;266
75;Nouvelle-Aquitaine;64;3;09;442;Parbayse;330;7;337
75;Nouvelle-Aquitaine;64;3;09;443;Pardies;898;24;922
75;Nouvelle-Aquitaine;64;3;17;444;Pardies-Piétat;468;11;479
75;Nouvelle-Aquitaine;64;3;99;445;Pau;75665;1396;77061
75;Nouvelle-Aquitaine;64;3;25;446;Peyrelongue-Abos;159;1;160
75;Nouvelle-Aquitaine;64;3;02;447;Piets-Plasence-Moustrou;140;1;141
75;Nouvelle-Aquitaine;64;3;11;448;Poey-de-Lescar;1818;50;1868
75;Nouvelle-Aquitaine;64;2;15;449;Poey-d'Oloron;163;2;165
75;Nouvelle-Aquitaine;64;3;02;450;Pomps;297;4;301
75;Nouvelle-Aquitaine;64;3;23;451;Ponson-Debat-Pouts;97;3;100
75;Nouvelle-Aquitaine;64;3;27;452;Ponson-Dessus;259;7;266
75;Nouvelle-Aquitaine;64;3;27;453;Pontacq;2921;57;2978
75;Nouvelle-Aquitaine;64;3;23;454;Pontiacq-Viellepinte;187;2;189
75;Nouvelle-Aquitaine;64;3;25;455;Portet;165;3;168
75;Nouvelle-Aquitaine;64;3;25;456;Pouliacq;49;3;52
75;Nouvelle-Aquitaine;64;3;02;457;Poursiugues-Boucoue;185;5;190
75;Nouvelle-Aquitaine;64;2;14;458;Préchacq-Josbaig;295;8;303
75;Nouvelle-Aquitaine;64;2;09;459;Préchacq-Navarrenx;176;2;178
75;Nouvelle-Aquitaine;64;2;15;460;Précilhon;400;7;407
75;Nouvelle-Aquitaine;64;3;16;461;Puyoô;1108;22;1130
75;Nouvelle-Aquitaine;64;3;16;462;Ramous;491;6;497
75;Nouvelle-Aquitaine;64;2;15;463;Rébénacq;653;6;659
75;Nouvelle-Aquitaine;64;3;25;464;Ribarrouy;82;1;83
75;Nouvelle-Aquitaine;64;3;23;465;Riupeyrous;228;1;229
75;Nouvelle-Aquitaine;64;2;09;466;Rivehaute;270;7;277
75;Nouvelle-Aquitaine;64;3;17;467;Rontignon;855;17;872
75;Nouvelle-Aquitaine;64;2;12;468;Roquiague;121;2;123
75;Nouvelle-Aquitaine;64;3;17;469;Saint-Abit;308;8;316
75;Nouvelle-Aquitaine;64;3;23;470;Saint-Armou;640;11;651
75;Nouvelle-Aquitaine;64;3;16;471;Saint-Boès;358;12;370
75;Nouvelle-Aquitaine;64;3;23;472;Saint-Castin;855;11;866
75;Nouvelle-Aquitaine;64;2;15;473;Sainte-Colome;360;4;364
75;Nouvelle-Aquitaine;64;2;16;474;Saint-Dos;157;3;160
75;Nouvelle-Aquitaine;64;2;12;475;Sainte-Engrâce;187;4;191
75;Nouvelle-Aquitaine;64;1;22;476;Saint-Esteben;421;8;429
75;Nouvelle-Aquitaine;64;1;12;477;Saint-Étienne-de-Baïgorry;1499;33;1532
75;Nouvelle-Aquitaine;64;3;08;478;Saint-Faust;743;25;768
75;Nouvelle-Aquitaine;64;3;16;479;Saint-Girons-en-Béarn;166;4;170
75;Nouvelle-Aquitaine;64;2;16;480;Saint-Gladie-Arrive-Munein;198;5;203
75;Nouvelle-Aquitaine;64;2;14;481;Saint-Goin;232;4;236
75;Nouvelle-Aquitaine;64;3;23;482;Saint-Jammes;617;8;625
75;Nouvelle-Aquitaine;64;1;24;483;Saint-Jean-de-Luz;14282;420;14702
75;Nouvelle-Aquitaine;64;1;12;484;Saint-Jean-le-Vieux;831;18;849
75;Nouvelle-Aquitaine;64;1;12;485;Saint-Jean-Pied-de-Port;1510;300;1810
75;Nouvelle-Aquitaine;64;3;25;486;Saint-Jean-Poudge;64;0;64
75;Nouvelle-Aquitaine;64;1;22;487;Saint-Just-Ibarre;201;6;207
75;Nouvelle-Aquitaine;64;3;23;488;Saint-Laurent-Bretagne;446;9;455
75;Nouvelle-Aquitaine;64;1;22;489;Saint-Martin-d'Arberoue;341;10;351
75;Nouvelle-Aquitaine;64;1;12;490;Saint-Martin-d'Arrossa;541;15;556
75;Nouvelle-Aquitaine;64;3;02;491;Saint-Médard;199;6;205
75;Nouvelle-Aquitaine;64;1;12;492;Saint-Michel;291;6;297
75;Nouvelle-Aquitaine;64;1;22;493;Saint-Palais;1948;75;2023
75;Nouvelle-Aquitaine;64;2;16;494;Saint-Pé-de-Léren;261;6;267
75;Nouvelle-Aquitaine;64;1;26;495;Saint-Pée-sur-Nivelle;7102;185;7287
75;Nouvelle-Aquitaine;64;1;13;496;Saint-Pierre-d'Irube;5814;103;5917
75;Nouvelle-Aquitaine;64;3;27;498;Saint-Vincent;393;10;403
75;Nouvelle-Aquitaine;64;2;16;499;Salies-de-Béarn;4555;129;4684
75;Nouvelle-Aquitaine;64;3;16;500;Salles-Mongiscard;302;7;309
75;Nouvelle-Aquitaine;64;3;02;501;Sallespisse;569;8;577
75;Nouvelle-Aquitaine;64;1;13;502;Sames;707;22;729
75;Nouvelle-Aquitaine;64;3;25;503;Samsons-Lion;92;3;95
75;Nouvelle-Aquitaine;64;1;26;504;Sare;2705;37;2742
75;Nouvelle-Aquitaine;64;3;09;505;Sarpourenx;296;13;309
75;Nouvelle-Aquitaine;64;2;14;506;Sarrance;159;2;161
75;Nouvelle-Aquitaine;64;3;23;507;Saubole;137;3;140
75;Nouvelle-Aquitaine;64;2;15;508;Saucède;130;3;133
75;Nouvelle-Aquitaine;64;2;12;509;Sauguis-Saint-Étienne;173;4;177
75;Nouvelle-Aquitaine;64;3;02;510;Sault-de-Navailles;946;19;965
75;Nouvelle-Aquitaine;64;3;25;511;Sauvagnon;3460;87;3547
75;Nouvelle-Aquitaine;64;3;09;512;Sauvelade;267;4;271
75;Nouvelle-Aquitaine;64;2;16;513;Sauveterre-de-Béarn;1369;98;1467
75;Nouvelle-Aquitaine;64;3;02;514;Séby;201;0;201
75;Nouvelle-Aquitaine;64;3;23;515;Sedze-Maubecq;240;5;245
75;Nouvelle-Aquitaine;64;3;23;516;Sedzère;383;3;386
75;Nouvelle-Aquitaine;64;3;25;517;Séméacq-Blachon;159;9;168
75;Nouvelle-Aquitaine;64;3;23;518;Sendets;1126;22;1148
75;Nouvelle-Aquitaine;64;3;25;519;Serres-Castet;4393;126;4519
75;Nouvelle-Aquitaine;64;3;23;520;Serres-Morlaàs;827;33;860
75;Nouvelle-Aquitaine;64;3;02;521;Serres-Sainte-Marie;561;17;578
75;Nouvelle-Aquitaine;64;2;15;522;Sévignacq-Meyracq;544;10;554
75;Nouvelle-Aquitaine;64;3;25;523;Sévignacq;778;15;793
75;Nouvelle-Aquitaine;64;3;25;524;Simacourbe;418;3;421
75;Nouvelle-Aquitaine;64;3;11;525;Siros;804;10;814
75;Nouvelle-Aquitaine;64;3;27;526;Soumoulou;1584;19;1603
75;Nouvelle-Aquitaine;64;1;03;527;Souraïde;1523;28;1551
75;Nouvelle-Aquitaine;64;1;22;528;Suhescun;166;8;174
75;Nouvelle-Aquitaine;64;2;09;529;Sus;375;10;385
75;Nouvelle-Aquitaine;64;2;09;530;Susmiou;357;7;364
75;Nouvelle-Aquitaine;64;2;16;531;Tabaille-Usquain;46;0;46
75;Nouvelle-Aquitaine;64;3;25;532;Tadousse-Ussau;71;1;72
75;Nouvelle-Aquitaine;64;2;12;533;Tardets-Sorholus;566;10;576
75;Nouvelle-Aquitaine;64;3;25;534;Taron-Sadirac-Viellenave;184;3;187
75;Nouvelle-Aquitaine;64;3;09;535;Tarsacq;532;6;538
75;Nouvelle-Aquitaine;64;3;25;536;Thèze;872;16;888
75;Nouvelle-Aquitaine;64;2;12;537;Trois-Villes;127;4;131
75;Nouvelle-Aquitaine;64;1;12;538;Uhart-Cize;801;16;817
75;Nouvelle-Aquitaine;64;1;22;539;Uhart-Mixe;212;5;217
75;Nouvelle-Aquitaine;64;1;13;540;Urcuit;2845;75;2920
75;Nouvelle-Aquitaine;64;3;02;541;Urdès;308;2;310
75;Nouvelle-Aquitaine;64;2;14;542;Urdos;67;1;68
75;Nouvelle-Aquitaine;64;1;12;543;Urepel;276;7;283
75;Nouvelle-Aquitaine;64;3;23;544;Urost;76;2;78
75;Nouvelle-Aquitaine;64;1;10;545;Urrugne;10495;161;10656
75;Nouvelle-Aquitaine;64;1;13;546;Urt;2340;34;2374
75;Nouvelle-Aquitaine;64;1;26;547;Ustaritz;7399;274;7673
75;Nouvelle-Aquitaine;64;3;02;548;Uzan;164;4;168
75;Nouvelle-Aquitaine;64;3;11;549;Uzein;1258;20;1278
75;Nouvelle-Aquitaine;64;3;17;550;Uzos;825;33;858
75;Nouvelle-Aquitaine;64;2;15;551;Verdets;291;4;295
75;Nouvelle-Aquitaine;64;3;25;552;Vialer;173;8;181
75;Nouvelle-Aquitaine;64;3;02;554;Viellenave-d'Arthez;214;3;217
75;Nouvelle-Aquitaine;64;2;09;555;Viellenave-de-Navarrenx;169;2;171
75;Nouvelle-Aquitaine;64;3;09;556;Vielleségure;386;8;394
75;Nouvelle-Aquitaine;64;3;02;557;Vignes;451;21;472
75;Nouvelle-Aquitaine;64;1;13;558;Villefranque;2836;78;2914
75;Nouvelle-Aquitaine;64;2;12;559;Viodos-Abense-de-Bas;736;17;753
75;Nouvelle-Aquitaine;64;3;25;560;Viven;177;0;177
76;Occitanie;65;1;16;001;Adast;298;7;305
76;Occitanie;65;1;06;002;Adé;826;10;836
76;Occitanie;65;2;08;003;Adervielle-Pouchergues;147;1;148
76;Occitanie;65;1;16;004;Agos-Vidalos;406;10;416
76;Occitanie;65;3;07;005;Allier;435;11;446
76;Occitanie;65;2;08;006;Ancizan;268;8;276
76;Occitanie;65;3;17;007;Andrest;1371;26;1397
76;Occitanie;65;2;15;009;Anères;171;6;177
76;Occitanie;65;3;07;010;Angos;222;4;226
76;Occitanie;65;1;06;011;Les Angles;131;5;136
76;Occitanie;65;2;15;012;Anla;78;2;80
76;Occitanie;65;3;13;013;Ansost;57;2;59
76;Occitanie;65;2;15;014;Antichan;40;0;40
76;Occitanie;65;3;03;015;Antin;101;5;106
76;Occitanie;65;2;04;016;Antist;184;3;187
76;Occitanie;65;2;08;017;Aragnouet;249;2;251
76;Occitanie;65;1;16;018;Arbéost;82;1;83
76;Occitanie;65;3;07;019;Arcizac-Adour;572;12;584
76;Occitanie;65;1;06;020;Arcizac-ez-Angles;264;5;269
76;Occitanie;65;1;16;021;Arcizans-Avant;389;8;397
76;Occitanie;65;1;16;022;Arcizans-Dessus;114;7;121
76;Occitanie;65;2;08;023;Ardengost;12;0;12
76;Occitanie;65;2;14;024;Argelès-Bagnères;103;2;105
76;Occitanie;65;1;16;025;Argelès-Gazost;2897;172;3069
76;Occitanie;65;3;03;026;Aries-Espénan;76;0;76
76;Occitanie;65;2;15;028;Arné;198;8;206
76;Occitanie;65;1;16;029;Arras-en-Lavedan;488;11;499
76;Occitanie;65;2;08;031;Arreau;772;16;788
76;Occitanie;65;1;16;032;Arrens-Marsous;687;20;707
76;Occitanie;65;1;06;033;Arrodets-ez-Angles;115;3;118
76;Occitanie;65;2;14;034;Arrodets;21;1;22
76;Occitanie;65;3;17;035;Artagnan;515;18;533
76;Occitanie;65;1;16;036;Artalens-Souin;131;3;134
76;Occitanie;65;2;14;037;Artiguemy;87;1;88
76;Occitanie;65;1;06;038;Artigues;14;1;15
76;Occitanie;65;2;08;039;Aspin-Aure;40;0;40
76;Occitanie;65;1;05;040;Aspin-en-Lavedan;315;3;318
76;Occitanie;65;2;14;041;Asque;120;7;127
76;Occitanie;65;2;04;042;Asté;581;12;593
76;Occitanie;65;2;04;043;Astugue;265;7;272
76;Occitanie;65;3;03;044;Aubarède;292;6;298
76;Occitanie;65;1;16;045;Aucun;227;9;236
76;Occitanie;65;2;08;046;Aulon;98;3;101
76;Occitanie;65;3;01;047;Aureilhan;7932;168;8100
76;Occitanie;65;3;17;048;Aurensan;783;16;799
76;Occitanie;65;3;13;049;Auriébat;242;3;245
76;Occitanie;65;2;08;050;Avajan;80;2;82
76;Occitanie;65;2;15;051;Aventignan;208;4;212
76;Occitanie;65;3;09;052;Averan;73;0;73
76;Occitanie;65;2;15;053;Aveux;42;1;43
76;Occitanie;65;2;08;054;Avezac-Prat-Lahitte;601;11;612
76;Occitanie;65;1;16;055;Ayros-Arbouix;344;12;356
76;Occitanie;65;1;16;056;Ayzac-Ost;452;13;465
76;Occitanie;65;3;09;057;Azereix;979;20;999
76;Occitanie;65;2;08;058;Azet;143;1;144
76;Occitanie;65;2;04;059;Bagnères-de-Bigorre;7034;284;7318
76;Occitanie;65;2;14;060;Banios;63;3;66
76;Occitanie;65;3;13;061;Barbachen;48;3;51
76;Occitanie;65;3;07;062;Barbazan-Debat;3497;75;3572
76;Occitanie;65;3;14;063;Barbazan-Dessus;172;3;175
76;Occitanie;65;2;08;064;Bareilles;46;1;47
76;Occitanie;65;1;05;065;Barlest;292;8;300
76;Occitanie;65;2;08;066;Barrancoueu;33;0;33
76;Occitanie;65;3;09;067;Barry;130;7;137
76;Occitanie;65;3;03;068;Barthe;24;1;25
76;Occitanie;65;2;08;069;La Barthe-de-Neste;1230;30;1260
76;Occitanie;65;1;05;070;Bartrès;560;18;578
76;Occitanie;65;2;14;071;Batsère;32;0;32
76;Occitanie;65;3;02;072;Bazet;1849;15;1864
76;Occitanie;65;3;13;073;Bazillac;359;7;366
76;Occitanie;65;3;03;074;Bazordan;108;2;110
76;Occitanie;65;2;08;075;Bazus-Aure;137;6;143
76;Occitanie;65;2;08;076;Bazus-Neste;61;1;62
76;Occitanie;65;1;16;077;Beaucens;423;24;447
76;Occitanie;65;2;04;078;Beaudéan;402;10;412
76;Occitanie;65;3;14;079;Bégole;195;4;199
76;Occitanie;65;3;09;080;Bénac;546;16;562
76;Occitanie;65;2;14;081;Benqué-Molère;136;3;139
76;Occitanie;65;1;06;082;Berbérust-Lias;49;1;50
76;Occitanie;65;3;07;083;Bernac-Debat;724;17;741
76;Occitanie;65;3;07;084;Bernac-Dessus;286;3;289
76;Occitanie;65;3;03;085;Bernadets-Debat;107;5;112
76;Occitanie;65;3;14;086;Bernadets-Dessus;149;6;155
76;Occitanie;65;2;15;087;Bertren;169;6;175
76;Occitanie;65;3;03;088;Betbèze;48;1;49
76;Occitanie;65;1;16;089;Betpouey;84;4;88
76;Occitanie;65;3;03;090;Betpouy;77;3;80
76;Occitanie;65;2;14;091;Bettes;59;1;60
76;Occitanie;65;2;08;092;Beyrède-Jumet-Camous;226;2;228
76;Occitanie;65;2;15;093;Bize;210;7;217
76;Occitanie;65;2;15;094;Bizous;128;1;129
76;Occitanie;65;3;03;095;Bonnefont;328;11;339
76;Occitanie;65;2;14;096;Bonnemazon;68;3;71
76;Occitanie;65;2;14;097;Bonrepos;191;8;199
76;Occitanie;65;1;16;098;Boô-Silhen;334;7;341
76;Occitanie;65;2;08;099;Bordères-Louron;139;3;142
76;Occitanie;65;3;02;100;Bordères-sur-l'Échez;5421;122;5543
76;Occitanie;65;3;14;101;Bordes;762;11;773
76;Occitanie;65;3;13;102;Bouilh-Devant;19;1;20
76;Occitanie;65;3;03;103;Bouilh-Péreuilh;111;1;112
76;Occitanie;65;3;03;104;Boulin;299;9;308
76;Occitanie;65;2;14;105;Bourg-de-Bigorre;196;1;197
76;Occitanie;65;2;08;106;Bourisp;173;3;176
76;Occitanie;65;1;06;107;Bourréac;112;2;114
76;Occitanie;65;3;02;108;Bours;880;19;899
76;Occitanie;65;2;15;109;Bramevaque;31;1;32
76;Occitanie;65;3;03;110;Bugard;96;0;96
76;Occitanie;65;2;14;111;Bulan;62;0;62
76;Occitanie;65;1;16;112;Bun;155;5;160
76;Occitanie;65;3;14;113;Burg;284;11;295
76;Occitanie;65;3;13;114;Buzon;77;2;79
76;Occitanie;65;3;03;115;Cabanac;294;8;302
76;Occitanie;65;2;08;116;Cadéac;298;5;303
76;Occitanie;65;2;08;117;Cadeilhan-Trachère;43;1;44
76;Occitanie;65;3;14;118;Caharet;36;0;36
76;Occitanie;65;3;17;119;Caixon;358;11;369
76;Occitanie;65;3;14;120;Calavanté;338;14;352
76;Occitanie;65;3;17;121;Camalès;388;12;400
76;Occitanie;65;2;04;123;Campan;1304;54;1358
76;Occitanie;65;2;08;124;Camparan;55;3;58
76;Occitanie;65;2;15;125;Campistrous;313;7;320
76;Occitanie;65;3;03;126;Campuzan;146;5;151
76;Occitanie;65;2;08;127;Capvern;1266;23;1289
76;Occitanie;65;2;14;128;Castelbajac;140;3;143
76;Occitanie;65;3;03;129;Castelnau-Magnoac;794;20;814
76;Occitanie;65;3;13;130;Castelnau-Rivière-Basse;625;5;630
76;Occitanie;65;3;03;131;Castelvieilh;244;2;246
76;Occitanie;65;3;14;132;Castéra-Lanusse;45;0;45
76;Occitanie;65;3;03;133;Castéra-Lou;234;4;238
76;Occitanie;65;3;03;134;Casterets;14;1;15
76;Occitanie;65;2;14;135;Castillon;82;0;82
76;Occitanie;65;3;03;136;Caubous;32;0;32
76;Occitanie;65;3;13;137;Caussade-Rivière;96;3;99
76;Occitanie;65;1;16;138;Cauterets;870;19;889
76;Occitanie;65;2;15;139;Cazarilh;53;2;55
76;Occitanie;65;2;08;140;Cazaux-Debat;31;1;32
76;Occitanie;65;2;08;141;Cazaux-Fréchet-Anéran-Camors;60;3;63
76;Occitanie;65;3;03;142;Chelle-Debat;211;4;215
76;Occitanie;65;2;14;143;Chelle-Spou;110;2;112
76;Occitanie;65;1;06;144;Cheust;87;1;88
76;Occitanie;65;1;16;145;Chèze;48;0;48
76;Occitanie;65;3;02;146;Chis;312;1;313
76;Occitanie;65;2;14;147;Cieutat;612;12;624
76;Occitanie;65;3;03;148;Cizos;134;1;135
76;Occitanie;65;3;14;149;Clarac;163;4;167
76;Occitanie;65;2;15;150;Clarens;495;25;520
76;Occitanie;65;3;03;151;Collongues;148;4;152
76;Occitanie;65;3;03;153;Coussan;123;4;127
76;Occitanie;65;2;15;154;Créchets;55;1;56
76;Occitanie;65;3;03;155;Devèze;52;2;54
76;Occitanie;65;3;03;156;Dours;214;5;219
76;Occitanie;65;2;08;157;Ens;20;2;22
76;Occitanie;65;2;15;158;Esbareich;80;0;80
76;Occitanie;65;2;08;159;Escala;354;12;366
76;Occitanie;65;3;17;160;Escaunets;121;3;124
76;Occitanie;65;3;13;161;Escondeaux;282;4;286
76;Occitanie;65;2;14;162;Esconnets;33;1;34
76;Occitanie;65;2;14;163;Escots;40;1;41
76;Occitanie;65;1;06;164;Escoubès-Pouts;103;1;104
76;Occitanie;65;2;08;165;Esparros;180;0;180
76;Occitanie;65;2;14;166;Espèche;50;1;51
76;Occitanie;65;2;14;167;Espieilh;25;0;25
76;Occitanie;65;1;16;168;Esquièze-Sère;411;12;423
76;Occitanie;65;1;16;169;Estaing;92;2;94
76;Occitanie;65;3;03;170;Estampures;76;1;77
76;Occitanie;65;2;08;171;Estarvielle;43;0;43
76;Occitanie;65;2;08;172;Estensan;38;0;38
76;Occitanie;65;1;16;173;Esterre;190;7;197
76;Occitanie;65;3;13;174;Estirac;104;4;108
76;Occitanie;65;2;15;175;Ferrère;39;3;42
76;Occitanie;65;1;16;176;Ferrières;82;0;82
76;Occitanie;65;3;03;177;Fontrailles;167;3;170
76;Occitanie;65;3;03;178;Fréchède;56;0;56
76;Occitanie;65;2;14;179;Fréchendets;27;0;27
76;Occitanie;65;2;08;180;Fréchet-Aure;14;0;14
76;Occitanie;65;3;14;181;Fréchou-Fréchet;167;3;170
76;Occitanie;65;1;16;182;Gaillagos;121;1;122
76;Occitanie;65;2;14;183;Galan;698;13;711
76;Occitanie;65;2;14;184;Galez;172;1;173
76;Occitanie;65;3;09;185;Gardères;443;13;456
76;Occitanie;65;2;15;186;Gaudent;35;0;35
76;Occitanie;65;3;03;187;Gaussan;98;4;102
76;Occitanie;65;3;17;189;Gayan;276;13;289
76;Occitanie;65;2;08;190;Gazave;71;0;71
76;Occitanie;65;1;06;191;Gazost;122;2;124
76;Occitanie;65;1;16;192;Gavarnie-Gèdre;340;9;349
76;Occitanie;65;2;15;193;Gembrie;92;3;95
76;Occitanie;65;2;15;194;Générest;95;3;98
76;Occitanie;65;2;08;195;Génos;141;0;141
76;Occitanie;65;3;13;196;Gensac;91;2;93
76;Occitanie;65;1;06;197;Ger;154;9;163
76;Occitanie;65;2;04;198;Gerde;1142;27;1169
76;Occitanie;65;2;08;199;Germ;35;0;35
76;Occitanie;65;1;06;200;Germs-sur-l'Oussouet;106;1;107
76;Occitanie;65;1;06;201;Geu;187;4;191
76;Occitanie;65;1;16;202;Gez;329;13;342
76;Occitanie;65;1;06;203;Gez-ez-Angles;26;1;27
76;Occitanie;65;3;03;204;Gonez;28;0;28
76;Occitanie;65;2;08;205;Gouaux;54;0;54
76;Occitanie;65;3;14;206;Goudon;234;6;240
76;Occitanie;65;2;14;207;Gourgue;64;0;64
76;Occitanie;65;2;08;208;Grailhen;23;0;23
76;Occitanie;65;2;08;209;Grézian;76;0;76
76;Occitanie;65;1;16;210;Grust;34;1;35
76;Occitanie;65;2;08;211;Guchan;149;5;154
76;Occitanie;65;2;08;212;Guchen;327;11;338
76;Occitanie;65;3;03;213;Guizerix;122;3;125
76;Occitanie;65;3;03;214;Hachan;45;0;45
76;Occitanie;65;3;13;215;Hagedet;43;2;45
76;Occitanie;65;2;14;216;Hauban;101;0;101
76;Occitanie;65;2;15;217;Hautaget;57;2;59
76;Occitanie;65;2;08;218;Hèches;613;11;624
76;Occitanie;65;3;13;219;Hères;115;3;118
76;Occitanie;65;3;09;220;Hibarette;238;2;240
76;Occitanie;65;2;04;221;Hiis;258;5;263
76;Occitanie;65;3;14;222;Hitte;154;8;162
76;Occitanie;65;3;07;223;Horgues;1194;26;1220
76;Occitanie;65;2;14;224;Houeydets;280;6;286
76;Occitanie;65;3;03;225;Hourc;107;1;108
76;Occitanie;65;3;02;226;Ibos;2905;138;3043
76;Occitanie;65;2;08;228;Ilhet;121;0;121
76;Occitanie;65;2;15;229;Ilheu;48;0;48
76;Occitanie;65;2;15;230;Izaourt;256;6;262
76;Occitanie;65;2;08;231;Izaux;199;12;211
76;Occitanie;65;3;03;232;Jacque;65;2;67
76;Occitanie;65;1;06;233;Jarret;312;4;316
76;Occitanie;65;2;08;234;Jézeau;96;1;97
76;Occitanie;65;3;09;235;Juillan;4045;96;4141
76;Occitanie;65;1;06;236;Julos;454;13;467
76;Occitanie;65;1;06;237;Juncalas;159;5;164
76;Occitanie;65;2;04;238;Labassère;234;10;244
76;Occitanie;65;2;08;239;Labastide;151;5;156
76;Occitanie;65;3;13;240;Labatut-Rivière;381;6;387
76;Occitanie;65;2;08;241;Laborde;86;3;89
76;Occitanie;65;3;13;242;Lacassagne;238;3;241
76;Occitanie;65;3;13;243;Lafitole;448;18;466
76;Occitanie;65;3;17;244;Lagarde;530;7;537
76;Occitanie;65;2;15;245;Lagrange;241;4;245
76;Occitanie;65;1;06;247;Arrayou-Lahitte;102;1;103
76;Occitanie;65;3;13;248;Lahitte-Toupière;257;17;274
76;Occitanie;65;3;03;249;Lalanne;101;5;106
76;Occitanie;65;3;03;250;Lalanne-Trie;119;1;120
76;Occitanie;65;3;07;251;Laloubère;1874;64;1938
76;Occitanie;65;3;09;252;Lamarque-Pontacq;869;14;883
76;Occitanie;65;3;03;253;Lamarque-Rustaing;53;0;53
76;Occitanie;65;3;13;254;Laméac;144;4;148
76;Occitanie;65;2;08;255;Lançon;30;0;30
76;Occitanie;65;3;14;256;Lanespède;145;2;147
76;Occitanie;65;3;09;257;Lanne;605;9;614
76;Occitanie;65;2;15;258;Lannemezan;5803;161;5964
76;Occitanie;65;3;03;259;Lansac;181;10;191
76;Occitanie;65;3;03;260;Lapeyre;92;1;93
76;Occitanie;65;3;03;261;Laran;47;1;48
76;Occitanie;65;3;13;262;Larreule;389;10;399
76;Occitanie;65;3;03;263;Larroque;94;3;97
76;Occitanie;65;3;13;264;Lascazères;309;25;334
76;Occitanie;65;3;03;265;Laslades;329;10;339
76;Occitanie;65;3;03;266;Lassales;37;1;38
76;Occitanie;65;1;16;267;Lau-Balagnas;522;17;539
76;Occitanie;65;3;09;268;Layrisse;225;3;228
76;Occitanie;65;3;13;269;Lescurry;166;3;169
76;Occitanie;65;3;14;270;Lespouey;201;8;209
76;Occitanie;65;1;06;271;Lézignan;357;4;361
76;Occitanie;65;3;14;272;Lhez;77;1;78
76;Occitanie;65;3;13;273;Liac;199;0;199
76;Occitanie;65;2;14;274;Libaros;139;1;140
76;Occitanie;65;2;14;275;Lies;76;1;77
76;Occitanie;65;3;03;276;Lizos;119;1;120
76;Occitanie;65;2;15;277;Lombrès;91;2;93
76;Occitanie;65;2;14;278;Lomné;31;0;31
76;Occitanie;65;2;08;279;Lortet;215;6;221
76;Occitanie;65;1;05;280;Loubajac;434;3;437
76;Occitanie;65;3;09;281;Loucrup;250;4;254
76;Occitanie;65;2;08;282;Loudenvielle;295;6;301
76;Occitanie;65;2;08;283;Loudervielle;48;3;51
76;Occitanie;65;3;09;284;Louey;1052;28;1080
76;Occitanie;65;3;03;285;Louit;191;3;194
76;Occitanie;65;1;98;286;Lourdes;13247;299;13546
76;Occitanie;65;2;15;287;Loures-Barousse;626;12;638
76;Occitanie;65;3;03;288;Lubret-Saint-Luc;55;1;56
76;Occitanie;65;3;03;289;Luby-Betmont;109;2;111
76;Occitanie;65;3;14;290;Luc;183;1;184
76;Occitanie;65;1;06;291;Lugagnan;143;4;147
76;Occitanie;65;3;09;292;Luquet;404;3;407
76;Occitanie;65;3;03;293;Lustar;97;2;99
76;Occitanie;65;2;14;294;Lutilhous;216;3;219
76;Occitanie;65;1;16;295;Luz-Saint-Sauveur;929;15;944
76;Occitanie;65;3;13;296;Madiran;425;13;438
76;Occitanie;65;3;13;297;Mansan;41;5;46
76;Occitanie;65;3;03;298;Marquerie;85;0;85
76;Occitanie;65;3;17;299;Marsac;220;4;224
76;Occitanie;65;2;14;300;Marsas;66;3;69
76;Occitanie;65;3;03;301;Marseillan;264;4;268
76;Occitanie;65;3;14;303;Mascaras;369;4;373
76;Occitanie;65;3;13;304;Maubourguet;2254;30;2284
76;Occitanie;65;2;15;305;Mauléon-Barousse;98;0;98
76;Occitanie;65;2;14;306;Mauvezin;233;4;237
76;Occitanie;65;2;15;307;Mazères-de-Neste;338;5;343
76;Occitanie;65;3;03;308;Mazerolles;105;3;108
76;Occitanie;65;2;08;309;Mazouau;15;0;15
76;Occitanie;65;2;14;310;Mérilheu;235;5;240
76;Occitanie;65;3;13;311;Mingot;99;0;99
76;Occitanie;65;3;07;313;Momères;737;23;760
76;Occitanie;65;3;13;314;Monfaucon;208;7;215
76;Occitanie;65;3;03;315;Monléon-Magnoac;414;207;621
76;Occitanie;65;3;03;316;Monlong;105;3;108
76;Occitanie;65;2;08;317;Mont;35;2;37
76;Occitanie;65;2;14;318;Montastruc;231;3;234
76;Occitanie;65;2;15;319;Montégut;134;3;137
76;Occitanie;65;2;04;320;Montgaillard;838;17;855
76;Occitanie;65;3;07;321;Montignac;141;3;144
76;Occitanie;65;2;08;322;Montoussé;251;7;258
76;Occitanie;65;2;15;323;Montsérié;84;0;84
76;Occitanie;65;3;14;324;Moulédous;214;7;221
76;Occitanie;65;3;13;325;Moumoulous;44;0;44
76;Occitanie;65;3;03;326;Mun;83;3;86
76;Occitanie;65;2;15;327;Nestier;170;3;173
76;Occitanie;65;2;04;328;Neuilh;95;4;99
76;Occitanie;65;2;15;329;Nistos;208;7;215
76;Occitanie;65;3;17;330;Nouilhan;224;3;227
76;Occitanie;65;3;07;331;Odos;3290;100;3390
76;Occitanie;65;3;03;332;Oléac-Debat;171;1;172
76;Occitanie;65;3;14;333;Oléac-Dessus;113;1;114
76;Occitanie;65;1;05;334;Omex;224;4;228
76;Occitanie;65;2;04;335;Ordizan;523;16;539
76;Occitanie;65;3;03;336;Organ;32;0;32
76;Occitanie;65;3;14;337;Orieux;106;3;109
76;Occitanie;65;2;14;338;Orignac;247;3;250
76;Occitanie;65;3;09;339;Orincles;338;7;345
76;Occitanie;65;3;02;340;Orleix;1953;42;1995
76;Occitanie;65;3;17;341;Oroix;106;2;108
76;Occitanie;65;3;03;342;Osmets;93;2;95
76;Occitanie;65;1;05;343;Ossen;242;5;247
76;Occitanie;65;3;09;344;Ossun;2369;52;2421
76;Occitanie;65;1;06;345;Ossun-ez-Angles;56;0;56
76;Occitanie;65;3;14;346;Oueilloux;150;6;156
76;Occitanie;65;2;15;347;Ourde;45;0;45
76;Occitanie;65;1;06;348;Ourdis-Cotdoussan;45;2;47
76;Occitanie;65;1;06;349;Ourdon;12;0;12
76;Occitanie;65;3;02;350;Oursbelille;1200;41;1241
76;Occitanie;65;1;06;351;Ousté;35;0;35
76;Occitanie;65;1;16;352;Ouzous;221;8;229
76;Occitanie;65;3;14;353;Ozon;249;10;259
76;Occitanie;65;2;08;354;Pailhac;75;3;78
76;Occitanie;65;1;06;355;Paréac;73;0;73
76;Occitanie;65;2;14;356;Péré;60;2;62
76;Occitanie;65;3;14;357;Peyraube;163;3;166
76;Occitanie;65;3;03;358;Peyret-Saint-André;51;2;53
76;Occitanie;65;3;03;359;Peyriguère;27;0;27
76;Occitanie;65;1;05;360;Peyrouse;275;8;283
76;Occitanie;65;3;13;361;Peyrun;98;0;98
76;Occitanie;65;1;16;362;Pierrefitte-Nestalas;1119;25;1144
76;Occitanie;65;2;15;363;Pinas;454;9;463
76;Occitanie;65;3;17;364;Pintac;22;2;24
76;Occitanie;65;1;05;366;Poueyferré;846;25;871
76;Occitanie;65;3;14;367;Poumarous;166;3;169
76;Occitanie;65;3;03;368;Pouy;41;2;43
76;Occitanie;65;3;03;369;Pouyastruc;643;23;666
76;Occitanie;65;2;04;370;Pouzac;1110;38;1148
76;Occitanie;65;1;16;371;Préchac;239;10;249
76;Occitanie;65;3;17;372;Pujo;649;14;663
76;Occitanie;65;3;03;373;Puntous;163;4;167
76;Occitanie;65;3;03;374;Puydarrieux;233;1;234
76;Occitanie;65;3;13;375;Rabastens-de-Bigorre;1443;25;1468
76;Occitanie;65;2;14;376;Recurt;217;4;221
76;Occitanie;65;2;15;377;Réjaumont;155;8;163
76;Occitanie;65;3;14;378;Ricaud;66;2;68
76;Occitanie;65;2;08;379;Ris;14;1;15
76;Occitanie;65;3;03;380;Sabalos;147;1;148
76;Occitanie;65;2;14;381;Sabarros;34;0;34
76;Occitanie;65;2;15;382;Sacoué;80;3;83
76;Occitanie;65;3;03;383;Sadournin;196;2;198
76;Occitanie;65;2;08;384;Sailhan;173;2;175
76;Occitanie;65;2;08;385;Saint-Arroman;96;1;97
76;Occitanie;65;1;06;386;Saint-Créac;98;0;98
76;Occitanie;65;3;13;387;Saint-Lanne;122;3;125
76;Occitanie;65;2;08;388;Saint-Lary-Soulan;838;17;855
76;Occitanie;65;2;15;389;Saint-Laurent-de-Neste;955;35;990
76;Occitanie;65;3;17;390;Saint-Lézer;429;8;437
76;Occitanie;65;2;15;391;Sainte-Marie;59;0;59
76;Occitanie;65;3;07;392;Saint-Martin;442;8;450
76;Occitanie;65;1;16;393;Saint-Pastous;143;5;148
76;Occitanie;65;2;15;394;Saint-Paul;319;3;322
76;Occitanie;65;1;05;395;Saint-Pé-de-Bigorre;1157;20;1177
76;Occitanie;65;1;16;396;Saint-Savin;364;8;372
76;Occitanie;65;3;13;397;Saint-Sever-de-Rustan;161;4;165
76;Occitanie;65;2;15;398;Saléchan;245;2;247
76;Occitanie;65;1;16;399;Saligos;98;2;100
76;Occitanie;65;1;16;400;Salles;228;7;235
76;Occitanie;65;3;07;401;Salles-Adour;573;24;597
76;Occitanie;65;2;15;402;Samuran;25;0;25
76;Occitanie;65;3;17;403;Sanous;101;2;103
76;Occitanie;65;3;03;404;Sariac-Magnoac;153;3;156
76;Occitanie;65;2;14;405;Sarlabous;78;1;79
76;Occitanie;65;3;17;406;Sarniguet;258;5;263
76;Occitanie;65;2;15;407;Sarp;108;2;110
76;Occitanie;65;2;08;408;Sarrancolin;560;19;579
76;Occitanie;65;3;13;409;Sarriac-Bigorre;292;3;295
76;Occitanie;65;3;07;410;Sarrouilles;525;14;539
76;Occitanie;65;1;16;411;Sassis;76;6;82
76;Occitanie;65;3;13;412;Sauveterre;165;3;168
76;Occitanie;65;1;16;413;Sazos;142;4;146
76;Occitanie;65;3;13;414;Ségalas;80;4;84
76;Occitanie;65;1;05;415;Ségus;239;1;240
76;Occitanie;65;2;15;416;Seich;86;2;88
76;Occitanie;65;3;01;417;Séméac;5165;95;5260
76;Occitanie;65;3;13;418;Sénac;292;7;299
76;Occitanie;65;2;14;419;Sentous;68;0;68
76;Occitanie;65;1;16;420;Sère-en-Lavedan;76;2;78
76;Occitanie;65;1;06;421;Sère-Lanso;50;2;52
76;Occitanie;65;3;09;422;Séron;338;3;341
76;Occitanie;65;3;03;423;Sère-Rustaing;133;1;134
76;Occitanie;65;1;16;424;Sers;118;2;120
76;Occitanie;65;3;17;425;Siarrouy;449;7;456
76;Occitanie;65;3;14;426;Sinzos;131;6;137
76;Occitanie;65;2;15;427;Siradan;285;6;291
76;Occitanie;65;1;16;428;Sireix;62;1;63
76;Occitanie;65;3;13;429;Sombrun;205;10;215
76;Occitanie;65;3;03;430;Soréac;44;1;45
76;Occitanie;65;2;15;431;Sost;96;3;99
76;Occitanie;65;3;13;432;Soublecause;177;6;183
76;Occitanie;65;3;01;433;Soues;3047;40;3087
76;Occitanie;65;1;16;435;Soulom;283;4;287
76;Occitanie;65;3;03;436;Souyeaux;303;11;314
76;Occitanie;65;2;15;437;Tajan;131;5;136
76;Occitanie;65;3;17;438;Talazac;76;2;78
76;Occitanie;65;3;17;439;Tarasteix;269;3;272
76;Occitanie;65;3;99;440;Tarbes;42925;1019;43944
76;Occitanie;65;2;15;441;Thèbe;79;2;81
76;Occitanie;65;3;03;442;Thermes-Magnoac;209;1;210
76;Occitanie;65;3;03;443;Thuy;16;0;16
76;Occitanie;65;2;15;444;Tibiran-Jaunac;323;2;325
76;Occitanie;65;2;14;445;Tilhouse;230;5;235
76;Occitanie;65;3;13;446;Tostat;549;4;553
76;Occitanie;65;3;14;447;Tournay;1164;21;1185
76;Occitanie;65;3;03;448;Tournous-Darré;87;4;91
76;Occitanie;65;2;14;449;Tournous-Devant;87;5;92
76;Occitanie;65;2;08;450;Tramezaïgues;39;1;40
76;Occitanie;65;2;04;451;Trébons;749;14;763
76;Occitanie;65;3;03;452;Trie-sur-Baïse;1001;26;1027
76;Occitanie;65;2;15;453;Troubat;75;0;75
76;Occitanie;65;3;13;454;Trouley-Labarthe;105;1;106
76;Occitanie;65;2;15;455;Tuzaguet;436;8;444
76;Occitanie;65;2;15;456;Uglas;285;7;292
76;Occitanie;65;3;13;457;Ugnouas;83;1;84
76;Occitanie;65;1;16;458;Uz;33;1;34
76;Occitanie;65;2;14;459;Uzer;103;0;103
76;Occitanie;65;3;17;460;Vic-en-Bigorre;4831;270;5101
76;Occitanie;65;3;03;461;Vidou;101;2;103
76;Occitanie;65;3;13;462;Vidouze;242;5;247
76;Occitanie;65;1;16;463;Viella;84;1;85
76;Occitanie;65;3;07;464;Vielle-Adour;500;10;510
76;Occitanie;65;2;08;465;Vielle-Aure;317;9;326
76;Occitanie;65;2;08;466;Vielle-Louron;82;1;83
76;Occitanie;65;1;16;467;Vier-Bordes;97;6;103
76;Occitanie;65;3;03;468;Vieuzos;43;1;44
76;Occitanie;65;1;16;469;Viey;21;1;22
76;Occitanie;65;1;05;470;Viger;146;4;150
76;Occitanie;65;2;08;471;Vignec;213;8;221
76;Occitanie;65;3;13;472;Villefranque;74;5;79
76;Occitanie;65;1;16;473;Villelongue;382;11;393
76;Occitanie;65;3;03;474;Villembits;113;1;114
76;Occitanie;65;3;03;475;Villemur;60;1;61
76;Occitanie;65;3;17;476;Villenave-près-Béarn;66;4;70
76;Occitanie;65;3;17;477;Villenave-près-Marsac;106;2;108
76;Occitanie;65;1;16;478;Viscos;33;1;34
76;Occitanie;65;3;09;479;Visker;352;10;362
76;Occitanie;65;1;16;481;Barèges;157;5;162
76;Occitanie;65;2;15;482;Cantaous;440;11;451
76;Occitanie;66;1;17;001;L'Albère;70;1;71
76;Occitanie;66;1;12;002;Alénya;3654;63;3717
76;Occitanie;66;1;02;003;Amélie-les-Bains-Palalda;3581;51;3632
76;Occitanie;66;3;13;004;Les Angles;546;8;554
76;Occitanie;66;3;13;005;Angoustrine-Villeneuve-des-Escaldes;557;35;592
76;Occitanie;66;3;15;006;Ansignan;166;5;171
76;Occitanie;66;3;15;007;Arboussols;127;1;128
76;Occitanie;66;1;05;008;Argelès-sur-Mer;10593;251;10844
76;Occitanie;66;1;02;009;Arles-sur-Tech;2784;39;2823
76;Occitanie;66;3;13;010;Ayguatébia-Talau;35;0;35
76;Occitanie;66;1;12;011;Bages;4453;54;4507
76;Occitanie;66;2;14;012;Baho;3388;69;3457
76;Occitanie;66;3;02;013;Baillestavy;118;3;121
76;Occitanie;66;2;14;014;Baixas;2669;48;2717
76;Occitanie;66;1;01;015;Banyuls-dels-Aspres;1289;22;1311
76;Occitanie;66;1;05;016;Banyuls-sur-Mer;4761;78;4839
76;Occitanie;66;2;04;017;Le Barcarès;5894;39;5933
76;Occitanie;66;1;02;018;La Bastide;68;0;68
76;Occitanie;66;3;15;019;Bélesta;213;4;217
76;Occitanie;66;3;13;020;Bolquère;816;29;845
76;Occitanie;66;2;07;021;Bompas;7625;109;7734
76;Occitanie;66;3;02;022;Boule-d'Amont;58;1;59
76;Occitanie;66;3;02;023;Bouleternère;957;9;966
76;Occitanie;66;1;17;024;Le Boulou;5313;57;5370
76;Occitanie;66;3;13;025;Bourg-Madame;1203;76;1279
76;Occitanie;66;1;01;026;Brouilla;1580;33;1613
76;Occitanie;66;3;13;027;La Cabanasse;695;14;709
76;Occitanie;66;2;08;028;Cabestany;10368;212;10580
76;Occitanie;66;1;01;029;Caixas;134;1;135
76;Occitanie;66;2;14;030;Calce;216;4;220
76;Occitanie;66;1;01;032;Calmeilles;59;3;62
76;Occitanie;66;1;01;033;Camélas;459;13;472
76;Occitanie;66;3;13;034;Campôme;111;5;116
76;Occitanie;66;3;15;035;Campoussy;41;0;41
76;Occitanie;66;3;13;036;Canaveilles;22;0;22
76;Occitanie;66;2;03;037;Canet-en-Roussillon;12653;263;12916
76;Occitanie;66;2;10;038;Canohès;6490;121;6611
76;Occitanie;66;3;15;039;Caramany;131;1;132
76;Occitanie;66;3;02;040;Casefabre;41;1;42
76;Occitanie;66;2;15;041;Cases-de-Pène;958;22;980
76;Occitanie;66;2;15;042;Cassagnes;276;1;277
76;Occitanie;66;3;02;043;Casteil;139;2;141
76;Occitanie;66;1;01;044;Castelnou;289;6;295
76;Occitanie;66;3;13;045;Catllar;761;15;776
76;Occitanie;66;3;15;046;Caudiès-de-Fenouillèdes;593;9;602
76;Occitanie;66;3;13;047;Caudiès-de-Conflent;18;2;20
76;Occitanie;66;1;05;048;Cerbère;1301;15;1316
76;Occitanie;66;1;17;049;Céret;7753;215;7968
76;Occitanie;66;2;04;050;Claira;4550;56;4606
76;Occitanie;66;3;13;051;Clara-Villerach;270;8;278
76;Occitanie;66;3;13;052;Codalet;359;7;366
76;Occitanie;66;1;05;053;Collioure;2400;29;2429
76;Occitanie;66;3;13;054;Conat;60;3;63
76;Occitanie;66;3;16;055;Corbère;777;17;794
76;Occitanie;66;3;16;056;Corbère-les-Cabanes;1040;14;1054
76;Occitanie;66;3;02;057;Corneilla-de-Conflent;530;4;534
76;Occitanie;66;3;16;058;Corneilla-la-Rivière;2012;35;2047
76;Occitanie;66;1;12;059;Corneilla-del-Vercol;2444;35;2479
76;Occitanie;66;1;02;060;Corsavy;240;21;261
76;Occitanie;66;1;02;061;Coustouges;91;0;91
76;Occitanie;66;3;13;062;Dorres;171;7;178
76;Occitanie;66;1;17;063;Les Cluses;232;3;235
76;Occitanie;66;3;13;064;Égat;422;13;435
76;Occitanie;66;1;12;065;Elne;9402;116;9518
76;Occitanie;66;3;13;066;Enveitg;637;22;659
76;Occitanie;66;3;13;067;Err;683;13;696
76;Occitanie;66;3;13;068;Escaro;111;2;113
76;Occitanie;66;2;15;069;Espira-de-l'Agly;3489;114;3603
76;Occitanie;66;3;02;070;Espira-de-Conflent;183;5;188
76;Occitanie;66;2;15;071;Estagel;2046;18;2064
76;Occitanie;66;3;13;072;Estavar;479;11;490
76;Occitanie;66;3;02;073;Estoher;135;2;137
76;Occitanie;66;3;13;074;Eus;377;14;391
76;Occitanie;66;3;13;075;Eyne;144;8;152
76;Occitanie;66;3;15;076;Feilluns;63;0;63
76;Occitanie;66;3;15;077;Fenouillet;88;1;89
76;Occitanie;66;3;02;078;Fillols;197;4;201
76;Occitanie;66;3;02;079;Finestret;200;4;204
76;Occitanie;66;3;13;080;Fontpédrouse;119;1;120
76;Occitanie;66;3;13;081;Fontrabiouse;124;3;127
76;Occitanie;66;3;13;082;Formiguères;500;15;515
76;Occitanie;66;3;15;083;Fosse;41;0;41
76;Occitanie;66;1;01;084;Fourques;1313;19;1332
76;Occitanie;66;3;02;085;Fuilla;442;9;451
76;Occitanie;66;3;02;086;Glorianes;22;0;22
76;Occitanie;66;3;16;088;Ille-sur-Têt;5519;69;5588
76;Occitanie;66;3;02;089;Joch;349;6;355
76;Occitanie;66;3;13;090;Jujols;43;2;45
76;Occitanie;66;1;02;091;Lamanère;56;1;57
76;Occitanie;66;3;15;092;Lansac;91;2;93
76;Occitanie;66;1;17;093;Laroque-des-Albères;2192;29;2221
76;Occitanie;66;1;12;094;Latour-Bas-Elne;3210;47;3257
76;Occitanie;66;3;13;095;Latour-de-Carol;450;12;462
76;Occitanie;66;3;15;096;Latour-de-France;1043;13;1056
76;Occitanie;66;3;15;097;Lesquerde;139;4;143
76;Occitanie;66;3;13;098;La Llagonne;218;10;228
76;Occitanie;66;1;01;099;Llauro;320;2;322
76;Occitanie;66;3;13;100;Llo;166;4;170
76;Occitanie;66;2;01;101;Llupia;2141;45;2186
76;Occitanie;66;3;02;102;Mantet;31;2;33
76;Occitanie;66;3;02;103;Marquixanes;574;8;582
76;Occitanie;66;3;13;104;Los Masos;979;12;991
76;Occitanie;66;3;13;105;Matemale;277;6;283
76;Occitanie;66;1;17;106;Maureillas-las-Illas;2665;45;2710
76;Occitanie;66;3;15;107;Maury;789;12;801
76;Occitanie;66;3;16;108;Millas;4261;63;4324
76;Occitanie;66;3;13;109;Molitg-les-Bains;246;4;250
76;Occitanie;66;3;16;111;Montalba-le-Château;153;2;155
76;Occitanie;66;1;01;112;Montauriol;251;4;255
76;Occitanie;66;1;02;113;Montbolo;177;2;179
76;Occitanie;66;1;12;114;Montescot;1630;36;1666
76;Occitanie;66;1;17;115;Montesquieu-des-Albères;1250;23;1273
76;Occitanie;66;1;02;116;Montferrer;197;3;200
76;Occitanie;66;3;13;117;Mont-Louis;144;8;152
76;Occitanie;66;2;15;118;Montner;333;7;340
76;Occitanie;66;3;13;119;Mosset;316;5;321
76;Occitanie;66;3;13;120;Nahuja;76;1;77
76;Occitanie;66;3;16;121;Néfiach;1314;36;1350
76;Occitanie;66;3;13;122;Nohèdes;59;2;61
76;Occitanie;66;3;13;123;Nyer;153;0;153
76;Occitanie;66;3;13;124;Font-Romeu-Odeillo-Via;1791;173;1964
76;Occitanie;66;3;13;125;Olette;347;5;352
76;Occitanie;66;1;01;126;Oms;334;5;339
76;Occitanie;66;2;15;127;Opoul-Périllos;1189;17;1206
76;Occitanie;66;3;13;128;Oreilla;25;0;25
76;Occitanie;66;1;12;129;Ortaffa;1700;22;1722
76;Occitanie;66;3;13;130;Osséja;1366;75;1441
76;Occitanie;66;3;13;132;Palau-de-Cerdagne;415;11;426
76;Occitanie;66;1;05;133;Palau-del-Vidre;3092;45;3137
76;Occitanie;66;1;01;134;Passa;998;10;1008
76;Occitanie;66;2;99;136;Perpignan;118032;1415;119447
76;Occitanie;66;1;17;137;Le Perthus;551;3;554
76;Occitanie;66;2;14;138;Peyrestortes;1585;26;1611
76;Occitanie;66;3;15;139;Pézilla-de-Conflent;39;0;39
76;Occitanie;66;2;14;140;Pézilla-la-Rivière;3906;56;3962
76;Occitanie;66;2;04;141;Pia;10334;102;10436
76;Occitanie;66;3;13;142;Planès;54;2;56
76;Occitanie;66;3;15;143;Planèzes;90;2;92
76;Occitanie;66;2;01;144;Pollestres;5316;84;5400
76;Occitanie;66;2;01;145;Ponteilla;2833;42;2875
76;Occitanie;66;3;13;146;Porta;115;6;121
76;Occitanie;66;3;13;147;Porté-Puymorens;106;1;107
76;Occitanie;66;1;05;148;Port-Vendres;3995;75;4070
76;Occitanie;66;3;13;149;Prades;6081;294;6375
76;Occitanie;66;1;02;150;Prats-de-Mollo-la-Preste;1155;14;1169
76;Occitanie;66;3;15;151;Prats-de-Sournia;78;4;82
76;Occitanie;66;3;15;152;Prugnanes;105;0;105
76;Occitanie;66;3;02;153;Prunet-et-Belpuig;47;0;47
76;Occitanie;66;3;13;154;Puyvalador;61;1;62
76;Occitanie;66;3;02;155;Py;80;1;81
76;Occitanie;66;3;15;156;Rabouillet;91;0;91
76;Occitanie;66;3;13;157;Railleu;23;1;24
76;Occitanie;66;3;15;158;Rasiguères;156;2;158
76;Occitanie;66;3;13;159;Réal;62;0;62
76;Occitanie;66;1;02;160;Reynès;1252;21;1273
76;Occitanie;66;3;13;161;Ria-Sirach;1354;25;1379
76;Occitanie;66;3;02;162;Rigarda;678;2;680
76;Occitanie;66;2;15;164;Rivesaltes;9020;140;9160
76;Occitanie;66;3;02;165;Rodès;636;7;643
76;Occitanie;66;3;02;166;Sahorre;397;4;401
76;Occitanie;66;3;13;167;Saillagouse;1175;30;1205
76;Occitanie;66;1;05;168;Saint-André;3411;51;3462
76;Occitanie;66;3;15;169;Saint-Arnac;109;1;110
76;Occitanie;66;1;01;170;Sainte-Colombe-de-la-Commanderie;162;2;164
76;Occitanie;66;1;03;171;Saint-Cyprien;11048;140;11188
76;Occitanie;66;2;14;172;Saint-Estève;11642;163;11805
76;Occitanie;66;3;16;173;Saint-Féliu-d'Amont;1205;19;1224
76;Occitanie;66;2;16;174;Saint-Féliu-d'Avall;2907;45;2952
76;Occitanie;66;1;17;175;Saint-Génis-des-Fontaines;2837;27;2864
76;Occitanie;66;2;04;176;Saint-Hippolyte;3209;32;3241
76;Occitanie;66;1;01;177;Saint-Jean-Lasseille;1558;17;1575
76;Occitanie;66;1;17;178;Saint-Jean-Pla-de-Corts;2264;49;2313
76;Occitanie;66;1;02;179;Saint-Laurent-de-Cerdans;1036;14;1050
76;Occitanie;66;2;04;180;Saint-Laurent-de-la-Salanque;10053;120;10173
76;Occitanie;66;3;13;181;Sainte-Léocadie;122;2;124
76;Occitanie;66;2;07;182;Sainte-Marie-la-Mer;4800;67;4867
76;Occitanie;66;1;02;183;Saint-Marsal;64;0;64
76;Occitanie;66;3;15;184;Saint-Martin-de-Fenouillet;51;3;54
76;Occitanie;66;3;02;185;Saint-Michel-de-Llotes;353;11;364
76;Occitanie;66;2;03;186;Saint-Nazaire;2784;39;2823
76;Occitanie;66;3;15;187;Saint-Paul-de-Fenouillet;1779;17;1796
76;Occitanie;66;3;13;188;Saint-Pierre-dels-Forcats;262;10;272
76;Occitanie;66;2;03;189;Saleilles;5617;83;5700
76;Occitanie;66;2;15;190;Salses-le-Château;3616;32;3648
76;Occitanie;66;3;13;191;Sansa;23;1;24
76;Occitanie;66;3;13;192;Sauto;94;3;97
76;Occitanie;66;3;13;193;Serdinya;225;5;230
76;Occitanie;66;1;02;194;Serralongue;227;3;230
76;Occitanie;66;2;16;195;Le Soler;7868;117;7985
76;Occitanie;66;1;17;196;Sorède;3395;51;3446
76;Occitanie;66;3;13;197;Souanyas;36;0;36
76;Occitanie;66;3;15;198;Sournia;492;3;495
76;Occitanie;66;1;02;199;Taillet;103;4;107
76;Occitanie;66;3;15;201;Tarerach;45;1;46
76;Occitanie;66;3;13;202;Targasonne;193;5;198
76;Occitanie;66;1;02;203;Taulis;58;0;58
76;Occitanie;66;3;02;204;Taurinya;328;10;338
76;Occitanie;66;2;15;205;Tautavel;854;22;876
76;Occitanie;66;1;02;206;Le Tech;96;0;96
76;Occitanie;66;1;01;207;Terrats;760;11;771
76;Occitanie;66;1;12;208;Théza;2170;100;2270
76;Occitanie;66;3;13;209;Thuès-Entre-Valls;35;0;35
76;Occitanie;66;1;01;210;Thuir;8057;140;8197
76;Occitanie;66;1;01;211;Tordères;180;7;187
76;Occitanie;66;2;04;212;Torreilles;3854;70;3924
76;Occitanie;66;2;11;213;Toulouges;7255;130;7385
76;Occitanie;66;1;01;214;Tresserre;1125;13;1138
76;Occitanie;66;3;15;215;Trévillach;161;0;161
76;Occitanie;66;3;15;216;Trilla;76;1;77
76;Occitanie;66;1;01;217;Trouillas;2222;25;2247
76;Occitanie;66;3;13;218;Ur;353;11;364
76;Occitanie;66;3;13;219;Urbanya;47;0;47
76;Occitanie;66;3;13;220;Valcebollère;36;1;37
76;Occitanie;66;3;02;221;Valmanya;34;0;34
76;Occitanie;66;3;02;222;Vernet-les-Bains;1447;41;1488
76;Occitanie;66;3;13;223;Villefranche-de-Conflent;209;6;215
76;Occitanie;66;2;07;224;Villelongue-de-la-Salanque;3285;40;3325
76;Occitanie;66;1;17;225;Villelongue-dels-Monts;1815;62;1877
76;Occitanie;66;1;01;226;Villemolaque;1356;16;1372
76;Occitanie;66;2;12;227;Villeneuve-de-la-Raho;4124;54;4178
76;Occitanie;66;2;14;228;Villeneuve-la-Rivière;1373;23;1396
76;Occitanie;66;3;02;230;Vinça;2146;25;2171
76;Occitanie;66;2;15;231;Vingrau;558;6;564
76;Occitanie;66;3;15;232;Vira;25;0;25
76;Occitanie;66;1;17;233;Vivès;173;5;178
76;Occitanie;66;3;15;234;Le Vivier;68;0;68
44;Grand Est;67;8;09;001;Achenheim;2437;34;2471
44;Grand Est;67;4;08;002;Adamswiller;396;2;398
44;Grand Est;67;5;11;003;Albé;451;10;461
44;Grand Est;67;4;14;004;Sommerau;1530;28;1558
44;Grand Est;67;4;02;005;Alteckendorf;851;20;871
44;Grand Est;67;4;14;006;Altenheim;221;1;222
44;Grand Est;67;3;10;008;Altorf;1398;23;1421
44;Grand Est;67;4;08;009;Altwiller;377;13;390
44;Grand Est;67;5;12;010;Andlau;1763;70;1833
44;Grand Est;67;5;16;011;Artolsheim;989;11;1000
44;Grand Est;67;2;23;012;Aschbach;649;18;667
44;Grand Est;67;4;08;013;Asswiller;272;3;275
44;Grand Est;67;3;10;016;Avolsheim;788;11;799
44;Grand Est;67;4;08;017;Baerendorf;296;5;301
44;Grand Est;67;3;14;018;Balbronn;675;9;684
44;Grand Est;67;5;16;019;Baldenheim;1193;18;1211
44;Grand Est;67;3;11;020;Barembach;827;7;834
44;Grand Est;67;5;12;021;Barr;7174;191;7365
44;Grand Est;67;5;11;022;Bassemberg;225;4;229
44;Grand Est;67;2;05;023;Batzendorf;984;22;1006
44;Grand Est;67;2;23;025;Beinheim;1924;21;1945
44;Grand Est;67;3;11;026;Bellefosse;170;3;173
44;Grand Est;67;3;11;027;Belmont;170;0;170
44;Grand Est;67;5;04;028;Benfeld;5820;94;5914
44;Grand Est;67;4;08;029;Berg;352;4;356
44;Grand Est;67;3;10;030;Bergbieten;725;7;732
44;Grand Est;67;5;12;031;Bernardswiller;1451;45;1496
44;Grand Est;67;5;12;032;Bernardvillé;203;7;210
44;Grand Est;67;2;03;033;Bernolsheim;606;8;614
44;Grand Est;67;4;02;034;Berstett;2462;40;2502
44;Grand Est;67;2;05;035;Berstheim;467;6;473
44;Grand Est;67;4;08;036;Bettwiller;308;7;315
44;Grand Est;67;2;13;037;Biblisheim;361;6;367
44;Grand Est;67;2;03;038;Bietlenheim;301;2;303
44;Grand Est;67;2;03;039;Bilwisheim;539;11;550
44;Grand Est;67;5;16;040;Bindernheim;1044;10;1054
44;Grand Est;67;8;15;043;Bischheim;17520;215;17735
44;Grand Est;67;4;08;044;Bischholtz;256;0;256
44;Grand Est;67;3;10;045;Bischoffsheim;3338;59;3397
44;Grand Est;67;2;01;046;Bischwiller;12606;153;12759
44;Grand Est;67;4;08;047;Bissert;157;3;160
44;Grand Est;67;2;13;048;Bitschhoffen;459;15;474
44;Grand Est;67;8;09;049;Blaesheim;1303;20;1323
44;Grand Est;67;3;11;050;Blancherupt;32;0;32
44;Grand Est;67;5;12;051;Blienschwiller;310;11;321
44;Grand Est;67;3;10;052;Bœrsch;2430;65;2495
44;Grand Est;67;5;16;053;Bœsenbiesen;323;10;333
44;Grand Est;67;5;04;054;Bolsenheim;552;6;558
44;Grand Est;67;5;04;055;Boofzheim;1381;20;1401
44;Grand Est;67;5;16;056;Bootzheim;780;11;791
44;Grand Est;67;4;02;057;Bosselshausen;172;6;178
44;Grand Est;67;4;02;058;Bossendorf;387;4;391
44;Grand Est;67;3;11;059;Bourg-Bruche;382;7;389
44;Grand Est;67;5;12;060;Bourgheim;628;10;638
44;Grand Est;67;4;02;061;Bouxwiller;3736;78;3814
44;Grand Est;67;5;11;062;Breitenau;333;6;339
44;Grand Est;67;5;11;063;Breitenbach;650;16;666
44;Grand Est;67;8;09;065;Breuschwickersheim;1343;14;1357
44;Grand Est;67;3;11;066;La Broque;2609;87;2696
44;Grand Est;67;2;03;067;Brumath;10061;104;10165
44;Grand Est;67;4;02;068;Buswiller;282;3;285
44;Grand Est;67;2;23;069;Buhl;505;7;512
44;Grand Est;67;4;08;070;Burbach;277;4;281
44;Grand Est;67;4;08;071;Bust;470;11;481
44;Grand Est;67;4;08;072;Butten;660;22;682
44;Grand Est;67;5;16;073;Châtenois;4206;87;4293
44;Grand Est;67;2;23;074;Cleebourg;640;18;658
44;Grand Est;67;2;23;075;Climbach;444;4;448
44;Grand Est;67;3;11;076;Colroy-la-Roche;473;9;482
44;Grand Est;67;3;14;077;Cosswiller;578;14;592
44;Grand Est;67;3;14;078;Crastatt;278;3;281
44;Grand Est;67;2;23;079;Crœttwiller;179;3;182
44;Grand Est;67;3;10;080;Dachstein;1811;21;1832
44;Grand Est;67;3;10;081;Dahlenheim;788;12;800
44;Grand Est;67;2;01;082;Dalhunden;1224;10;1234
44;Grand Est;67;2;13;083;Dambach;763;12;775
44;Grand Est;67;5;12;084;Dambach-la-Ville;2228;41;2269
44;Grand Est;67;3;10;085;Dangolsheim;705;11;716
44;Grand Est;67;5;04;086;Daubensand;448;10;458
44;Grand Est;67;2;05;087;Dauendorf;1441;15;1456
44;Grand Est;67;4;08;088;Dehlingen;349;7;356
44;Grand Est;67;4;14;089;Dettwiller;2595;33;2628
44;Grand Est;67;5;04;090;Diebolsheim;672;43;715
44;Grand Est;67;4;08;091;Diedendorf;340;13;353
44;Grand Est;67;5;11;092;Dieffenbach-au-Val;633;26;659
44;Grand Est;67;2;13;093;Dieffenbach-lès-Wœrth;347;6;353
44;Grand Est;67;5;16;094;Dieffenthal;251;2;253
44;Grand Est;67;4;08;095;Diemeringen;1598;34;1632
44;Grand Est;67;4;14;096;Dimbsthal;322;11;333
44;Grand Est;67;4;02;097;Dingsheim;1210;18;1228
44;Grand Est;67;3;11;098;Dinsheim-sur-Bruche;1515;19;1534
44;Grand Est;67;4;08;099;Domfessel;280;6;286
44;Grand Est;67;2;03;100;Donnenheim;354;1;355
44;Grand Est;67;3;10;101;Dorlisheim;2605;32;2637
44;Grand Est;67;4;02;102;Dossenheim-Kochersberg;308;4;312
44;Grand Est;67;4;08;103;Dossenheim-sur-Zinsel;1039;25;1064
44;Grand Est;67;2;23;104;Drachenbronn-Birlenbach;602;14;616
44;Grand Est;67;4;08;105;Drulingen;1429;27;1456
44;Grand Est;67;2;01;106;Drusenheim;5254;47;5301
44;Grand Est;67;4;02;107;Duntzenheim;656;8;664
44;Grand Est;67;3;10;108;Duppigheim;1723;19;1742
44;Grand Est;67;4;02;109;Durningen;666;9;675
44;Grand Est;67;2;13;110;Durrenbach;1097;16;1113
44;Grand Est;67;4;08;111;Durstel;422;11;433
44;Grand Est;67;3;10;112;Duttlenheim;2848;29;2877
44;Grand Est;67;2;23;113;Eberbach-Seltz;426;9;435
44;Grand Est;67;5;16;115;Ebersheim;2287;20;2307
44;Grand Est;67;5;16;116;Ebersmunster;542;31;573
44;Grand Est;67;4;14;117;Eckartswiller;430;3;433
44;Grand Est;67;8;06;118;Eckbolsheim;7143;65;7208
44;Grand Est;67;8;03;119;Eckwersheim;1378;17;1395
44;Grand Est;67;5;12;120;Eichhoffen;526;11;537
44;Grand Est;67;5;16;121;Elsenheim;802;11;813
44;Grand Est;67;3;14;122;Wangenbourg-Engenthal;1335;18;1353
44;Grand Est;67;2;13;123;Engwiller;486;4;490
44;Grand Est;67;8;09;124;Entzheim;2485;25;2510
44;Grand Est;67;5;12;125;Epfig;2255;76;2331
44;Grand Est;67;4;08;126;Erckartswiller;299;6;305
44;Grand Est;67;3;10;127;Ergersheim;1443;14;1457
44;Grand Est;67;3;10;128;Ernolsheim-Bruche;1887;17;1904
44;Grand Est;67;4;14;129;Ernolsheim-lès-Saverne;595;6;601
44;Grand Est;67;5;04;130;Erstein;10739;111;10850
44;Grand Est;67;8;07;131;Eschau;5645;63;5708
44;Grand Est;67;2;13;132;Eschbach;963;11;974
44;Grand Est;67;4;08;133;Eschbourg;466;12;478
44;Grand Est;67;4;08;134;Eschwiller;185;3;188
44;Grand Est;67;4;02;135;Ettendorf;759;5;764
44;Grand Est;67;4;08;136;Eywiller;275;5;280
44;Grand Est;67;8;09;137;Fegersheim;5777;68;5845
44;Grand Est;67;4;02;138;Fessenheim-le-Bas;580;8;588
44;Grand Est;67;3;10;139;Flexbourg;483;9;492
44;Grand Est;67;2;01;140;Forstfeld;772;4;776
44;Grand Est;67;2;13;141;Forstheim;594;4;598
44;Grand Est;67;2;01;142;Fort-Louis;288;2;290
44;Grand Est;67;5;11;143;Fouchy;636;19;655
44;Grand Est;67;3;11;144;Fouday;342;3;345
44;Grand Est;67;4;14;145;Friedolsheim;270;6;276
44;Grand Est;67;5;04;146;Friesenheim;613;8;621
44;Grand Est;67;2;13;147;Frœschwiller;495;5;500
44;Grand Est;67;4;08;148;Frohmuhl;161;4;165
44;Grand Est;67;4;14;149;Furchhausen;421;7;428
44;Grand Est;67;4;02;150;Furdenheim;1458;24;1482
44;Grand Est;67;2;03;151;Gambsheim;5164;52;5216
44;Grand Est;67;8;09;152;Geispolsheim;7603;79;7682
44;Grand Est;67;4;02;153;Geiswiller-Zœbersdorf;392;3;395
44;Grand Est;67;5;04;154;Gerstheim;3452;56;3508
44;Grand Est;67;5;12;155;Gertwiller;1266;13;1279
44;Grand Est;67;2;03;156;Geudertheim;2631;24;2655
44;Grand Est;67;4;08;159;Gœrlingen;204;6;210
44;Grand Est;67;2;13;160;Gœrsdorf;1057;28;1085
44;Grand Est;67;4;14;161;Gottenhouse;376;11;387
44;Grand Est;67;4;14;162;Gottesheim;356;8;364
44;Grand Est;67;4;02;163;Gougenheim;543;13;556
44;Grand Est;67;5;12;164;Goxwiller;834;20;854
44;Grand Est;67;3;11;165;Grandfontaine;376;8;384
44;Grand Est;67;4;02;166;Grassendorf;253;8;261
44;Grand Est;67;3;10;167;Grendelbruch;1226;16;1242
44;Grand Est;67;3;11;168;Gresswiller;1650;26;1676
44;Grand Est;67;2;03;169;Gries;2879;35;2914
44;Grand Est;67;3;10;172;Griesheim-près-Molsheim;2266;31;2297
44;Grand Est;67;4;02;173;Griesheim-sur-Souffel;1238;17;1255
44;Grand Est;67;2;13;174;Gumbrechtshoffen;1148;21;1169
44;Grand Est;67;2;13;176;Gundershoffen;3758;63;3821
44;Grand Est;67;2;13;177;Gunstett;635;10;645
44;Grand Est;67;4;08;178;Gungwiller;283;4;287
44;Grand Est;67;4;14;179;Haegen;653;8;661
44;Grand Est;67;2;05;180;Haguenau;35448;561;36009
44;Grand Est;67;4;02;181;Handschuheim;274;6;280
44;Grand Est;67;8;09;182;Hangenbieten;1696;25;1721
44;Grand Est;67;4;08;183;Harskirchen;882;15;897
44;Grand Est;67;2;23;184;Hatten;1901;24;1925
44;Grand Est;67;4;14;185;Hattmatt;678;9;687
44;Grand Est;67;2;13;186;Hegeney;437;6;443
44;Grand Est;67;5;16;187;Heidolsheim;557;8;565
44;Grand Est;67;3;11;188;Heiligenberg;703;11;714
44;Grand Est;67;5;12;189;Heiligenstein;949;29;978
44;Grand Est;67;4;14;190;Hengwiller;197;2;199
44;Grand Est;67;4;08;191;Herbitzheim;1840;26;1866
44;Grand Est;67;5;04;192;Herbsheim;946;11;957
44;Grand Est;67;2;01;194;Herrlisheim;4666;71;4737
44;Grand Est;67;5;16;195;Hessenheim;616;10;626
44;Grand Est;67;5;16;196;Hilsenheim;2638;36;2674
44;Grand Est;67;5;04;197;Hindisheim;1527;20;1547
44;Grand Est;67;4;08;198;Hinsbourg;113;3;116
44;Grand Est;67;4;08;199;Hinsingen;80;1;81
44;Grand Est;67;5;04;200;Hipsheim;1000;7;1007
44;Grand Est;67;4;08;201;Hirschland;302;4;306
44;Grand Est;67;4;02;202;Hochfelden;4045;56;4101
44;Grand Est;67;2;05;203;Hochstett;396;3;399
44;Grand Est;67;8;06;204;Hœnheim;11446;85;11531
44;Grand Est;67;2;03;205;Hœrdt;4586;51;4637
44;Grand Est;67;2;23;206;Hoffen;1137;18;1155
44;Grand Est;67;3;14;208;Hohengœft;543;7;550
44;Grand Est;67;4;02;209;Hohfrankenheim;273;2;275
44;Grand Est;67;5;12;210;Le Hohwald;504;12;516
44;Grand Est;67;8;09;212;Holtzheim;3821;29;3850
44;Grand Est;67;2;23;213;Hunspach;624;16;640
44;Grand Est;67;4;02;214;Hurtigheim;997;7;1004
44;Grand Est;67;2;05;215;Huttendorf;499;3;502
44;Grand Est;67;5;04;216;Huttenheim;2658;38;2696
44;Grand Est;67;5;04;217;Ichtratzheim;376;5;381
44;Grand Est;67;8;07;218;Illkirch-Graffenstaden;27087;584;27671
44;Grand Est;67;4;02;220;Ingenheim;343;2;345
44;Grand Est;67;2;23;221;Ingolsheim;348;5;353
44;Grand Est;67;4;08;222;Ingwiller;4029;38;4067
44;Grand Est;67;5;10;223;Innenheim;1202;13;1215
44;Grand Est;67;4;02;225;Issenhausen;113;2;115
44;Grand Est;67;4;02;226;Ittenheim;2098;23;2121
44;Grand Est;67;5;12;227;Itterswiller;231;6;237
44;Grand Est;67;4;02;228;Neugartheim-Ittlenheim;787;17;804
44;Grand Est;67;3;14;229;Jetterswiller;197;2;199
44;Grand Est;67;2;01;230;Kaltenhouse;2463;19;2482
44;Grand Est;67;2;01;231;Kauffenheim;212;2;214
44;Grand Est;67;2;23;232;Keffenach;204;6;210
44;Grand Est;67;5;04;233;Kertzfeld;1197;20;1217
44;Grand Est;67;4;08;234;Keskastel;1501;29;1530
44;Grand Est;67;2;23;235;Kesseldorf;438;2;440
44;Grand Est;67;4;02;236;Kienheim;545;10;555
44;Grand Est;67;2;03;237;Kilstett;2503;36;2539
44;Grand Est;67;2;13;238;Kindwiller;641;6;647
44;Grand Est;67;5;16;239;Kintzheim;1670;27;1697
44;Grand Est;67;3;10;240;Kirchheim;712;12;724
44;Grand Est;67;4;08;241;Kirrberg;147;4;151
44;Grand Est;67;4;02;242;Kirrwiller;535;5;540
44;Grand Est;67;4;14;244;Kleingœft;154;3;157
44;Grand Est;67;3;14;245;Knœrsheim;199;3;202
44;Grand Est;67;5;04;246;Kogenheim;1274;18;1292
44;Grand Est;67;8;09;247;Kolbsheim;986;21;1007
44;Grand Est;67;5;12;248;Krautergersheim;1728;26;1754
44;Grand Est;67;2;03;249;Krautwiller;231;7;238
44;Grand Est;67;2;03;250;Kriegsheim;787;16;803
44;Grand Est;67;2;03;252;Kurtzenhouse;1076;13;1089
44;Grand Est;67;4;02;253;Kuttolsheim;644;9;653
44;Grand Est;67;2;13;254;Kutzenhausen;917;16;933
44;Grand Est;67;5;11;255;Lalaye;482;9;491
44;Grand Est;67;8;06;256;Lampertheim;3459;54;3513
44;Grand Est;67;2;13;257;Lampertsloch;703;15;718
44;Grand Est;67;4;14;258;Landersheim;191;3;194
44;Grand Est;67;2;13;259;Langensoultzbach;912;11;923
44;Grand Est;67;2;13;260;Laubach;319;5;324
44;Grand Est;67;2;23;261;Lauterbourg;2341;27;2368
44;Grand Est;67;2;13;263;Lembach;1551;42;1593
44;Grand Est;67;2;01;264;Leutenheim;828;12;840
44;Grand Est;67;4;08;265;Lichtenberg;547;9;556
44;Grand Est;67;5;04;266;Limersheim;688;8;696
44;Grand Est;67;8;09;267;Lingolsheim;19797;146;19943
44;Grand Est;67;8;09;268;Lipsheim;2666;30;2696
44;Grand Est;67;4;14;269;Littenheim;303;3;306
44;Grand Est;67;4;02;270;Lixhausen;381;4;385
44;Grand Est;67;2;13;271;Lobsann;652;8;660
44;Grand Est;67;4;14;272;Lochwiller;393;6;399
44;Grand Est;67;4;08;273;Lohr;516;7;523
44;Grand Est;67;4;08;274;Lorentzen;240;4;244
44;Grand Est;67;4;14;275;Lupstein;812;14;826
44;Grand Est;67;3;11;276;Lutzelhouse;1893;35;1928
44;Grand Est;67;5;16;277;Mackenheim;757;11;768
44;Grand Est;67;4;08;278;Mackwiller;543;12;555
44;Grand Est;67;4;14;279;Maennolsheim;234;5;239
44;Grand Est;67;5;11;280;Maisonsgoutte;795;18;813
44;Grand Est;67;5;16;281;Marckolsheim;4234;42;4276
44;Grand Est;67;3;10;282;Marlenheim;4230;64;4294
44;Grand Est;67;4;14;283;Marmoutier;2712;44;2756
44;Grand Est;67;5;04;285;Matzenheim;1475;110;1585
44;Grand Est;67;5;12;286;Meistratzheim;1494;19;1513
44;Grand Est;67;4;02;287;Melsheim;575;11;586
44;Grand Est;67;2;23;288;Memmelshoffen;329;4;333
44;Grand Est;67;4;08;289;Menchhoffen;634;11;645
44;Grand Est;67;2;13;290;Merkwiller-Pechelbronn;925;17;942
44;Grand Est;67;2;13;291;Mertzwiller;3376;39;3415
44;Grand Est;67;2;13;292;Mietesheim;672;11;683
44;Grand Est;67;4;02;293;Minversheim;681;12;693
44;Grand Est;67;5;12;295;Mittelbergheim;605;23;628
44;Grand Est;67;8;06;296;Mittelhausbergen;2107;24;2131
44;Grand Est;67;2;03;298;Mittelschaeffolsheim;566;8;574
44;Grand Est;67;3;10;299;Mollkirch;896;25;921
44;Grand Est;67;3;10;300;Molsheim;9352;126;9478
44;Grand Est;67;2;03;301;Mommenheim;2241;22;2263
44;Grand Est;67;4;14;302;Monswiller;2013;36;2049
44;Grand Est;67;2;13;303;Morsbronn-les-Bains;680;12;692
44;Grand Est;67;2;05;304;Morschwiller;588;10;598
44;Grand Est;67;2;23;305;Mothern;1945;21;1966
44;Grand Est;67;3;11;306;Muhlbach-sur-Bruche;641;54;695
44;Grand Est;67;4;08;307;Mulhausen;450;5;455
44;Grand Est;67;2;23;308;Munchhausen;811;9;820
44;Grand Est;67;8;06;309;Mundolsheim;4911;70;4981
44;Grand Est;67;5;16;310;Mussig;1154;20;1174
44;Grand Est;67;5;16;311;Muttersholtz;2198;29;2227
44;Grand Est;67;4;02;312;Mutzenhouse;469;2;471
44;Grand Est;67;3;11;313;Mutzig;6083;53;6136
44;Grand Est;67;3;11;314;Natzwiller;530;8;538
44;Grand Est;67;2;23;315;Neewiller-près-Lauterbourg;670;14;684
44;Grand Est;67;5;11;317;Neubois;658;17;675
44;Grand Est;67;2;01;319;Neuhaeusel;395;3;398
44;Grand Est;67;5;11;320;Neuve-Église;619;12;631
44;Grand Est;67;3;11;321;Neuviller-la-Roche;326;8;334
44;Grand Est;67;4;08;322;Neuwiller-lès-Saverne;1107;13;1120
44;Grand Est;67;2;13;324;Niederbronn-les-Bains;4369;69;4438
44;Grand Est;67;3;11;325;Niederhaslach;1395;17;1412
44;Grand Est;67;8;06;326;Niederhausbergen;1669;13;1682
44;Grand Est;67;2;23;327;Niederlauterbach;955;22;977
44;Grand Est;67;2;13;328;Niedermodern;883;7;890
44;Grand Est;67;5;12;329;Niedernai;1267;22;1289
44;Grand Est;67;2;23;330;Niederrœdern;916;14;930
44;Grand Est;67;2;05;331;Niederschaeffolsheim;1365;18;1383
44;Grand Est;67;4;08;333;Niedersoultzbach;292;5;297
44;Grand Est;67;2;13;334;Niedersteinbach;115;1;116
44;Grand Est;67;3;10;335;Nordheim;932;14;946
44;Grand Est;67;5;04;336;Nordhouse;1739;30;1769
44;Grand Est;67;5;12;337;Nothalten;455;16;471
44;Grand Est;67;5;04;338;Obenheim;1371;23;1394
44;Grand Est;67;2;23;339;Betschdorf;4192;43;4235
44;Grand Est;67;2;13;340;Oberbronn;1508;20;1528
44;Grand Est;67;2;13;341;Oberdorf-Spachbach;404;2;406
44;Grand Est;67;3;11;342;Oberhaslach;1763;29;1792
44;Grand Est;67;8;06;343;Oberhausbergen;5459;57;5516
44;Grand Est;67;2;23;344;Oberhoffen-lès-Wissembourg;315;4;319
44;Grand Est;67;2;01;345;Oberhoffen-sur-Moder;3650;28;3678
44;Grand Est;67;2;23;346;Oberlauterbach;552;11;563
44;Grand Est;67;4;02;347;Obermodern-Zutzendorf;1713;21;1734
44;Grand Est;67;5;12;348;Obernai;12015;456;12471
44;Grand Est;67;2;23;349;Oberrœdern;524;6;530
44;Grand Est;67;8;09;350;Oberschaeffolsheim;2438;27;2465
44;Grand Est;67;2;23;351;Seebach;1673;42;1715
44;Grand Est;67;4;02;352;Obersoultzbach;397;8;405
44;Grand Est;67;2;13;353;Obersteinbach;232;3;235
44;Grand Est;67;3;10;354;Odratzheim;523;9;532
44;Grand Est;67;4;08;355;Oermingen;1125;28;1153
44;Grand Est;67;2;01;356;Offendorf;2506;32;2538
44;Grand Est;67;2;13;358;Offwiller;805;13;818
44;Grand Est;67;2;05;359;Ohlungen;1309;23;1332
44;Grand Est;67;5;16;360;Ohnenheim;1086;14;1100
44;Grand Est;67;2;03;361;Olwisheim;501;7;508
44;Grand Est;67;5;16;362;Orschwiller;603;12;615
44;Grand Est;67;8;09;363;Osthoffen;811;17;828
44;Grand Est;67;5;04;364;Osthouse;924;16;940
44;Grand Est;67;8;07;365;Ostwald;12985;133;13118
44;Grand Est;67;4;14;366;Ottersthal;795;19;814
44;Grand Est;67;4;14;367;Otterswiller;1311;32;1343
44;Grand Est;67;3;10;368;Ottrott;1552;32;1584
44;Grand Est;67;4;08;369;Ottwiller;255;1;256
44;Grand Est;67;4;08;370;Petersbach;665;12;677
44;Grand Est;67;4;08;371;La Petite-Pierre;623;3;626
44;Grand Est;67;2;89;372;Val-de-Moder;5012;63;5075
44;Grand Est;67;4;08;373;Pfalzweyer;322;4;326
44;Grand Est;67;4;02;375;Pfulgriesheim;1304;17;1321
44;Grand Est;67;3;11;377;Plaine;999;11;1010
44;Grand Est;67;8;07;378;Plobsheim;4475;48;4523
44;Grand Est;67;2;13;379;Preuschdorf;898;16;914
44;Grand Est;67;4;14;380;Printzheim;204;4;208
44;Grand Est;67;4;08;381;Puberg;361;5;366
44;Grand Est;67;4;02;382;Quatzenheim;772;17;789
44;Grand Est;67;3;14;383;Rangen;197;5;202
44;Grand Est;67;3;11;384;Ranrupt;309;7;316
44;Grand Est;67;4;08;385;Ratzwiller;241;2;243
44;Grand Est;67;4;08;386;Rauwiller;208;2;210
44;Grand Est;67;5;12;387;Reichsfeld;300;9;309
44;Grand Est;67;2;13;388;Reichshoffen;5416;78;5494
44;Grand Est;67;8;06;389;Reichstett;4389;42;4431
44;Grand Est;67;4;14;391;Reinhardsmunster;450;6;456
44;Grand Est;67;4;08;392;Reipertswiller;846;13;859
44;Grand Est;67;2;23;394;Retschwiller;276;6;282
44;Grand Est;67;4;14;395;Reutenbourg;398;10;408
44;Grand Est;67;4;08;396;Rexingen;202;1;203
44;Grand Est;67;5;04;397;Rhinau;2651;31;2682
44;Grand Est;67;5;16;398;Richtolsheim;364;2;366
44;Grand Est;67;2;23;400;Riedseltz;1119;19;1138
44;Grand Est;67;4;08;401;Rimsdorf;309;9;318
44;Grand Est;67;4;02;403;Ringendorf;459;10;469
44;Grand Est;67;2;23;404;Rittershoffen;910;16;926
44;Grand Est;67;2;01;405;Rœschwoog;2283;51;2334
44;Grand Est;67;4;02;406;Rohr;351;3;354
44;Grand Est;67;2;01;407;Rohrwiller;1598;13;1611
44;Grand Est;67;3;14;408;Romanswiller;1192;17;1209
44;Grand Est;67;2;01;409;Roppenheim;1014;8;1022
44;Grand Est;67;3;10;410;Rosenwiller;652;14;666
44;Grand Est;67;3;10;411;Rosheim;5312;115;5427
44;Grand Est;67;5;04;412;Rossfeld;1019;9;1028
44;Grand Est;67;4;08;413;Rosteig;505;13;518
44;Grand Est;67;3;11;414;Rothau;1529;22;1551
44;Grand Est;67;2;13;415;Rothbach;471;2;473
44;Grand Est;67;2;23;416;Rott;468;10;478
44;Grand Est;67;2;03;417;Rottelsheim;296;9;305
44;Grand Est;67;2;01;418;Rountzenheim-Auenheim;1953;31;1984
44;Grand Est;67;3;11;420;Russ;1241;15;1256
44;Grand Est;67;3;11;421;Saales;824;11;835
44;Grand Est;67;5;16;422;Saasenheim;588;10;598
44;Grand Est;67;4;14;423;Saessolsheim;597;7;604
44;Grand Est;67;3;11;424;Saint-Blaise-la-Roche;250;0;250
44;Grand Est;67;4;14;425;Saint-Jean-Saverne;535;13;548
44;Grand Est;67;5;11;426;Saint-Martin;364;1;365
44;Grand Est;67;5;11;427;Saint-Maurice;338;14;352
44;Grand Est;67;3;10;428;Saint-Nabor;498;7;505
44;Grand Est;67;5;12;429;Saint-Pierre;617;10;627
44;Grand Est;67;5;11;430;Saint-Pierre-Bois;752;25;777
44;Grand Est;67;2;23;432;Salmbach;586;10;596
44;Grand Est;67;5;04;433;Sand;1389;10;1399
44;Grand Est;67;4;08;434;Sarre-Union;2791;45;2836
44;Grand Est;67;4;08;435;Sarrewerden;831;21;852
44;Grand Est;67;3;11;436;Saulxures;497;12;509
44;Grand Est;67;4;14;437;Saverne;11303;299;11602
44;Grand Est;67;5;04;438;Schaeffersheim;810;13;823
44;Grand Est;67;2;23;440;Schaffhouse-près-Seltz;557;12;569
44;Grand Est;67;4;02;441;Schalkendorf;335;5;340
44;Grand Est;67;3;10;442;Scharrachbergheim-Irmstett;1243;61;1304
44;Grand Est;67;2;23;443;Scheibenhard;853;20;873
44;Grand Est;67;4;02;444;Scherlenheim;118;3;121
44;Grand Est;67;5;16;445;Scherwiller;3185;59;3244
44;Grand Est;67;4;08;446;Schillersdorf;424;11;435
44;Grand Est;67;8;15;447;Schiltigheim;33993;213;34206
44;Grand Est;67;3;11;448;Schirmeck;2132;48;2180
44;Grand Est;67;2;01;449;Schirrhein;2271;22;2293
44;Grand Est;67;2;01;450;Schirrhoffen;715;16;731
44;Grand Est;67;2;23;451;Schleithal;1383;32;1415
44;Grand Est;67;4;02;452;Schnersheim;1783;33;1816
44;Grand Est;67;5;16;453;Schœnau;620;8;628
44;Grand Est;67;4;08;454;Schœnbourg;386;7;393
44;Grand Est;67;2;23;455;Schœnenbourg;694;11;705
44;Grand Est;67;4;08;456;Schopperten;438;16;454
44;Grand Est;67;2;05;458;Schweighouse-sur-Moder;4983;62;5045
44;Grand Est;67;4;14;459;Schwenheim;747;17;764
44;Grand Est;67;4;02;460;Schwindratzheim;1754;21;1775
44;Grand Est;67;5;16;461;Schwobsheim;329;14;343
44;Grand Est;67;5;16;462;Sélestat;19279;251;19530
44;Grand Est;67;2;23;463;Seltz;3150;35;3185
44;Grand Est;67;5;04;464;Sermersheim;945;13;958
44;Grand Est;67;2;01;465;Sessenheim;2319;26;2345
44;Grand Est;67;2;23;466;Siegen;507;9;516
44;Grand Est;67;4;08;467;Siewiller;381;7;388
44;Grand Est;67;4;08;468;Siltzheim;619;16;635
44;Grand Est;67;3;11;470;Solbach;97;1;98
44;Grand Est;67;8;06;471;Souffelweyersheim;8057;63;8120
44;Grand Est;67;2;01;472;Soufflenheim;4796;54;4850
44;Grand Est;67;3;10;473;Soultz-les-Bains;956;18;974
44;Grand Est;67;2;23;474;Soultz-sous-Forêts;3169;37;3206
44;Grand Est;67;4;08;475;Sparsbach;234;4;238
44;Grand Est;67;2;01;476;Stattmatten;749;5;754
44;Grand Est;67;5;11;477;Steige;614;11;625
44;Grand Est;67;4;14;478;Steinbourg;1934;29;1963
44;Grand Est;67;2;23;479;Steinseltz;602;11;613
44;Grand Est;67;3;11;480;Still;1806;26;1832
44;Grand Est;67;5;12;481;Stotzheim;1081;14;1095
44;Grand Est;67;8;99;482;Strasbourg;290576;2962;293538
44;Grand Est;67;4;08;483;Struth;224;4;228
44;Grand Est;67;2;23;484;Stundwiller;484;10;494
44;Grand Est;67;4;02;485;Stutzheim-Offenheim;1662;27;1689
44;Grand Est;67;5;16;486;Sundhouse;1837;20;1857
44;Grand Est;67;2;23;487;Surbourg;1715;26;1741
44;Grand Est;67;4;08;488;Thal-Drulingen;184;4;188
44;Grand Est;67;4;14;489;Thal-Marmoutier;828;17;845
44;Grand Est;67;5;11;490;Thanvillé;598;17;615
44;Grand Est;67;4;08;491;Tieffenbach;250;1;251
44;Grand Est;67;3;14;492;Traenheim;651;17;668
44;Grand Est;67;5;11;493;Triembach-au-Val;436;10;446
44;Grand Est;67;2;23;494;Trimbach;583;11;594
44;Grand Est;67;4;02;495;Truchtersheim;4386;101;4487
44;Grand Est;67;2;05;497;Uhlwiller;684;14;698
44;Grand Est;67;2;13;498;Uhrwiller;707;7;714
44;Grand Est;67;5;11;499;Urbeis;316;14;330
44;Grand Est;67;3;11;500;Urmatt;1452;37;1489
44;Grand Est;67;5;04;501;Uttenheim;561;4;565
44;Grand Est;67;2;13;502;Uttenhoffen;209;1;210
44;Grand Est;67;4;02;503;Uttwiller;160;2;162
44;Grand Est;67;5;12;504;Valff;1383;10;1393
44;Grand Est;67;5;16;505;La Vancelle;401;13;414
44;Grand Est;67;8;03;506;Vendenheim;6010;70;6080
44;Grand Est;67;5;11;507;Villé;1786;32;1818
44;Grand Est;67;4;08;508;Vœllerdingen;420;18;438
44;Grand Est;67;4;08;509;Volksberg;350;3;353
44;Grand Est;67;2;05;510;Wahlenheim;603;4;607
44;Grand Est;67;2;13;511;Walbourg;935;251;1186
44;Grand Est;67;3;11;513;Waldersbach;126;1;127
44;Grand Est;67;4;08;514;Waldhambach;638;9;647
44;Grand Est;67;4;14;515;Waldolwisheim;562;9;571
44;Grand Est;67;4;02;516;Waltenheim-sur-Zorn;670;7;677
44;Grand Est;67;3;10;517;Wangen;654;11;665
44;Grand Est;67;8;03;519;La Wantzenau;5909;113;6022
44;Grand Est;67;3;14;520;Wasselonne;5755;66;5821
44;Grand Est;67;4;08;521;Weinbourg;459;3;462
44;Grand Est;67;4;08;522;Weislingen;548;8;556
44;Grand Est;67;2;03;523;Weitbruch;2738;36;2774
44;Grand Est;67;4;08;524;Weiterswiller;521;8;529
44;Grand Est;67;3;14;525;Westhoffen;1653;24;1677
44;Grand Est;67;5;04;526;Westhouse;1599;17;1616
44;Grand Est;67;4;14;527;Westhouse-Marmoutier;349;7;356
44;Grand Est;67;4;08;528;Weyer;548;13;561
44;Grand Est;67;2;03;529;Weyersheim;3419;34;3453
44;Grand Est;67;4;02;530;Wickersheim-Wilshausen;383;6;389
44;Grand Est;67;3;11;531;Wildersbach;284;6;290
44;Grand Est;67;4;02;532;Willgottheim;1081;17;1098
44;Grand Est;67;4;02;534;Wilwisheim;735;3;738
44;Grand Est;67;4;08;535;Wimmenau;1055;21;1076
44;Grand Est;67;2;13;536;Windstein;163;1;164
44;Grand Est;67;2;13;537;Wingen;449;6;455
44;Grand Est;67;4;08;538;Wingen-sur-Moder;1581;24;1605
44;Grand Est;67;4;02;539;Wingersheim les Quatre Bans;2339;39;2378
44;Grand Est;67;2;05;540;Wintershouse;864;12;876
44;Grand Est;67;2;23;541;Wintzenbach;532;2;534
44;Grand Est;67;4;02;542;Wintzenheim-Kochersberg;516;4;520
44;Grand Est;67;3;11;543;Wisches;2077;29;2106
44;Grand Est;67;2;23;544;Wissembourg;7492;217;7709
44;Grand Est;67;5;04;545;Witternheim;501;6;507
44;Grand Est;67;2;05;546;Wittersheim;691;5;696
44;Grand Est;67;5;16;547;Wittisheim;2067;30;2097
44;Grand Est;67;4;02;548;Wiwersheim;873;14;887
44;Grand Est;67;2;13;550;Wœrth;1716;24;1740
44;Grand Est;67;8;06;551;Wolfisheim;4171;55;4226
44;Grand Est;67;4;08;552;Wolfskirchen;350;10;360
44;Grand Est;67;4;14;553;Wolschheim;317;4;321
44;Grand Est;67;3;10;554;Wolxheim;967;13;980
44;Grand Est;67;3;14;555;Zehnacker;248;3;251
44;Grand Est;67;3;14;556;Zeinheim;210;3;213
44;Grand Est;67;5;12;557;Zellwiller;807;12;819
44;Grand Est;67;2;13;558;Zinswiller;737;13;750
44;Grand Est;67;4;08;559;Zittersheim;253;2;255
44;Grand Est;68;2;06;001;Algolsheim;1125;11;1136
44;Grand Est;68;1;09;002;Altenach;390;4;394
44;Grand Est;68;1;01;004;Altkirch;5658;129;5787
44;Grand Est;68;2;15;005;Ammerschwihr;1705;33;1738
44;Grand Est;68;1;09;006;Bernwiller;1208;29;1237
44;Grand Est;68;2;05;007;Andolsheim;2192;73;2265
44;Grand Est;68;2;06;008;Appenwihr;580;12;592
44;Grand Est;68;2;06;009;Artzenheim;864;11;875
44;Grand Est;68;1;01;010;Aspach;1127;22;1149
44;Grand Est;68;6;03;011;Aspach-le-Bas;1302;26;1328
44;Grand Est;68;6;03;012;Aspach-Michelbach;1767;44;1811
44;Grand Est;68;4;14;013;Attenschwiller;989;23;1012
44;Grand Est;68;2;15;014;Aubure;363;10;373
44;Grand Est;68;4;13;015;Baldersheim;2636;49;2685
44;Grand Est;68;2;06;016;Balgau;970;14;984
44;Grand Est;68;1;09;017;Ballersdorf;812;17;829
44;Grand Est;68;1;09;018;Balschwiller;749;17;766
44;Grand Est;68;2;06;019;Baltzenheim;562;9;571
44;Grand Est;68;4;13;020;Bantzenheim;1605;32;1637
44;Grand Est;68;4;02;021;Bartenheim;4062;87;4149
44;Grand Est;68;4;13;022;Battenheim;1580;21;1601
44;Grand Est;68;2;15;023;Beblenheim;938;22;960
44;Grand Est;68;1;09;024;Bellemagny;148;5;153
44;Grand Est;68;1;01;025;Bendorf;245;3;248
44;Grand Est;68;2;15;026;Bennwihr;1373;23;1396
44;Grand Est;68;1;01;027;Berentzwiller;341;11;352
44;Grand Est;68;2;15;028;Bergheim;2072;48;2120
44;Grand Est;68;6;07;029;Bergholtz;1103;32;1135
44;Grand Est;68;6;07;030;Bergholtzzell;413;12;425
44;Grand Est;68;4;17;032;Berrwiller;1204;37;1241
44;Grand Est;68;1;01;033;Bettendorf;448;8;456
44;Grand Est;68;1;01;034;Bettlach;310;15;325
44;Grand Est;68;1;01;035;Biederthal;325;7;332
44;Grand Est;68;2;06;036;Biesheim;2510;55;2565
44;Grand Est;68;6;06;037;Biltzheim;478;9;487
44;Grand Est;68;2;05;038;Bischwihr;1134;25;1159
44;Grand Est;68;1;01;039;Bisel;543;14;557
44;Grand Est;68;6;03;040;Bitschwiller-lès-Thann;2002;37;2039
44;Grand Est;68;2;06;041;Blodelsheim;1986;26;2012
44;Grand Est;68;4;14;042;Blotzheim;4777;121;4898
44;Grand Est;68;4;17;043;Bollwiller;4119;55;4174
44;Grand Est;68;2;15;044;Le Bonhomme;745;20;765
44;Grand Est;68;6;03;045;Bourbach-le-Bas;552;16;568
44;Grand Est;68;6;03;046;Bourbach-le-Haut;415;9;424
44;Grand Est;68;1;01;049;Bouxwiller;429;15;444
44;Grand Est;68;1;09;050;Bréchaumont;405;14;419
44;Grand Est;68;2;16;051;Breitenbach-Haut-Rhin;819;14;833
44;Grand Est;68;1;09;052;Bretten;186;3;189
44;Grand Est;68;4;02;054;Brinckheim;421;8;429
44;Grand Est;68;4;02;055;Bruebach;1048;34;1082
44;Grand Est;68;4;02;056;Brunstatt-Didenheim;8168;129;8297
44;Grand Est;68;1;09;057;Buethwiller;267;9;276
44;Grand Est;68;6;07;058;Buhl;3277;49;3326
44;Grand Est;68;6;09;059;Burnhaupt-le-Bas;1928;43;1971
44;Grand Est;68;6;09;060;Burnhaupt-le-Haut;1744;46;1790
44;Grand Est;68;4;14;061;Buschwiller;1066;17;1083
44;Grand Est;68;1;01;062;Carspach;2082;90;2172
44;Grand Est;68;6;03;063;Cernay;11559;210;11769
44;Grand Est;68;4;13;064;Chalampé;978;9;987
44;Grand Est;68;1;09;065;Chavannes-sur-l'Étang;690;12;702
44;Grand Est;68;2;98;066;Colmar;68294;1104;69398
44;Grand Est;68;1;01;067;Courtavon;350;2;352
44;Grand Est;68;1;09;068;Dannemarie;2266;39;2305
44;Grand Est;68;2;06;069;Dessenheim;1477;20;1497
44;Grand Est;68;1;09;071;Diefmatten;284;6;290
44;Grand Est;68;4;02;072;Dietwiller;1422;53;1475
44;Grand Est;68;6;09;073;Dolleren;475;11;486
44;Grand Est;68;1;01;074;Durlinsdorf;552;7;559
44;Grand Est;68;1;01;075;Durmenach;829;16;845
44;Grand Est;68;2;06;076;Durrenentzen;1009;12;1021
44;Grand Est;68;1;09;077;Eglingen;378;10;388
44;Grand Est;68;2;16;078;Eguisheim;1722;41;1763
44;Grand Est;68;1;09;079;Elbach;256;0;256
44;Grand Est;68;1;01;080;Emlingen;307;3;310
44;Grand Est;68;1;01;081;Saint-Bernard;579;10;589
44;Grand Est;68;6;06;082;Ensisheim;7475;70;7545
44;Grand Est;68;2;16;083;Eschbach-au-Val;368;8;376
44;Grand Est;68;4;02;084;Eschentzwiller;1476;46;1522
44;Grand Est;68;1;09;085;Eteimbes;381;6;387
44;Grand Est;68;1;09;086;Falkwiller;208;3;211
44;Grand Est;68;1;01;087;Feldbach;460;11;471
44;Grand Est;68;4;17;088;Feldkirch;999;16;1015
44;Grand Est;68;6;03;089;Fellering;1599;26;1625
44;Grand Est;68;1;01;090;Ferrette;820;13;833
44;Grand Est;68;2;06;091;Fessenheim;2282;46;2328
44;Grand Est;68;1;01;092;Fislis;399;6;405
44;Grand Est;68;4;02;093;Flaxlanden;1415;35;1450
44;Grand Est;68;4;14;094;Folgensbourg;928;19;947
44;Grand Est;68;2;05;095;Fortschwihr;1162;40;1202
44;Grand Est;68;1;01;096;Franken;370;5;375
44;Grand Est;68;2;15;097;Fréland;1310;33;1343
44;Grand Est;68;1;09;098;Friesen;656;7;663
44;Grand Est;68;1;01;099;Frœningen;831;18;849
44;Grand Est;68;1;09;100;Fulleren;340;14;354
44;Grand Est;68;4;08;101;Galfingue;816;23;839
44;Grand Est;68;6;03;102;Geishouse;438;10;448
44;Grand Est;68;4;02;103;Geispitzen;505;12;517
44;Grand Est;68;2;06;104;Geiswasser;309;5;314
44;Grand Est;68;1;09;105;Gildwiller;261;14;275
44;Grand Est;68;6;03;106;Goldbach-Altenbach;276;6;282
44;Grand Est;68;1;09;107;Gommersdorf;382;8;390
44;Grand Est;68;2;16;109;Griesbach-au-Val;691;14;705
44;Grand Est;68;2;05;110;Grussenheim;794;18;812
44;Grand Est;68;6;16;111;Gueberschwihr;859;26;885
44;Grand Est;68;6;07;112;Guebwiller;10988;293;11281
44;Grand Est;68;2;15;113;Guémar;1432;28;1460
44;Grand Est;68;1;09;114;Guevenatten;144;1;145
44;Grand Est;68;6;09;115;Guewenheim;1312;29;1341
44;Grand Est;68;6;16;116;Gundolsheim;725;22;747
44;Grand Est;68;2;16;117;Gunsbach;880;16;896
44;Grand Est;68;4;13;118;Habsheim;5052;90;5142
44;Grand Est;68;1;09;119;Hagenbach;753;16;769
44;Grand Est;68;4;14;120;Hagenthal-le-Bas;1275;28;1303
44;Grand Est;68;4;14;121;Hagenthal-le-Haut;719;15;734
44;Grand Est;68;6;07;122;Hartmannswiller;646;10;656
44;Grand Est;68;6;16;123;Hattstatt;809;12;821
44;Grand Est;68;1;01;124;Hausgauen;378;10;388
44;Grand Est;68;1;09;125;Hecken;529;9;538
44;Grand Est;68;4;14;126;Hégenheim;3362;73;3435
44;Grand Est;68;1;01;127;Heidwiller;666;14;680
44;Grand Est;68;1;01;128;Heimersdorf;659;9;668
44;Grand Est;68;4;08;129;Heimsbrunn;1333;50;1383
44;Grand Est;68;2;06;130;Heiteren;1047;22;1069
44;Grand Est;68;1;01;131;Heiwiller;164;1;165
44;Grand Est;68;4;02;132;Helfrantzkirch;728;17;745
44;Grand Est;68;2;16;134;Herrlisheim-près-Colmar;1870;28;1898
44;Grand Est;68;4;14;135;Hésingue;2804;57;2861
44;Grand Est;68;2;06;136;Hettenschlag;332;12;344
44;Grand Est;68;1;09;137;Hindlingen;616;11;627
44;Grand Est;68;1;01;138;Hirsingue;2120;50;2170
44;Grand Est;68;1;01;139;Hirtzbach;1477;22;1499
44;Grand Est;68;2;06;140;Hirtzfelden;1313;15;1328
44;Grand Est;68;1;01;141;Hochstatt;2179;55;2234
44;Grand Est;68;2;16;142;Hohrod;375;13;388
44;Grand Est;68;2;05;143;Porte du Ried;1843;60;1903
44;Grand Est;68;4;13;144;Hombourg;1348;26;1374
44;Grand Est;68;2;05;145;Horbourg-Wihr;6244;121;6365
44;Grand Est;68;2;05;146;Houssen;2405;23;2428
44;Grand Est;68;2;15;147;Hunawihr;587;15;602
44;Grand Est;68;1;01;148;Hundsbach;359;18;377
44;Grand Est;68;4;14;149;Huningue;7283;96;7379
44;Grand Est;68;2;16;150;Husseren-les-Châteaux;509;15;524
44;Grand Est;68;6;03;151;Husseren-Wesserling;1049;11;1060
44;Grand Est;68;1;01;152;Illfurth;2464;65;2529
44;Grand Est;68;2;15;153;Illhaeusern;727;13;740
44;Grand Est;68;4;12;154;Illzach;14380;205;14585
44;Grand Est;68;2;04;155;Ingersheim;4680;75;4755
44;Grand Est;68;6;07;156;Issenheim;3449;57;3506
44;Grand Est;68;2;05;157;Jebsheim;1349;39;1388
44;Grand Est;68;1;01;158;Jettingen;500;15;515
44;Grand Est;68;6;07;159;Jungholtz;917;25;942
44;Grand Est;68;4;02;160;Kappelen;584;24;608
44;Grand Est;68;2;15;161;Katzenthal;538;23;561
44;Grand Est;68;2;15;162;Kaysersberg Vignoble;4412;93;4505
44;Grand Est;68;4;02;163;Kembs;5617;104;5721
44;Grand Est;68;1;01;165;Kiffis;239;10;249
44;Grand Est;68;4;08;166;Kingersheim;13230;161;13391
44;Grand Est;68;6;09;167;Kirchberg;728;21;749
44;Grand Est;68;4;14;168;Knœringue;373;7;380
44;Grand Est;68;1;01;169;Kœstlach;504;10;514
44;Grand Est;68;4;02;170;Kœtzingue;580;24;604
44;Grand Est;68;6;03;171;Kruth;937;12;949
44;Grand Est;68;2;06;172;Kunheim;1820;30;1850
44;Grand Est;68;2;15;173;Labaroche;2111;76;2187
44;Grand Est;68;4;02;174;Landser;1646;27;1673
44;Grand Est;68;2;15;175;Lapoutroie;1851;39;1890
44;Grand Est;68;1;09;176;Largitzen;327;7;334
44;Grand Est;68;6;07;177;Lautenbach;1479;38;1517
44;Grand Est;68;6;07;178;Lautenbachzell;951;14;965
44;Grand Est;68;6;09;179;Lauw;915;15;930
44;Grand Est;68;6;03;180;Leimbach;918;29;947
44;Grand Est;68;1;01;181;Levoncourt;250;4;254
44;Grand Est;68;4;14;182;Leymen;1246;28;1274
44;Grand Est;68;4;14;183;Liebenswiller;179;4;183
44;Grand Est;68;1;01;184;Liebsdorf;299;5;304
44;Grand Est;68;2;15;185;Lièpvre;1664;30;1694
44;Grand Est;68;1;01;186;Ligsdorf;310;8;318
44;Grand Est;68;1;01;187;Linsdorf;339;9;348
44;Grand Est;68;6;07;188;Linthal;584;16;600
44;Grand Est;68;2;06;189;Logelheim;874;27;901
44;Grand Est;68;1;01;190;Lucelle;33;0;33
44;Grand Est;68;1;01;191;Luemschwiller;751;22;773
44;Grand Est;68;1;09;192;Valdieu-Lutran;431;7;438
44;Grand Est;68;2;16;193;Luttenbach-près-Munster;758;9;767
44;Grand Est;68;1;01;194;Lutter;286;5;291
44;Grand Est;68;4;08;195;Lutterbach;6237;102;6339
44;Grand Est;68;1;09;196;Magny;295;8;303
44;Grand Est;68;4;02;197;Magstatt-le-Bas;495;10;505
44;Grand Est;68;4;02;198;Magstatt-le-Haut;290;8;298
44;Grand Est;68;6;03;199;Malmerspach;501;2;503
44;Grand Est;68;1;09;200;Manspach;536;12;548
44;Grand Est;68;6;09;201;Masevaux-Niederbruck;3682;77;3759
44;Grand Est;68;1;09;202;Mertzen;196;4;200
44;Grand Est;68;6;07;203;Merxheim;1275;27;1302
44;Grand Est;68;2;16;204;Metzeral;1042;15;1057
44;Grand Est;68;6;06;205;Meyenheim;2005;21;2026
44;Grand Est;68;4;14;207;Michelbach-le-Bas;701;14;715
44;Grand Est;68;4;14;208;Michelbach-le-Haut;590;12;602
44;Grand Est;68;2;15;209;Mittelwihr;842;16;858
44;Grand Est;68;2;16;210;Mittlach;332;4;336
44;Grand Est;68;6;03;211;Mitzach;384;8;392
44;Grand Est;68;1;01;212;Mœrnach;516;12;528
44;Grand Est;68;6;03;213;Mollau;339;9;348
44;Grand Est;68;1;09;214;Montreux-Jeune;375;8;383
44;Grand Est;68;1;09;215;Montreux-Vieux;911;7;918
44;Grand Est;68;1;09;216;Mooslargue;411;6;417
44;Grand Est;68;6;03;217;Moosch;1622;21;1643
44;Grand Est;68;4;08;218;Morschwiller-le-Bas;3648;72;3720
44;Grand Est;68;6;09;219;Le Haut Soultzbach;878;24;902
44;Grand Est;68;1;01;221;Muespach;929;20;949
44;Grand Est;68;1;01;222;Muespach-le-Haut;1076;20;1096
44;Grand Est;68;2;16;223;Muhlbach-sur-Munster;795;17;812
44;Grand Est;68;4;99;224;Mulhouse;108038;1247;109285
44;Grand Est;68;2;06;225;Munchhouse;1577;28;1605
44;Grand Est;68;2;16;226;Munster;4711;83;4794
44;Grand Est;68;2;05;227;Muntzenheim;1284;28;1312
44;Grand Est;68;6;06;228;Munwiller;459;12;471
44;Grand Est;68;6;07;229;Murbach;164;3;167
44;Grand Est;68;2;06;230;Nambsheim;583;7;590
44;Grand Est;68;2;06;231;Neuf-Brisach;1955;15;1970
44;Grand Est;68;4;14;232;Neuwiller;495;7;502
44;Grand Est;68;6;06;234;Niederentzen;738;11;749
44;Grand Est;68;6;06;235;Niederhergheim;1148;16;1164
44;Grand Est;68;2;16;237;Niedermorschwihr;557;15;572
44;Grand Est;68;4;13;238;Niffer;953;26;979
44;Grand Est;68;6;09;239;Oberbruck;391;13;404
44;Grand Est;68;1;01;240;Illtal;1269;18;1287
44;Grand Est;68;6;06;241;Oberentzen;686;10;696
44;Grand Est;68;6;06;242;Oberhergheim;1266;25;1291
44;Grand Est;68;1;01;243;Oberlarg;139;1;140
44;Grand Est;68;2;16;244;Obermorschwihr;378;6;384
44;Grand Est;68;1;01;245;Obermorschwiller;405;15;420
44;Grand Est;68;2;06;246;Obersaasheim;1025;13;1038
44;Grand Est;68;6;03;247;Oderen;1256;14;1270
44;Grand Est;68;1;01;248;Oltingue;674;20;694
44;Grand Est;68;2;15;249;Orbey;3461;66;3527
44;Grand Est;68;6;07;250;Orschwihr;1042;18;1060
44;Grand Est;68;6;16;251;Osenbach;842;22;864
44;Grand Est;68;2;15;252;Ostheim;1660;29;1689
44;Grand Est;68;4;13;253;Ottmarsheim;1985;33;2018
44;Grand Est;68;4;13;254;Petit-Landau;826;18;844
44;Grand Est;68;6;16;255;Pfaffenheim;1350;42;1392
44;Grand Est;68;4;08;256;Pfastatt;10054;131;10185
44;Grand Est;68;1;09;257;Pfetterhouse;957;24;981
44;Grand Est;68;4;17;258;Pulversheim;3097;79;3176
44;Grand Est;68;1;01;259;Raedersdorf;504;11;515
44;Grand Est;68;6;07;260;Raedersheim;1121;25;1146
44;Grand Est;68;6;03;261;Rammersmatt;228;6;234
44;Grand Est;68;6;03;262;Ranspach;796;17;813
44;Grand Est;68;4;14;263;Ranspach-le-Bas;630;13;643
44;Grand Est;68;4;14;264;Ranspach-le-Haut;627;19;646
44;Grand Est;68;4;02;265;Rantzwiller;800;24;824
44;Grand Est;68;6;06;266;Réguisheim;2006;29;2035
44;Grand Est;68;4;08;267;Reiningue;1986;25;2011
44;Grand Est;68;1;09;268;Retzwiller;701;10;711
44;Grand Est;68;2;15;269;Ribeauvillé;4670;177;4847
44;Grand Est;68;4;08;270;Richwiller;3680;59;3739
44;Grand Est;68;4;13;271;Riedisheim;12258;304;12562
44;Grand Est;68;1;01;273;Riespach;626;41;667
44;Grand Est;68;6;07;274;Rimbach-près-Guebwiller;195;2;197
44;Grand Est;68;6;09;275;Rimbach-près-Masevaux;437;11;448
44;Grand Est;68;6;07;276;Rimbachzell;194;4;198
44;Grand Est;68;2;15;277;Riquewihr;1061;22;1083
44;Grand Est;68;4;13;278;Rixheim;14020;225;14245
44;Grand Est;68;6;03;279;Roderen;910;30;940
44;Grand Est;68;2;15;280;Rodern;381;6;387
44;Grand Est;68;2;06;281;Roggenhouse;465;13;478
44;Grand Est;68;1;09;282;Romagny;280;5;285
44;Grand Est;68;2;15;283;Rombach-le-Franc;776;14;790
44;Grand Est;68;1;01;284;Roppentzwiller;686;11;697
44;Grand Est;68;2;15;285;Rorschwihr;367;8;375
44;Grand Est;68;4;14;286;Rosenau;2371;49;2420
44;Grand Est;68;6;16;287;Rouffach;4187;229;4416
44;Grand Est;68;1;01;288;Ruederbach;406;4;410
44;Grand Est;68;4;17;289;Ruelisheim;2384;37;2421
44;Grand Est;68;2;06;290;Rustenhart;902;19;921
44;Grand Est;68;2;06;291;Rumersheim-le-Haut;1049;26;1075
44;Grand Est;68;6;03;292;Saint-Amarin;2217;38;2255
44;Grand Est;68;1;09;293;Saint-Cosme;81;1;82
44;Grand Est;68;2;15;294;Sainte-Croix-aux-Mines;1857;30;1887
44;Grand Est;68;2;05;295;Sainte-Croix-en-Plaine;3024;67;3091
44;Grand Est;68;2;15;296;Saint-Hippolyte;980;14;994
44;Grand Est;68;4;14;297;Saint-Louis;22835;287;23122
44;Grand Est;68;2;15;298;Sainte-Marie-aux-Mines;5054;128;5182
44;Grand Est;68;1;09;299;Saint-Ulrich;310;0;310
44;Grand Est;68;4;13;300;Sausheim;5487;124;5611
44;Grand Est;68;4;02;301;Schlierbach;1271;24;1295
44;Grand Est;68;6;03;302;Schweighouse-Thann;744;30;774
44;Grand Est;68;1;01;303;Schwoben;226;7;233
44;Grand Est;68;6;09;304;Sentheim;1564;39;1603
44;Grand Est;68;1;09;305;Seppois-le-Bas;1391;28;1419
44;Grand Est;68;1;09;306;Seppois-le-Haut;503;7;510
44;Grand Est;68;6;09;307;Sewen;498;10;508
44;Grand Est;68;6;09;308;Sickert;327;4;331
44;Grand Est;68;4;02;309;Sierentz;3994;63;4057
44;Grand Est;68;2;16;311;Sondernach;600;12;612
44;Grand Est;68;1;01;312;Sondersdorf;317;6;323
44;Grand Est;68;6;09;313;Soppe-le-Bas;774;11;785
44;Grand Est;68;6;07;315;Soultz-Haut-Rhin;7033;143;7176
44;Grand Est;68;2;16;316;Soultzbach-les-Bains;728;21;749
44;Grand Est;68;2;16;317;Soultzeren;1096;20;1116
44;Grand Est;68;6;16;318;Soultzmatt;2379;53;2432
44;Grand Est;68;1;01;320;Spechbach;1398;47;1445
44;Grand Est;68;4;17;321;Staffelfelden;4053;35;4088
44;Grand Est;68;6;03;322;Steinbach;1350;29;1379
44;Grand Est;68;4;02;323;Steinbrunn-le-Bas;830;24;854
44;Grand Est;68;4;02;324;Steinbrunn-le-Haut;631;19;650
44;Grand Est;68;1;01;325;Steinsoultz;761;9;770
44;Grand Est;68;1;09;326;Sternenberg;151;5;156
44;Grand Est;68;4;02;327;Stetten;345;8;353
44;Grand Est;68;6;03;328;Storckensohn;196;6;202
44;Grand Est;68;2;16;329;Stosswihr;1341;31;1372
44;Grand Est;68;1;09;330;Strueth;341;6;347
44;Grand Est;68;2;05;331;Sundhoffen;1955;58;2013
44;Grand Est;68;1;01;332;Tagolsheim;953;13;966
44;Grand Est;68;1;01;333;Tagsdorf;293;6;299
44;Grand Est;68;6;03;334;Thann;7784;148;7932
44;Grand Est;68;2;15;335;Thannenkirch;469;6;475
44;Grand Est;68;1;09;336;Traubach-le-Bas;455;8;463
44;Grand Est;68;1;09;337;Traubach-le-Haut;619;11;630
44;Grand Est;68;2;16;338;Turckheim;3820;82;3902
44;Grand Est;68;1;09;340;Ueberstrass;369;16;385
44;Grand Est;68;4;02;341;Uffheim;989;30;1019
44;Grand Est;68;6;03;342;Uffholtz;1650;42;1692
44;Grand Est;68;4;17;343;Ungersheim;2422;33;2455
44;Grand Est;68;6;03;344;Urbès;439;10;449
44;Grand Est;68;2;06;345;Urschenheim;778;27;805
44;Grand Est;68;1;01;347;Vieux-Ferrette;676;13;689
44;Grand Est;68;6;03;348;Vieux-Thann;2836;37;2873
44;Grand Est;68;4;14;349;Village-Neuf;4486;95;4581
44;Grand Est;68;2;16;350;Vœgtlinshoffen;473;15;488
44;Grand Est;68;2;06;351;Vogelgrun;634;13;647
44;Grand Est;68;2;06;352;Volgelsheim;2691;29;2720
44;Grand Est;68;4;02;353;Wahlbach;487;17;504
44;Grand Est;68;2;16;354;Walbach;918;36;954
44;Grand Est;68;1;01;355;Waldighofen;1544;28;1572
44;Grand Est;68;1;01;356;Walheim;883;20;903
44;Grand Est;68;4;02;357;Waltenheim;513;16;529
44;Grand Est;68;2;16;358;Wasserbourg;475;11;486
44;Grand Est;68;6;03;359;Wattwiller;1678;59;1737
44;Grand Est;68;2;06;360;Weckolsheim;673;4;677
44;Grand Est;68;6;09;361;Wegscheid;319;4;323
44;Grand Est;68;4;14;362;Wentzwiller;774;15;789
44;Grand Est;68;1;01;363;Werentzhouse;609;12;621
44;Grand Est;68;6;16;364;Westhalten;998;23;1021
44;Grand Est;68;2;16;365;Wettolsheim;1775;65;1840
44;Grand Est;68;2;05;366;Wickerschwihr;697;30;727
44;Grand Est;68;2;06;367;Widensolen;1195;21;1216
44;Grand Est;68;2;16;368;Wihr-au-Val;1231;36;1267
44;Grand Est;68;6;03;370;Wildenstein;163;2;165
44;Grand Est;68;1;01;371;Willer;307;9;316
44;Grand Est;68;6;03;372;Willer-sur-Thur;1777;39;1816
44;Grand Est;68;1;01;373;Winkel;296;12;308
44;Grand Est;68;2;16;374;Wintzenheim;7933;324;8257
44;Grand Est;68;4;17;375;Wittelsheim;10358;142;10500
44;Grand Est;68;4;17;376;Wittenheim;15065;101;15166
44;Grand Est;68;1;01;377;Wittersdorf;796;19;815
44;Grand Est;68;1;09;378;Wolfersdorf;373;4;377
44;Grand Est;68;2;06;379;Wolfgantzen;1099;21;1120
44;Grand Est;68;1;01;380;Wolschwiller;440;10;450
44;Grand Est;68;6;07;381;Wuenheim;789;9;798
44;Grand Est;68;4;02;382;Zaessingue;391;4;395
44;Grand Est;68;2;15;383;Zellenberg;319;8;327
44;Grand Est;68;4;02;384;Zillisheim;2524;61;2585
44;Grand Est;68;2;16;385;Zimmerbach;832;24;856
44;Grand Est;68;4;02;386;Zimmersheim;1053;22;1075
84;Auvergne-Rhône-Alpes;69;2;10;001;Affoux;393;4;397
84;Auvergne-Rhône-Alpes;69;2;11;002;Aigueperse;244;1;245
84;Auvergne-Rhône-Alpes;69;1;00;003;Albigny-sur-Saône;2982;43;3025
84;Auvergne-Rhône-Alpes;69;2;04;004;Alix;766;23;789
84;Auvergne-Rhône-Alpes;69;2;01;005;Ambérieux;589;10;599
84;Auvergne-Rhône-Alpes;69;2;11;006;Amplepuis;4906;112;5018
84;Auvergne-Rhône-Alpes;69;1;08;007;Ampuis;2743;44;2787
84;Auvergne-Rhône-Alpes;69;2;10;008;Ancy;675;15;690
84;Auvergne-Rhône-Alpes;69;2;01;009;Anse;7754;153;7907
84;Auvergne-Rhône-Alpes;69;2;02;010;L'Arbresle;6437;154;6591
84;Auvergne-Rhône-Alpes;69;2;03;012;Les Ardillats;606;15;621
84;Auvergne-Rhône-Alpes;69;2;07;013;Arnas;4063;85;4148
84;Auvergne-Rhône-Alpes;69;1;12;014;Aveize;1122;19;1141
84;Auvergne-Rhône-Alpes;69;2;11;016;Azolette;121;4;125
84;Auvergne-Rhône-Alpes;69;2;04;017;Bagnols;745;20;765
84;Auvergne-Rhône-Alpes;69;2;03;018;Beaujeu;2144;32;2176
84;Auvergne-Rhône-Alpes;69;2;03;019;Belleville-en-Beaujolais;13336;280;13616
84;Auvergne-Rhône-Alpes;69;2;04;020;Belmont-d'Azergues;693;10;703
84;Auvergne-Rhône-Alpes;69;2;02;021;Bessenay;2346;78;2424
84;Auvergne-Rhône-Alpes;69;2;02;022;Bibost;549;15;564
84;Auvergne-Rhône-Alpes;69;2;07;023;Blacé;1646;26;1672
84;Auvergne-Rhône-Alpes;69;2;04;024;Val d'Oingt;4157;101;4258
84;Auvergne-Rhône-Alpes;69;2;04;026;Le Breuil;542;7;549
84;Auvergne-Rhône-Alpes;69;1;05;027;Brignais;12403;169;12572
84;Auvergne-Rhône-Alpes;69;1;05;028;Brindas;6589;113;6702
84;Auvergne-Rhône-Alpes;69;1;00;029;Bron;42442;377;42819
84;Auvergne-Rhône-Alpes;69;1;02;030;Brullioles;819;14;833
84;Auvergne-Rhône-Alpes;69;1;02;031;Brussieu;1374;104;1478
84;Auvergne-Rhône-Alpes;69;2;04;032;Bully;2005;37;2042
84;Auvergne-Rhône-Alpes;69;1;00;033;Cailloux-sur-Fontaines;2879;73;2952
84;Auvergne-Rhône-Alpes;69;1;00;034;Caluire-et-Cuire;43355;574;43929
84;Auvergne-Rhône-Alpes;69;2;03;035;Cenves;379;7;386
84;Auvergne-Rhône-Alpes;69;2;03;036;Cercié;1135;23;1158
84;Auvergne-Rhône-Alpes;69;2;10;037;Chambost-Allières;830;12;842
84;Auvergne-Rhône-Alpes;69;1;02;038;Chambost-Longessaigne;924;23;947
84;Auvergne-Rhône-Alpes;69;2;04;039;Chamelet;697;9;706
84;Auvergne-Rhône-Alpes;69;1;00;040;Champagne-au-Mont-d'Or;5749;44;5793
84;Auvergne-Rhône-Alpes;69;1;12;042;La Chapelle-sur-Coise;570;15;585
84;Auvergne-Rhône-Alpes;69;1;05;043;Chaponost;8887;178;9065
84;Auvergne-Rhône-Alpes;69;1;00;044;Charbonnières-les-Bains;5237;148;5385
84;Auvergne-Rhône-Alpes;69;2;03;045;Charentay;1253;67;1320
84;Auvergne-Rhône-Alpes;69;1;00;046;Charly;4585;138;4723
84;Auvergne-Rhône-Alpes;69;2;04;047;Charnay;1047;21;1068
84;Auvergne-Rhône-Alpes;69;2;01;049;Chasselay;2833;65;2898
84;Auvergne-Rhône-Alpes;69;2;04;050;Châtillon;2114;42;2156
84;Auvergne-Rhône-Alpes;69;1;08;051;Chaussan;1200;34;1234
84;Auvergne-Rhône-Alpes;69;2;01;052;Chazay-d'Azergues;4153;117;4270
84;Auvergne-Rhône-Alpes;69;2;03;053;Chénas;542;13;555
84;Auvergne-Rhône-Alpes;69;2;11;054;Chénelette;354;2;356
84;Auvergne-Rhône-Alpes;69;2;01;055;Les Chères;1505;28;1533
84;Auvergne-Rhône-Alpes;69;2;04;056;Chessy;2080;89;2169
84;Auvergne-Rhône-Alpes;69;2;02;057;Chevinay;583;13;596
84;Auvergne-Rhône-Alpes;69;2;03;058;Chiroubles;380;11;391
84;Auvergne-Rhône-Alpes;69;2;01;059;Civrieux-d'Azergues;1550;29;1579
84;Auvergne-Rhône-Alpes;69;2;11;060;Claveisolles;570;82;652
84;Auvergne-Rhône-Alpes;69;2;04;061;Cogny;1199;34;1233
84;Auvergne-Rhône-Alpes;69;1;12;062;Coise;782;24;806
84;Auvergne-Rhône-Alpes;69;1;00;063;Collonges-au-Mont-d'Or;4448;91;4539
84;Auvergne-Rhône-Alpes;69;1;08;064;Condrieu;3949;82;4031
84;Auvergne-Rhône-Alpes;69;2;03;065;Corcelles-en-Beaujolais;977;15;992
84;Auvergne-Rhône-Alpes;69;2;11;066;Cours;4366;91;4457
84;Auvergne-Rhône-Alpes;69;2;02;067;Courzieu;1169;23;1192
84;Auvergne-Rhône-Alpes;69;1;00;068;Couzon-au-Mont-d'Or;2455;44;2499
84;Auvergne-Rhône-Alpes;69;1;00;069;Craponne;11453;204;11657
84;Auvergne-Rhône-Alpes;69;2;11;070;Cublize;1296;24;1320
84;Auvergne-Rhône-Alpes;69;1;00;071;Curis-au-Mont-d'Or;1182;26;1208
84;Auvergne-Rhône-Alpes;69;1;00;072;Dardilly;8829;630;9459
84;Auvergne-Rhône-Alpes;69;2;07;074;Denicé;1568;39;1607
84;Auvergne-Rhône-Alpes;69;2;10;075;Dième;191;2;193
84;Auvergne-Rhône-Alpes;69;2;01;076;Dommartin;2551;99;2650
84;Auvergne-Rhône-Alpes;69;2;03;077;Dracé;1035;16;1051
84;Auvergne-Rhône-Alpes;69;1;12;078;Duerne;839;16;855
84;Auvergne-Rhône-Alpes;69;1;08;080;Échalas;1914;15;1929
84;Auvergne-Rhône-Alpes;69;1;00;081;Écully;18789;353;19142
84;Auvergne-Rhône-Alpes;69;2;03;082;Émeringes;277;8;285
84;Auvergne-Rhône-Alpes;69;2;02;083;Éveux;1159;40;1199
84;Auvergne-Rhône-Alpes;69;2;03;084;Fleurie;1300;24;1324
84;Auvergne-Rhône-Alpes;69;1;00;085;Fleurieu-sur-Saône;1491;42;1533
84;Auvergne-Rhône-Alpes;69;2;02;086;Fleurieux-sur-l'Arbresle;2272;63;2335
84;Auvergne-Rhône-Alpes;69;1;00;087;Fontaines-Saint-Martin;3015;73;3088
84;Auvergne-Rhône-Alpes;69;1;00;088;Fontaines-sur-Saône;7065;94;7159
84;Auvergne-Rhône-Alpes;69;1;00;089;Francheville;14821;225;15046
84;Auvergne-Rhône-Alpes;69;2;04;090;Frontenas;841;22;863
84;Auvergne-Rhône-Alpes;69;1;00;091;Givors;20672;126;20798
84;Auvergne-Rhône-Alpes;69;2;07;092;Gleizé;7495;348;7843
84;Auvergne-Rhône-Alpes;69;2;10;093;Grandris;1185;20;1205
84;Auvergne-Rhône-Alpes;69;1;05;094;Grézieu-la-Varenne;6029;115;6144
84;Auvergne-Rhône-Alpes;69;1;12;095;Grézieu-le-Marché;824;16;840
84;Auvergne-Rhône-Alpes;69;1;00;096;Grigny;9739;75;9814
84;Auvergne-Rhône-Alpes;69;1;08;097;Les Haies;773;19;792
84;Auvergne-Rhône-Alpes;69;1;02;098;Les Halles;496;9;505
84;Auvergne-Rhône-Alpes;69;1;02;099;Haute-Rivoire;1436;24;1460
84;Auvergne-Rhône-Alpes;69;1;00;100;Irigny;8805;119;8924
84;Auvergne-Rhône-Alpes;69;2;10;102;Joux;756;10;766
84;Auvergne-Rhône-Alpes;69;2;03;103;Juliénas;886;18;904
84;Auvergne-Rhône-Alpes;69;2;03;104;Jullié;454;5;459
84;Auvergne-Rhône-Alpes;69;2;07;105;Lacenas;1007;36;1043
84;Auvergne-Rhône-Alpes;69;2;01;106;Lachassagne;1209;24;1233
84;Auvergne-Rhône-Alpes;69;2;10;107;Lamure-sur-Azergues;1049;64;1113
84;Auvergne-Rhône-Alpes;69;2;03;108;Lancié;1043;21;1064
84;Auvergne-Rhône-Alpes;69;2;03;109;Lantignié;851;26;877
84;Auvergne-Rhône-Alpes;69;1;12;110;Larajasse;1848;34;1882
84;Auvergne-Rhône-Alpes;69;2;04;111;Légny;681;18;699
84;Auvergne-Rhône-Alpes;69;2;01;112;Lentilly;6510;157;6667
84;Auvergne-Rhône-Alpes;69;2;04;113;Létra;900;27;927
84;Auvergne-Rhône-Alpes;69;2;07;115;Limas;4830;93;4923
84;Auvergne-Rhône-Alpes;69;1;00;116;Limonest;3742;108;3850
84;Auvergne-Rhône-Alpes;69;1;00;117;Lissieu;3157;73;3230
84;Auvergne-Rhône-Alpes;69;1;08;118;Loire-sur-Rhône;2660;34;2694
84;Auvergne-Rhône-Alpes;69;1;08;119;Longes;977;8;985
84;Auvergne-Rhône-Alpes;69;1;02;120;Longessaigne;596;16;612
84;Auvergne-Rhône-Alpes;69;2;01;121;Lozanne;2880;44;2924
84;Auvergne-Rhône-Alpes;69;2;01;122;Lucenay;1969;54;2023
84;Auvergne-Rhône-Alpes;69;2;03;124;Marchampt;457;10;467
84;Auvergne-Rhône-Alpes;69;2;01;125;Marcilly-d'Azergues;880;16;896
84;Auvergne-Rhône-Alpes;69;2;01;126;Marcy;805;21;826
84;Auvergne-Rhône-Alpes;69;1;00;127;Marcy-l'Étoile;3495;63;3558
84;Auvergne-Rhône-Alpes;69;2;11;130;Meaux-la-Montagne;232;2;234
84;Auvergne-Rhône-Alpes;69;1;05;131;Messimy;3523;88;3611
84;Auvergne-Rhône-Alpes;69;1;12;132;Meys;843;14;857
84;Auvergne-Rhône-Alpes;69;1;09;133;Millery;4313;79;4392
84;Auvergne-Rhône-Alpes;69;2;04;134;Moiré;230;10;240
84;Auvergne-Rhône-Alpes;69;2;11;135;Deux-Grosnes;1914;53;1967
84;Auvergne-Rhône-Alpes;69;1;09;136;Montagny;3180;56;3236
84;Auvergne-Rhône-Alpes;69;2;07;137;Montmelas-Saint-Sorlin;534;6;540
84;Auvergne-Rhône-Alpes;69;1;02;138;Montromant;445;8;453
84;Auvergne-Rhône-Alpes;69;1;02;139;Montrottier;1379;65;1444
84;Auvergne-Rhône-Alpes;69;2;01;140;Morancé;2086;54;2140
84;Auvergne-Rhône-Alpes;69;1;08;141;Mornant;6238;175;6413
84;Auvergne-Rhône-Alpes;69;1;00;142;La Mulatière;6617;73;6690
84;Auvergne-Rhône-Alpes;69;1;00;143;Neuville-sur-Saône;7635;65;7700
84;Auvergne-Rhône-Alpes;69;2;03;145;Odenas;932;26;958
84;Auvergne-Rhône-Alpes;69;1;09;148;Orliénas;2549;71;2620
84;Auvergne-Rhône-Alpes;69;1;00;149;Oullins;26994;269;27263
84;Auvergne-Rhône-Alpes;69;2;07;151;Le Perréon;1492;31;1523
84;Auvergne-Rhône-Alpes;69;1;00;152;Pierre-Bénite;10508;47;10555
84;Auvergne-Rhône-Alpes;69;1;00;153;Poleymieux-au-Mont-d'Or;1400;28;1428
84;Auvergne-Rhône-Alpes;69;1;12;154;Pollionnay;2868;53;2921
84;Auvergne-Rhône-Alpes;69;1;12;155;Pomeys;1131;29;1160
84;Auvergne-Rhône-Alpes;69;2;01;156;Pommiers;2685;81;2766
84;Auvergne-Rhône-Alpes;69;2;10;157;Vindry-sur-Turdine;5280;124;5404
84;Auvergne-Rhône-Alpes;69;2;04;159;Porte des Pierres Dorées;3951;93;4044
84;Auvergne-Rhône-Alpes;69;2;11;160;Poule-les-Écharmeaux;1047;20;1067
84;Auvergne-Rhône-Alpes;69;2;11;161;Propières;485;11;496
84;Auvergne-Rhône-Alpes;69;2;03;162;Quincié-en-Beaujolais;1354;35;1389
84;Auvergne-Rhône-Alpes;69;1;00;163;Quincieux;3502;51;3553
84;Auvergne-Rhône-Alpes;69;2;11;164;Ranchal;323;10;333
84;Auvergne-Rhône-Alpes;69;2;03;165;Régnié-Durette;1137;19;1156
84;Auvergne-Rhône-Alpes;69;1;08;166;Riverie;334;1;335
84;Auvergne-Rhône-Alpes;69;2;07;167;Rivolet;588;10;598
84;Auvergne-Rhône-Alpes;69;1;00;168;Rochetaillée-sur-Saône;1540;40;1580
84;Auvergne-Rhône-Alpes;69;2;11;169;Ronno;645;24;669
84;Auvergne-Rhône-Alpes;69;1;12;170;Rontalon;1160;19;1179
84;Auvergne-Rhône-Alpes;69;2;02;171;Sain-Bel;2434;31;2465
84;Auvergne-Rhône-Alpes;69;2;07;172;Salles-Arbuissonnas-en-Beaujolais;766;27;793
84;Auvergne-Rhône-Alpes;69;2;10;173;Sarcey;1002;24;1026
84;Auvergne-Rhône-Alpes;69;2;10;174;Les Sauvages;612;11;623
84;Auvergne-Rhône-Alpes;69;2;02;175;Savigny;1988;54;2042
84;Auvergne-Rhône-Alpes;69;1;08;176;Soucieu-en-Jarrest;4613;83;4696
84;Auvergne-Rhône-Alpes;69;2;02;177;Sourcieux-les-Mines;2083;44;2127
84;Auvergne-Rhône-Alpes;69;1;02;178;Souzy;806;18;824
84;Auvergne-Rhône-Alpes;69;1;08;179;Beauvallon;4074;76;4150
84;Auvergne-Rhône-Alpes;69;1;12;180;Saint-André-la-Côte;283;9;292
84;Auvergne-Rhône-Alpes;69;2;10;181;Saint-Appolinaire;229;1;230
84;Auvergne-Rhône-Alpes;69;2;11;182;Saint-Bonnet-des-Bruyères;361;4;365
84;Auvergne-Rhône-Alpes;69;2;11;183;Saint-Bonnet-le-Troncy;316;2;318
84;Auvergne-Rhône-Alpes;69;1;12;184;Sainte-Catherine;997;21;1018
84;Auvergne-Rhône-Alpes;69;2;11;186;Saint-Clément-de-Vers;207;4;211
84;Auvergne-Rhône-Alpes;69;1;02;187;Saint-Clément-les-Places;653;20;673
84;Auvergne-Rhône-Alpes;69;2;10;188;Saint-Clément-sur-Valsonne;907;9;916
84;Auvergne-Rhône-Alpes;69;1;08;189;Sainte-Colombe;1986;31;2017
84;Auvergne-Rhône-Alpes;69;1;12;190;Sainte-Consorce;2065;88;2153
84;Auvergne-Rhône-Alpes;69;1;00;191;Saint-Cyr-au-Mont-d'Or;5686;145;5831
84;Auvergne-Rhône-Alpes;69;2;07;192;Saint-Cyr-le-Chatoux;153;7;160
84;Auvergne-Rhône-Alpes;69;1;08;193;Saint-Cyr-sur-le-Rhône;1272;33;1305
84;Auvergne-Rhône-Alpes;69;1;00;194;Saint-Didier-au-Mont-d'Or;7124;181;7305
84;Auvergne-Rhône-Alpes;69;2;03;196;Saint-Didier-sur-Beaujeu;609;13;622
84;Auvergne-Rhône-Alpes;69;2;07;197;Saint-Étienne-des-Oullières;2212;48;2260
84;Auvergne-Rhône-Alpes;69;2;03;198;Saint-Étienne-la-Varenne;764;11;775
84;Auvergne-Rhône-Alpes;69;1;00;199;Saint-Fons;19500;56;19556
84;Auvergne-Rhône-Alpes;69;2;10;200;Saint-Forgeux;1494;20;1514
84;Auvergne-Rhône-Alpes;69;1;02;201;Sainte-Foy-l'Argentière;1287;22;1309
84;Auvergne-Rhône-Alpes;69;1;00;202;Sainte-Foy-lès-Lyon;22077;375;22452
84;Auvergne-Rhône-Alpes;69;1;02;203;Saint-Genis-l'Argentière;1000;17;1017
84;Auvergne-Rhône-Alpes;69;1;00;204;Saint-Genis-Laval;20971;468;21439
84;Auvergne-Rhône-Alpes;69;1;00;205;Saint-Genis-les-Ollières;5229;95;5324
84;Auvergne-Rhône-Alpes;69;2;07;206;Saint-Georges-de-Reneins;4403;94;4497
84;Auvergne-Rhône-Alpes;69;1;00;207;Saint-Germain-au-Mont-d'Or;2981;49;3030
84;Auvergne-Rhône-Alpes;69;2;04;208;Saint-Germain-Nuelles;2247;62;2309
84;Auvergne-Rhône-Alpes;69;2;11;209;Saint-Igny-de-Vers;556;13;569
84;Auvergne-Rhône-Alpes;69;2;04;212;Saint-Jean-des-Vignes;476;11;487
84;Auvergne-Rhône-Alpes;69;2;11;214;Saint-Jean-la-Bussière;1196;24;1220
84;Auvergne-Rhône-Alpes;69;2;07;215;Saint-Julien;897;21;918
84;Auvergne-Rhône-Alpes;69;2;02;216;Saint-Julien-sur-Bibost;570;9;579
84;Auvergne-Rhône-Alpes;69;2;10;217;Saint-Just-d'Avray;748;21;769
84;Auvergne-Rhône-Alpes;69;2;03;218;Saint-Lager;1042;17;1059
84;Auvergne-Rhône-Alpes;69;1;08;219;Saint-Laurent-d'Agny;2129;61;2190
84;Auvergne-Rhône-Alpes;69;1;02;220;Saint-Laurent-de-Chamousset;1798;112;1910
84;Auvergne-Rhône-Alpes;69;2;10;225;Saint-Marcel-l'Éclairé;539;14;553
84;Auvergne-Rhône-Alpes;69;1;12;227;Saint-Martin-en-Haut;3860;182;4042
84;Auvergne-Rhône-Alpes;69;1;08;228;Chabanière;4223;71;4294
84;Auvergne-Rhône-Alpes;69;2;11;229;Saint-Nizier-d'Azergues;792;16;808
84;Auvergne-Rhône-Alpes;69;2;04;230;Sainte-Paule;314;6;320
84;Auvergne-Rhône-Alpes;69;2;02;231;Saint-Pierre-la-Palud;2576;60;2636
84;Auvergne-Rhône-Alpes;69;1;00;233;Saint-Romain-au-Mont-d'Or;1235;46;1281
84;Auvergne-Rhône-Alpes;69;2;10;234;Saint-Romain-de-Popey;1619;69;1688
84;Auvergne-Rhône-Alpes;69;1;08;235;Saint-Romain-en-Gal;1972;106;2078
84;Auvergne-Rhône-Alpes;69;1;08;236;Saint-Romain-en-Gier;596;6;602
84;Auvergne-Rhône-Alpes;69;1;12;238;Saint-Symphorien-sur-Coise;3704;93;3797
84;Auvergne-Rhône-Alpes;69;2;04;239;Saint-Vérand;1190;32;1222
84;Auvergne-Rhône-Alpes;69;2;11;240;Saint-Vincent-de-Reins;612;5;617
84;Auvergne-Rhône-Alpes;69;1;09;241;Taluyers;2637;62;2699
84;Auvergne-Rhône-Alpes;69;2;03;242;Taponas;903;12;915
84;Auvergne-Rhône-Alpes;69;2;10;243;Tarare;10572;261;10833
84;Auvergne-Rhône-Alpes;69;1;00;244;Tassin-la-Demi-Lune;22475;320;22795
84;Auvergne-Rhône-Alpes;69;2;04;245;Ternand;712;25;737
84;Auvergne-Rhône-Alpes;69;2;04;246;Theizé;1324;37;1361
84;Auvergne-Rhône-Alpes;69;2;11;248;Thizy-les-Bourgs;5944;117;6061
84;Auvergne-Rhône-Alpes;69;1;12;249;Thurins;3111;64;3175
84;Auvergne-Rhône-Alpes;69;1;00;250;La Tour-de-Salvagny;4249;101;4350
84;Auvergne-Rhône-Alpes;69;1;08;252;Trèves;746;9;755
84;Auvergne-Rhône-Alpes;69;1;08;253;Tupin-et-Semons;646;10;656
84;Auvergne-Rhône-Alpes;69;2;10;254;Valsonne;973;12;985
84;Auvergne-Rhône-Alpes;69;1;12;255;Vaugneray;6082;111;6193
84;Auvergne-Rhône-Alpes;69;1;00;256;Vaulx-en-Velin;51761;229;51990
84;Auvergne-Rhône-Alpes;69;2;07;257;Vaux-en-Beaujolais;1108;26;1134
84;Auvergne-Rhône-Alpes;69;2;03;258;Vauxrenard;320;5;325
84;Auvergne-Rhône-Alpes;69;1;00;259;Vénissieux;66765;252;67017
84;Auvergne-Rhône-Alpes;69;1;00;260;Vernaison;5105;57;5162
84;Auvergne-Rhône-Alpes;69;2;03;261;Vernay;103;1;104
84;Auvergne-Rhône-Alpes;69;1;02;263;Villechenève;880;17;897
84;Auvergne-Rhône-Alpes;69;2;13;264;Villefranche-sur-Saône;36009;410;36419
84;Auvergne-Rhône-Alpes;69;2;04;265;Ville-sur-Jarnioux;803;32;835
84;Auvergne-Rhône-Alpes;69;1;00;266;Villeurbanne;154781;1077;155858
84;Auvergne-Rhône-Alpes;69;2;03;267;Villié-Morgon;2129;114;2243
84;Auvergne-Rhône-Alpes;69;1;05;268;Vourles;3402;93;3495
84;Auvergne-Rhône-Alpes;69;1;12;269;Yzeron;980;24;1004
84;Auvergne-Rhône-Alpes;69;1;09;270;Chaponnay;4411;71;4482
84;Auvergne-Rhône-Alpes;69;1;00;271;Chassieu;10844;140;10984
84;Auvergne-Rhône-Alpes;69;1;09;272;Communay;4455;89;4544
84;Auvergne-Rhône-Alpes;69;1;00;273;Corbas;11161;80;11241
84;Auvergne-Rhône-Alpes;69;1;00;275;Décines-Charpieu;28913;150;29063
84;Auvergne-Rhône-Alpes;69;1;00;276;Feyzin;9926;50;9976
84;Auvergne-Rhône-Alpes;69;1;06;277;Genas;13195;250;13445
84;Auvergne-Rhône-Alpes;69;1;00;278;Genay;5519;107;5626
84;Auvergne-Rhône-Alpes;69;1;00;279;Jonage;6083;75;6158
84;Auvergne-Rhône-Alpes;69;1;06;280;Jons;1537;13;1550
84;Auvergne-Rhône-Alpes;69;1;09;281;Marennes;1947;29;1976
84;Auvergne-Rhône-Alpes;69;1;00;282;Meyzieu;35134;334;35468
84;Auvergne-Rhône-Alpes;69;1;00;283;Mions;13684;152;13836
84;Auvergne-Rhône-Alpes;69;1;00;284;Montanay;3205;116;3321
84;Auvergne-Rhône-Alpes;69;1;06;285;Pusignan;4190;38;4228
84;Auvergne-Rhône-Alpes;69;1;00;286;Rillieux-la-Pape;30887;323;31210
84;Auvergne-Rhône-Alpes;69;1;06;287;Saint-Bonnet-de-Mure;6876;107;6983
84;Auvergne-Rhône-Alpes;69;1;06;288;Saint-Laurent-de-Mure;5609;68;5677
84;Auvergne-Rhône-Alpes;69;1;06;289;Saint-Pierre-de-Chandieu;4616;82;4698
84;Auvergne-Rhône-Alpes;69;1;00;290;Saint-Priest;48318;294;48612
84;Auvergne-Rhône-Alpes;69;1;09;291;Saint-Symphorien-d'Ozon;5850;56;5906
84;Auvergne-Rhône-Alpes;69;1;00;292;Sathonay-Camp;6678;60;6738
84;Auvergne-Rhône-Alpes;69;1;00;293;Sathonay-Village;2409;47;2456
84;Auvergne-Rhône-Alpes;69;1;09;294;Sérézin-du-Rhône;2906;39;2945
84;Auvergne-Rhône-Alpes;69;1;09;295;Simandres;1823;9;1832
84;Auvergne-Rhône-Alpes;69;1;00;296;Solaize;3034;45;3079
84;Auvergne-Rhône-Alpes;69;1;09;297;Ternay;5511;73;5584
84;Auvergne-Rhône-Alpes;69;1;06;298;Toussieu;3204;28;3232
84;Auvergne-Rhône-Alpes;69;1;06;299;Colombier-Saugnieu;2744;43;2787
84;Auvergne-Rhône-Alpes;69;1;00;381;Lyon 1er Arrondissement;29303;805;30108
84;Auvergne-Rhône-Alpes;69;1;00;382;Lyon 2e Arrondissement;30318;312;30630
84;Auvergne-Rhône-Alpes;69;1;00;383;Lyon 3e Arrondissement;101838;951;102789
84;Auvergne-Rhône-Alpes;69;1;00;384;Lyon 4e Arrondissement;35683;411;36094
84;Auvergne-Rhône-Alpes;69;1;00;385;Lyon 5e Arrondissement;49546;1060;50606
84;Auvergne-Rhône-Alpes;69;1;00;386;Lyon 6e Arrondissement;52621;827;53448
84;Auvergne-Rhône-Alpes;69;1;00;387;Lyon 7e Arrondissement;84310;478;84788
84;Auvergne-Rhône-Alpes;69;1;00;388;Lyon 8e Arrondissement;85980;1016;86996
84;Auvergne-Rhône-Alpes;69;1;00;389;Lyon 9e Arrondissement;52629;545;53174
27;Bourgogne-Franche-Comté;70;1;13;001;Abelcourt;350;7;357
27;Bourgogne-Franche-Comté;70;2;05;002;Aboncourt-Gesincourt;212;2;214
27;Bourgogne-Franche-Comté;70;2;01;003;Achey;69;2;71
27;Bourgogne-Franche-Comté;70;1;06;004;Adelans-et-le-Val-de-Bithaine;310;1;311
27;Bourgogne-Franche-Comté;70;1;17;005;Aillevans;130;2;132
27;Bourgogne-Franche-Comté;70;1;13;006;Aillevillers-et-Lyaumont;1488;101;1589
27;Bourgogne-Franche-Comté;70;1;08;007;Ailloncourt;305;6;311
27;Bourgogne-Franche-Comté;70;1;13;008;Ainvelle;148;2;150
27;Bourgogne-Franche-Comté;70;2;05;009;Aisey-et-Richecourt;99;1;100
27;Bourgogne-Franche-Comté;70;1;05;010;Alaincourt;101;0;101
27;Bourgogne-Franche-Comté;70;1;10;011;Amage;313;3;316
27;Bourgogne-Franche-Comté;70;2;11;012;Amance;660;6;666
27;Bourgogne-Franche-Comté;70;1;05;013;Ambiévillers;66;0;66
27;Bourgogne-Franche-Comté;70;1;07;014;Amblans-et-Velotte;415;5;420
27;Bourgogne-Franche-Comté;70;2;11;015;Amoncourt;271;5;276
27;Bourgogne-Franche-Comté;70;1;10;016;Amont-et-Effreney;163;2;165
27;Bourgogne-Franche-Comté;70;1;11;017;Anchenoncourt-et-Chazel;240;4;244
27;Bourgogne-Franche-Comté;70;2;02;018;Ancier;516;4;520
27;Bourgogne-Franche-Comté;70;2;15;019;Andelarre;142;4;146
27;Bourgogne-Franche-Comté;70;2;15;020;Andelarrot;244;2;246
27;Bourgogne-Franche-Comté;70;1;07;021;Andornay;187;4;191
27;Bourgogne-Franche-Comté;70;2;02;022;Angirey;148;3;151
27;Bourgogne-Franche-Comté;70;1;11;023;Anjeux;142;2;144
27;Bourgogne-Franche-Comté;70;2;02;024;Apremont;439;15;454
27;Bourgogne-Franche-Comté;70;2;05;025;Arbecey;241;3;244
27;Bourgogne-Franche-Comté;70;2;02;026;Arc-lès-Gray;2492;45;2537
27;Bourgogne-Franche-Comté;70;2;01;027;Argillières;71;1;72
27;Bourgogne-Franche-Comté;70;2;14;028;Aroz;142;3;145
27;Bourgogne-Franche-Comté;70;1;07;029;Arpenans;235;2;237
27;Bourgogne-Franche-Comté;70;2;09;030;Arsans;47;1;48
27;Bourgogne-Franche-Comté;70;1;17;031;Athesans-Étroitefontaine;639;15;654
27;Bourgogne-Franche-Comté;70;2;01;032;Attricourt;45;0;45
27;Bourgogne-Franche-Comté;70;2;05;035;Augicourt;175;4;179
27;Bourgogne-Franche-Comté;70;2;12;036;Aulx-lès-Cromary;155;2;157
27;Bourgogne-Franche-Comté;70;2;01;037;Autet;259;20;279
27;Bourgogne-Franche-Comté;70;2;12;038;Authoison;312;8;320
27;Bourgogne-Franche-Comté;70;2;09;039;Autoreille;365;4;369
27;Bourgogne-Franche-Comté;70;2;17;040;Autrey-lès-Cerre;241;3;244
27;Bourgogne-Franche-Comté;70;2;01;041;Autrey-lès-Gray;385;8;393
27;Bourgogne-Franche-Comté;70;1;17;042;Autrey-le-Vay;99;1;100
27;Bourgogne-Franche-Comté;70;2;01;043;Auvet-et-la-Chapelotte;236;3;239
27;Bourgogne-Franche-Comté;70;2;11;044;Auxon;403;12;415
27;Bourgogne-Franche-Comté;70;2;09;045;Avrigney-Virey;420;6;426
27;Bourgogne-Franche-Comté;70;1;07;046;Les Aynans;365;11;376
27;Bourgogne-Franche-Comté;70;2;14;047;Baignes;109;2;111
27;Bourgogne-Franche-Comté;70;2;09;048;Bard-lès-Pesmes;136;2;138
27;Bourgogne-Franche-Comté;70;2;05;049;Barges;98;2;100
27;Bourgogne-Franche-Comté;70;2;12;050;La Barre;98;0;98
27;Bourgogne-Franche-Comté;70;1;05;051;La Basse-Vaivre;33;0;33
27;Bourgogne-Franche-Comté;70;1;11;052;Bassigney;119;3;122
27;Bourgogne-Franche-Comté;70;2;14;053;Les Bâties;76;1;77
27;Bourgogne-Franche-Comté;70;2;02;054;Battrans;239;4;243
27;Bourgogne-Franche-Comté;70;1;08;055;Baudoncourt;494;7;501
27;Bourgogne-Franche-Comté;70;2;11;056;Baulay;317;1;318
27;Bourgogne-Franche-Comté;70;2;09;057;Bay;152;3;155
27;Bourgogne-Franche-Comté;70;2;14;058;Beaujeu-Saint-Vallier-Pierrejux-et-Quitteur;929;14;943
27;Bourgogne-Franche-Comté;70;2;12;059;Beaumotte-Aubertans;472;8;480
27;Bourgogne-Franche-Comté;70;2;09;060;Beaumotte-lès-Pin;288;3;291
27;Bourgogne-Franche-Comté;70;1;10;061;Belfahy;86;0;86
27;Bourgogne-Franche-Comté;70;1;10;062;Belmont;144;5;149
27;Bourgogne-Franche-Comté;70;1;10;063;Belonchamp;209;3;212
27;Bourgogne-Franche-Comté;70;1;04;064;Belverne;145;1;146
27;Bourgogne-Franche-Comté;70;2;12;065;Besnans;74;1;75
27;Bourgogne-Franche-Comté;70;2;05;066;Betaucourt;181;4;185
27;Bourgogne-Franche-Comté;70;1;06;067;Betoncourt-lès-Brotte;122;0;122
27;Bourgogne-Franche-Comté;70;1;11;069;Betoncourt-Saint-Pancras;44;0;44
27;Bourgogne-Franche-Comté;70;2;05;070;Betoncourt-sur-Mance;27;0;27
27;Bourgogne-Franche-Comté;70;1;10;071;Beulotte-Saint-Laurent;58;1;59
27;Bourgogne-Franche-Comté;70;1;17;072;Beveuge;84;2;86
27;Bourgogne-Franche-Comté;70;2;05;074;Blondefontaine;241;2;243
27;Bourgogne-Franche-Comté;70;2;09;075;Bonboillon;198;3;201
27;Bourgogne-Franche-Comté;70;2;09;076;Bonnevent-Velloreille;373;8;381
27;Bourgogne-Franche-Comté;70;2;17;077;Borey;220;4;224
27;Bourgogne-Franche-Comté;70;2;05;078;Bougey;93;2;95
27;Bourgogne-Franche-Comté;70;2;11;079;Bougnon;514;13;527
27;Bourgogne-Franche-Comté;70;2;01;080;Bouhans-et-Feurg;237;4;241
27;Bourgogne-Franche-Comté;70;1;06;081;Bouhans-lès-Lure;307;6;313
27;Bourgogne-Franche-Comté;70;2;12;082;Bouhans-lès-Montbozon;124;2;126
27;Bourgogne-Franche-Comté;70;1;11;083;Bouligney;404;7;411
27;Bourgogne-Franche-Comté;70;2;12;084;Boulot;649;11;660
27;Bourgogne-Franche-Comté;70;2;12;085;Boult;692;13;705
27;Bourgogne-Franche-Comté;70;2;05;086;Bourbévelle;75;0;75
27;Bourgogne-Franche-Comté;70;2;11;087;Bourguignon-lès-Conflans;150;2;152
27;Bourgogne-Franche-Comté;70;2;14;088;Bourguignon-lès-la-Charité;114;2;116
27;Bourgogne-Franche-Comté;70;2;05;089;Bourguignon-lès-Morey;46;0;46
27;Bourgogne-Franche-Comté;70;2;14;090;Boursières;62;2;64
27;Bourgogne-Franche-Comté;70;2;05;091;Bousseraucourt;46;1;47
27;Bourgogne-Franche-Comté;70;2;09;092;Bresilley;179;3;182
27;Bourgogne-Franche-Comté;70;1;08;093;Breuches;652;8;660
27;Bourgogne-Franche-Comté;70;1;10;094;Breuchotte;304;4;308
27;Bourgogne-Franche-Comté;70;2;11;095;Breurey-lès-Faverney;635;16;651
27;Bourgogne-Franche-Comté;70;1;03;096;Brevilliers;633;17;650
27;Bourgogne-Franche-Comté;70;1;13;097;Briaucourt;237;6;243
27;Bourgogne-Franche-Comté;70;1;08;098;Brotte-lès-Luxeuil;207;3;210
27;Bourgogne-Franche-Comté;70;2;01;099;Brotte-lès-Ray;77;1;78
27;Bourgogne-Franche-Comté;70;2;01;100;Broye-les-Loups-et-Verfontaine;127;0;127
27;Bourgogne-Franche-Comté;70;2;09;101;Broye-Aubigney-Montseugny;505;5;510
27;Bourgogne-Franche-Comté;70;2;09;102;Brussey;278;9;287
27;Bourgogne-Franche-Comté;70;1;10;103;La Bruyère;204;7;211
27;Bourgogne-Franche-Comté;70;2;09;104;Bucey-lès-Gy;586;15;601
27;Bourgogne-Franche-Comté;70;2;14;105;Bucey-lès-Traves;138;1;139
27;Bourgogne-Franche-Comté;70;2;11;106;Buffignécourt;109;2;111
27;Bourgogne-Franche-Comté;70;2;12;107;Bussières;443;4;447
27;Bourgogne-Franche-Comté;70;2;12;109;Buthiers;307;2;309
27;Bourgogne-Franche-Comté;70;2;17;111;Calmoutier;277;3;280
27;Bourgogne-Franche-Comté;70;2;05;112;Cemboing;172;6;178
27;Bourgogne-Franche-Comté;70;2;12;113;Cenans;132;3;135
27;Bourgogne-Franche-Comté;70;2;05;114;Cendrecourt;204;2;206
27;Bourgogne-Franche-Comté;70;2;17;115;Cerre-lès-Noroy;237;4;241
27;Bourgogne-Franche-Comté;70;1;03;116;Chagey;615;12;627
27;Bourgogne-Franche-Comté;70;1;03;117;Châlonvillars;1243;31;1274
27;Bourgogne-Franche-Comté;70;2;12;118;Chambornay-lès-Bellevaux;196;2;198
27;Bourgogne-Franche-Comté;70;2;09;119;Chambornay-lès-Pin;354;11;365
27;Bourgogne-Franche-Comté;70;1;03;120;Champagney;3717;73;3790
27;Bourgogne-Franche-Comté;70;1;04;121;Champey;851;29;880
27;Bourgogne-Franche-Comté;70;2;01;122;Champlitte;1634;32;1666
27;Bourgogne-Franche-Comté;70;2;02;124;Champtonnay;87;1;88
27;Bourgogne-Franche-Comté;70;2;02;125;Champvans;176;6;182
27;Bourgogne-Franche-Comté;70;2;09;126;Chancey;195;6;201
27;Bourgogne-Franche-Comté;70;2;14;127;Chantes;106;5;111
27;Bourgogne-Franche-Comté;70;1;08;128;La Chapelle-lès-Luxeuil;390;3;393
27;Bourgogne-Franche-Comté;70;2;14;129;La Chapelle-Saint-Quillain;157;4;161
27;Bourgogne-Franche-Comté;70;2;09;130;Charcenne;309;8;317
27;Bourgogne-Franche-Comté;70;2;01;132;Chargey-lès-Gray;704;67;771
27;Bourgogne-Franche-Comté;70;2;05;133;Chargey-lès-Port;234;7;241
27;Bourgogne-Franche-Comté;70;2;15;134;Chariez;205;2;207
27;Bourgogne-Franche-Comté;70;2;05;135;Charmes-Saint-Valbert;33;1;34
27;Bourgogne-Franche-Comté;70;2;15;136;Charmoille;493;9;502
27;Bourgogne-Franche-Comté;70;2;12;137;Chassey-lès-Montbozon;220;3;223
27;Bourgogne-Franche-Comté;70;2;14;138;Chassey-lès-Scey;124;3;127
27;Bourgogne-Franche-Comté;70;1;06;140;Châteney;69;1;70
27;Bourgogne-Franche-Comté;70;1;06;141;Châtenois;118;5;123
27;Bourgogne-Franche-Comté;70;2;09;142;Chaumercenne;191;2;193
27;Bourgogne-Franche-Comté;70;2;05;143;Chauvirey-le-Châtel;125;6;131
27;Bourgogne-Franche-Comté;70;2;05;144;Chauvirey-le-Vieil;33;1;34
27;Bourgogne-Franche-Comté;70;2;12;145;Chaux-la-Lotière;491;11;502
27;Bourgogne-Franche-Comté;70;2;11;146;Chaux-lès-Port;167;4;171
27;Bourgogne-Franche-Comté;70;1;04;147;Chavanne;222;4;226
27;Bourgogne-Franche-Comté;70;2;14;148;Chemilly;86;1;87
27;Bourgogne-Franche-Comté;70;1;04;149;Chenebier;695;18;713
27;Bourgogne-Franche-Comté;70;2;09;150;Chenevrey-et-Morogne;324;2;326
27;Bourgogne-Franche-Comté;70;2;09;151;Chevigney;35;0;35
27;Bourgogne-Franche-Comté;70;2;09;152;Choye;475;39;514
27;Bourgogne-Franche-Comté;70;2;05;153;Cintrey;97;1;98
27;Bourgogne-Franche-Comté;70;2;12;154;Cirey;367;6;373
27;Bourgogne-Franche-Comté;70;1;08;155;Citers;792;15;807
27;Bourgogne-Franche-Comté;70;2;09;156;Citey;111;1;112
27;Bourgogne-Franche-Comté;70;1;03;157;Clairegoutte;352;10;362
27;Bourgogne-Franche-Comté;70;2;14;158;Clans;105;1;106
27;Bourgogne-Franche-Comté;70;2;12;159;Cognières;90;0;90
27;Bourgogne-Franche-Comté;70;1;04;160;Coisevaux;312;19;331
27;Bourgogne-Franche-Comté;70;2;17;162;Colombe-lès-Vesoul;464;13;477
27;Bourgogne-Franche-Comté;70;2;16;163;Colombier;439;8;447
27;Bourgogne-Franche-Comté;70;2;17;164;Colombotte;82;1;83
27;Bourgogne-Franche-Comté;70;2;05;165;Combeaufontaine;544;42;586
27;Bourgogne-Franche-Comté;70;2;16;166;Comberjon;150;5;155
27;Bourgogne-Franche-Comté;70;2;11;167;Conflandey;350;13;363
27;Bourgogne-Franche-Comté;70;1;13;168;Conflans-sur-Lanterne;603;9;612
27;Bourgogne-Franche-Comté;70;2;05;169;Confracourt;221;5;226
27;Bourgogne-Franche-Comté;70;2;11;170;Contréglise;119;1;120
27;Bourgogne-Franche-Comté;70;1;13;171;Corbenay;1257;28;1285
27;Bourgogne-Franche-Comté;70;1;10;172;La Corbière;109;2;111
27;Bourgogne-Franche-Comté;70;2;12;174;Cordonnet;143;2;145
27;Bourgogne-Franche-Comté;70;2;05;175;Cornot;135;3;138
27;Bourgogne-Franche-Comté;70;1;10;176;Corravillers;183;0;183
27;Bourgogne-Franche-Comté;70;2;05;177;Corre;596;15;611
27;Bourgogne-Franche-Comté;70;1;07;178;La Côte;526;9;535
27;Bourgogne-Franche-Comté;70;2;16;179;Coulevon;166;4;170
27;Bourgogne-Franche-Comté;70;1;17;180;Courchaton;442;8;450
27;Bourgogne-Franche-Comté;70;2;09;181;Courcuire;134;0;134
27;Bourgogne-Franche-Comté;70;1;04;182;Courmont;135;1;136
27;Bourgogne-Franche-Comté;70;2;01;183;Courtesoult-et-Gatey;60;0;60
27;Bourgogne-Franche-Comté;70;1;04;184;Couthenans;719;21;740
27;Bourgogne-Franche-Comté;70;2;02;185;Cresancey;186;0;186
27;Bourgogne-Franche-Comté;70;1;06;186;La Creuse;72;1;73
27;Bourgogne-Franche-Comté;70;1;17;187;Crevans-et-la-Chapelle-lès-Granges;258;1;259
27;Bourgogne-Franche-Comté;70;1;06;188;Creveney;52;1;53
27;Bourgogne-Franche-Comté;70;2;12;189;Cromary;251;4;255
27;Bourgogne-Franche-Comté;70;2;11;190;Cubry-lès-Faverney;185;3;188
27;Bourgogne-Franche-Comté;70;2;09;192;Cugney;206;4;210
27;Bourgogne-Franche-Comté;70;2;09;193;Cult;231;2;233
27;Bourgogne-Franche-Comté;70;1;11;194;Cuve;132;4;136
27;Bourgogne-Franche-Comté;70;1;06;195;Dambenoît-lès-Colombe;273;4;277
27;Bourgogne-Franche-Comté;70;1;11;196;Dampierre-lès-Conflans;246;8;254
27;Bourgogne-Franche-Comté;70;2;12;197;Dampierre-sur-Linotte;792;17;809
27;Bourgogne-Franche-Comté;70;2;01;198;Dampierre-sur-Salon;1234;24;1258
27;Bourgogne-Franche-Comté;70;2;17;199;Dampvalley-lès-Colombe;120;0;120
27;Bourgogne-Franche-Comté;70;1;11;200;Dampvalley-Saint-Pancras;42;1;43
27;Bourgogne-Franche-Comté;70;2;01;201;Delain;203;5;208
27;Bourgogne-Franche-Comté;70;1;05;202;Demangevelle;271;7;278
27;Bourgogne-Franche-Comté;70;2;17;203;La Demie;153;2;155
27;Bourgogne-Franche-Comté;70;2;01;204;Denèvre;151;4;155
27;Bourgogne-Franche-Comté;70;1;03;205;Échavanne;201;2;203
27;Bourgogne-Franche-Comté;70;1;03;206;Échenans-sous-Mont-Vaudois;564;7;571
27;Bourgogne-Franche-Comté;70;2;15;207;Échenoz-la-Méline;3235;68;3303
27;Bourgogne-Franche-Comté;70;2;12;208;Échenoz-le-Sec;290;5;295
27;Bourgogne-Franche-Comté;70;1;10;210;Écromagny;152;5;157
27;Bourgogne-Franche-Comté;70;2;01;211;Écuelle;64;2;66
27;Bourgogne-Franche-Comté;70;1;13;213;Éhuns;220;6;226
27;Bourgogne-Franche-Comté;70;2;11;214;Équevilley;122;3;125
27;Bourgogne-Franche-Comté;70;1;03;215;Errevet;242;11;253
27;Bourgogne-Franche-Comté;70;1;08;216;Esboz-Brest;445;24;469
27;Bourgogne-Franche-Comté;70;1;10;217;Esmoulières;97;1;98
27;Bourgogne-Franche-Comté;70;2;02;218;Esmoulins;132;5;137
27;Bourgogne-Franche-Comté;70;1;17;219;Esprels;734;15;749
27;Bourgogne-Franche-Comté;70;2;02;220;Essertenne-et-Cecey;404;7;411
27;Bourgogne-Franche-Comté;70;1;04;221;Étobon;288;4;292
27;Bourgogne-Franche-Comté;70;2;14;222;Étrelles-et-la-Montbleuse;85;0;85
27;Bourgogne-Franche-Comté;70;2;09;224;Étuz;684;14;698
27;Bourgogne-Franche-Comté;70;2;01;225;Fahy-lès-Autrey;100;2;102
27;Bourgogne-Franche-Comté;70;1;17;226;Fallon;311;3;314
27;Bourgogne-Franche-Comté;70;1;10;227;Faucogney-et-la-Mer;467;13;480
27;Bourgogne-Franche-Comté;70;2;11;228;Faverney;980;16;996
27;Bourgogne-Franche-Comté;70;1;07;229;Faymont;259;6;265
27;Bourgogne-Franche-Comté;70;2;01;230;Fédry;96;5;101
27;Bourgogne-Franche-Comté;70;2;01;231;Ferrières-lès-Ray;36;0;36
27;Bourgogne-Franche-Comté;70;2;14;232;Ferrières-lès-Scey;130;5;135
27;Bourgogne-Franche-Comté;70;1;10;233;Les Fessey;134;2;136
27;Bourgogne-Franche-Comté;70;2;12;234;Filain;222;10;232
27;Bourgogne-Franche-Comté;70;2;11;235;Flagy;139;4;143
27;Bourgogne-Franche-Comté;70;2;11;236;Fleurey-lès-Faverney;463;8;471
27;Bourgogne-Franche-Comté;70;2;01;237;Fleurey-lès-Lavoncourt;101;1;102
27;Bourgogne-Franche-Comté;70;1;13;238;Fleurey-lès-Saint-Loup;134;6;140
27;Bourgogne-Franche-Comté;70;2;12;239;Fondremand;200;5;205
27;Bourgogne-Franche-Comté;70;1;13;240;Fontaine-lès-Luxeuil;1328;23;1351
27;Bourgogne-Franche-Comté;70;1;11;242;Fontenois-la-Ville;131;0;131
27;Bourgogne-Franche-Comté;70;2;12;243;Fontenois-lès-Montbozon;340;11;351
27;Bourgogne-Franche-Comté;70;2;05;244;Fouchécourt;115;2;117
27;Bourgogne-Franche-Comté;70;1;88;245;Fougerolles-Saint-Valbert;3784;131;3915
27;Bourgogne-Franche-Comté;70;2;01;247;Fouvent-Saint-Andoche;210;3;213
27;Bourgogne-Franche-Comté;70;1;03;248;Frahier-et-Chatebier;1379;35;1414
27;Bourgogne-Franche-Comté;70;1;13;249;Francalmont;118;3;121
27;Bourgogne-Franche-Comté;70;1;06;250;Franchevelle;473;5;478
27;Bourgogne-Franche-Comté;70;2;01;251;Francourt;100;1;101
27;Bourgogne-Franche-Comté;70;2;01;252;Framont;181;3;184
27;Bourgogne-Franche-Comté;70;2;14;253;Frasne-le-Château;296;28;324
27;Bourgogne-Franche-Comté;70;1;03;254;Frédéric-Fontaine;259;8;267
27;Bourgogne-Franche-Comté;70;2;14;255;Fresne-Saint-Mamès;495;11;506
27;Bourgogne-Franche-Comté;70;1;10;256;Fresse;709;12;721
27;Bourgogne-Franche-Comté;70;2;14;257;Fretigney-et-Velloreille;747;13;760
27;Bourgogne-Franche-Comté;70;1;08;258;Froideconche;1987;45;2032
27;Bourgogne-Franche-Comté;70;1;06;259;Froideterre;368;6;374
27;Bourgogne-Franche-Comté;70;1;07;260;Frotey-lès-Lure;684;20;704
27;Bourgogne-Franche-Comté;70;2;16;261;Frotey-lès-Vesoul;1358;32;1390
27;Bourgogne-Franche-Comté;70;1;07;262;Genevreuille;158;4;162
27;Bourgogne-Franche-Comté;70;1;06;263;Genevrey;247;2;249
27;Bourgogne-Franche-Comté;70;1;17;264;Georfans;45;0;45
27;Bourgogne-Franche-Comté;70;2;02;265;Germigney;148;5;153
27;Bourgogne-Franche-Comté;70;2;05;267;Gevigney-et-Mercey;488;7;495
27;Bourgogne-Franche-Comté;70;2;09;268;Gézier-et-Fontenelay;214;4;218
27;Bourgogne-Franche-Comté;70;1;11;269;Girefontaine;34;1;35
27;Bourgogne-Franche-Comté;70;1;17;271;Gouhenans;367;9;376
27;Bourgogne-Franche-Comté;70;2;05;272;Gourgeon;180;11;191
27;Bourgogne-Franche-Comté;70;1;17;273;Grammont;68;1;69
27;Bourgogne-Franche-Comté;70;2;01;274;Grandecourt;49;0;49
27;Bourgogne-Franche-Comté;70;2;14;275;Grandvelle-et-le-Perrenot;388;7;395
27;Bourgogne-Franche-Comté;70;1;17;276;Granges-la-Ville;184;5;189
27;Bourgogne-Franche-Comté;70;1;17;277;Granges-le-Bourg;381;6;387
27;Bourgogne-Franche-Comté;70;2;11;278;Grattery;213;4;217
27;Bourgogne-Franche-Comté;70;2;02;279;Gray;5560;420;5980
27;Bourgogne-Franche-Comté;70;2;02;280;Gray-la-Ville;928;35;963
27;Bourgogne-Franche-Comté;70;2;09;282;Gy;1006;20;1026
27;Bourgogne-Franche-Comté;70;1;10;283;Haut-du-Them-Château-Lambert;446;6;452
27;Bourgogne-Franche-Comté;70;1;13;284;Hautevelle;263;1;264
27;Bourgogne-Franche-Comté;70;1;97;285;Héricourt;10592;270;10862
27;Bourgogne-Franche-Comté;70;2;09;286;Hugier;125;4;129
27;Bourgogne-Franche-Comté;70;1;05;287;Hurecourt;46;0;46
27;Bourgogne-Franche-Comté;70;2;12;288;Hyet;118;1;119
27;Bourgogne-Franche-Comté;70;2;02;289;Igny;211;2;213
27;Bourgogne-Franche-Comté;70;1;11;290;Jasney;197;6;203
27;Bourgogne-Franche-Comté;70;2;05;291;Jonvelle;117;3;120
27;Bourgogne-Franche-Comté;70;2;05;292;Jussey;1543;32;1575
27;Bourgogne-Franche-Comté;70;2;05;293;Lambrey;74;2;76
27;Bourgogne-Franche-Comté;70;1;10;294;Lantenot;357;4;361
27;Bourgogne-Franche-Comté;70;1;10;295;La Lanterne-et-les-Armonts;221;5;226
27;Bourgogne-Franche-Comté;70;2;12;296;Larians-et-Munans;270;2;272
27;Bourgogne-Franche-Comté;70;2;01;297;Larret;60;0;60
27;Bourgogne-Franche-Comté;70;2;05;298;Lavigney;119;0;119
27;Bourgogne-Franche-Comté;70;2;01;299;Lavoncourt;318;5;323
27;Bourgogne-Franche-Comté;70;2;14;301;Lieffrans;53;0;53
27;Bourgogne-Franche-Comté;70;2;09;302;Lieucourt;76;1;77
27;Bourgogne-Franche-Comté;70;2;17;303;Liévans;156;1;157
27;Bourgogne-Franche-Comté;70;1;06;304;Linexert;118;1;119
27;Bourgogne-Franche-Comté;70;2;01;305;Lœuilley;101;2;103
27;Bourgogne-Franche-Comté;70;1;07;306;Lomont;469;13;482
27;Bourgogne-Franche-Comté;70;1;17;307;Longevelle;121;6;127
27;Bourgogne-Franche-Comté;70;1;10;308;La Longine;213;5;218
27;Bourgogne-Franche-Comté;70;2;12;309;Loulans-Verchamp;453;10;463
27;Bourgogne-Franche-Comté;70;1;98;310;Lure;7960;183;8143
27;Bourgogne-Franche-Comté;70;1;08;311;Luxeuil-les-Bains;6644;259;6903
27;Bourgogne-Franche-Comté;70;1;03;312;Luze;785;22;807
27;Bourgogne-Franche-Comté;70;1;07;313;Lyoffans;411;8;419
27;Bourgogne-Franche-Comté;70;1;10;314;Magnivray;167;6;173
27;Bourgogne-Franche-Comté;70;1;13;315;Magnoncourt;408;11;419
27;Bourgogne-Franche-Comté;70;2;12;316;Le Magnoray;85;4;89
27;Bourgogne-Franche-Comté;70;1;17;317;Les Magny;143;4;147
27;Bourgogne-Franche-Comté;70;1;07;318;Magny-Danigon;438;10;448
27;Bourgogne-Franche-Comté;70;1;07;319;Magny-Jobert;131;3;134
27;Bourgogne-Franche-Comté;70;2;05;320;Magny-lès-Jussey;96;3;99
27;Bourgogne-Franche-Comté;70;1;07;321;Magny-Vernois;1375;27;1402
27;Bourgogne-Franche-Comté;70;1;13;322;Mailleroncourt-Charette;284;6;290
27;Bourgogne-Franche-Comté;70;1;11;323;Mailleroncourt-Saint-Pancras;196;1;197
27;Bourgogne-Franche-Comté;70;2;14;324;Mailley-et-Chazelot;634;16;650
27;Bourgogne-Franche-Comté;70;2;12;325;Maizières;356;7;363
27;Bourgogne-Franche-Comté;70;2;12;326;La Malachère;307;3;310
27;Bourgogne-Franche-Comté;70;2;09;327;Malans;134;3;137
27;Bourgogne-Franche-Comté;70;1;06;328;Malbouhans;326;5;331
27;Bourgogne-Franche-Comté;70;2;05;329;Malvillers;63;1;64
27;Bourgogne-Franche-Comté;70;1;03;330;Mandrevillars;309;8;317
27;Bourgogne-Franche-Comté;70;2;02;331;Mantoche;444;7;451
27;Bourgogne-Franche-Comté;70;1;17;332;Marast;58;1;59
27;Bourgogne-Franche-Comté;70;2;09;334;Marnay;1522;25;1547
27;Bourgogne-Franche-Comté;70;2;12;335;Maussans;59;2;61
27;Bourgogne-Franche-Comté;70;1;17;336;Mélecey;135;3;138
27;Bourgogne-Franche-Comté;70;2;05;337;Melin;58;1;59
27;Bourgogne-Franche-Comté;70;1;11;338;Melincourt;223;7;230
27;Bourgogne-Franche-Comté;70;1;10;339;Mélisey;1678;33;1711
27;Bourgogne-Franche-Comté;70;2;01;340;Membrey;214;27;241
27;Bourgogne-Franche-Comté;70;2;11;341;Menoux;300;3;303
27;Bourgogne-Franche-Comté;70;2;14;342;Mercey-sur-Saône;134;3;137
27;Bourgogne-Franche-Comté;70;2;11;343;Mersuay;282;5;287
27;Bourgogne-Franche-Comté;70;1;13;344;Meurcourt;340;9;349
27;Bourgogne-Franche-Comté;70;1;17;347;Mignavillers;365;8;373
27;Bourgogne-Franche-Comté;70;1;07;348;Moffans-et-Vacheresse;618;12;630
27;Bourgogne-Franche-Comté;70;1;17;349;Moimay;234;3;237
27;Bourgogne-Franche-Comté;70;2;05;350;Molay;65;0;65
27;Bourgogne-Franche-Comté;70;1;07;351;Mollans;227;3;230
27;Bourgogne-Franche-Comté;70;1;10;352;La Montagne;38;0;38
27;Bourgogne-Franche-Comté;70;2;09;353;Montagney;503;9;512
27;Bourgogne-Franche-Comté;70;2;12;355;Montarlot-lès-Rioz;311;4;315
27;Bourgogne-Franche-Comté;70;2;09;356;Montboillon;281;6;287
27;Bourgogne-Franche-Comté;70;2;12;357;Montbozon;544;86;630
27;Bourgogne-Franche-Comté;70;2;16;358;Montcey;269;4;273
27;Bourgogne-Franche-Comté;70;2;05;359;Montcourt;54;2;56
27;Bourgogne-Franche-Comté;70;1;05;360;Montdoré;75;1;76
27;Bourgogne-Franche-Comté;70;1;10;361;Montessaux;155;5;160
27;Bourgogne-Franche-Comté;70;2;05;362;Montigny-lès-Cherlieu;128;4;132
27;Bourgogne-Franche-Comté;70;2;15;363;Montigny-lès-Vesoul;637;15;652
27;Bourgogne-Franche-Comté;70;2;17;364;Montjustin-et-Velotte;119;1;120
27;Bourgogne-Franche-Comté;70;2;09;366;Villers-Chemin-et-Mont-lès-Étrelles;122;0;122
27;Bourgogne-Franche-Comté;70;2;15;367;Mont-le-Vernois;186;4;190
27;Bourgogne-Franche-Comté;70;2;01;368;Montot;131;3;134
27;Bourgogne-Franche-Comté;70;2;01;369;Mont-Saint-Léger;48;1;49
27;Bourgogne-Franche-Comté;70;2;01;371;Montureux-et-Prantigny;200;1;201
27;Bourgogne-Franche-Comté;70;2;11;372;Montureux-lès-Baulay;150;4;154
27;Bourgogne-Franche-Comté;70;2;05;373;La Roche-Morey;287;4;291
27;Bourgogne-Franche-Comté;70;2;09;374;Motey-Besuche;92;2;94
27;Bourgogne-Franche-Comté;70;2;02;376;Nantilly;452;10;462
27;Bourgogne-Franche-Comté;70;2;16;378;Navenne;1605;48;1653
27;Bourgogne-Franche-Comté;70;2;13;380;Neurey-en-Vaux;163;4;167
27;Bourgogne-Franche-Comté;70;2;17;381;Neurey-lès-la-Demie;348;10;358
27;Bourgogne-Franche-Comté;70;2;12;383;Neuvelle-lès-Cromary;425;4;429
27;Bourgogne-Franche-Comté;70;2;14;384;Neuvelle-lès-la-Charité;224;3;227
27;Bourgogne-Franche-Comté;70;1;06;385;La Neuvelle-lès-Lure;323;7;330
27;Bourgogne-Franche-Comté;70;2;05;386;La Neuvelle-lès-Scey;172;3;175
27;Bourgogne-Franche-Comté;70;2;14;387;Noidans-le-Ferroux;653;10;663
27;Bourgogne-Franche-Comté;70;2;15;388;Noidans-lès-Vesoul;1973;73;2046
27;Bourgogne-Franche-Comté;70;2;02;389;Noiron;58;1;59
27;Bourgogne-Franche-Comté;70;2;17;390;Noroy-le-Bourg;498;11;509
27;Bourgogne-Franche-Comté;70;2;05;392;Oigney;34;2;36
27;Bourgogne-Franche-Comté;70;2;14;393;Oiselay-et-Grachaux;431;2;433
27;Bourgogne-Franche-Comté;70;2;02;394;Onay;60;2;62
27;Bourgogne-Franche-Comté;70;1;17;395;Oppenans;51;0;51
27;Bourgogne-Franche-Comté;70;1;17;396;Oricourt;41;2;43
27;Bourgogne-Franche-Comté;70;2;12;397;Ormenans;82;0;82
27;Bourgogne-Franche-Comté;70;1;08;398;Ormoiche;67;0;67
27;Bourgogne-Franche-Comté;70;2;05;399;Ormoy;207;7;214
27;Bourgogne-Franche-Comté;70;2;05;400;Ouge;111;2;113
27;Bourgogne-Franche-Comté;70;2;14;401;Ovanches;138;1;139
27;Bourgogne-Franche-Comté;70;2;01;402;Oyrières;368;11;379
27;Bourgogne-Franche-Comté;70;1;07;403;Palante;243;3;246
27;Bourgogne-Franche-Comté;70;1;05;404;Passavant-la-Rochère;563;15;578
27;Bourgogne-Franche-Comté;70;2;12;405;Pennesières;196;4;200
27;Bourgogne-Franche-Comté;70;2;01;406;Percey-le-Grand;74;1;75
27;Bourgogne-Franche-Comté;70;2;12;407;Perrouse;275;4;279
27;Bourgogne-Franche-Comté;70;2;09;408;Pesmes;1072;20;1092
27;Bourgogne-Franche-Comté;70;2;01;409;Pierrecourt;114;2;116
27;Bourgogne-Franche-Comté;70;2;09;410;Pin;710;9;719
27;Bourgogne-Franche-Comté;70;1;11;411;La Pisseure;38;0;38
27;Bourgogne-Franche-Comté;70;1;11;412;Plainemont;72;0;72
27;Bourgogne-Franche-Comté;70;1;03;413;Plancher-Bas;1872;35;1907
27;Bourgogne-Franche-Comté;70;1;03;414;Plancher-les-Mines;955;14;969
27;Bourgogne-Franche-Comté;70;2;11;415;Polaincourt-et-Clairefontaine;620;10;630
27;Bourgogne-Franche-Comté;70;1;07;416;Pomoy;200;4;204
27;Bourgogne-Franche-Comté;70;2;14;417;Pontcey;297;3;300
27;Bourgogne-Franche-Comté;70;2;14;418;La Romaine;519;5;524
27;Bourgogne-Franche-Comté;70;1;05;419;Pont-du-Bois;110;2;112
27;Bourgogne-Franche-Comté;70;1;17;420;Pont-sur-l'Ognon;62;0;62
27;Bourgogne-Franche-Comté;70;2;11;421;Port-sur-Saône;2952;54;3006
27;Bourgogne-Franche-Comté;70;2;01;422;Poyans;145;1;146
27;Bourgogne-Franche-Comté;70;2;05;423;Preigney;116;3;119
27;Bourgogne-Franche-Comté;70;1;10;425;La Proiselière-et-Langle;147;6;153
27;Bourgogne-Franche-Comté;70;2;11;426;Provenchère;246;7;253
27;Bourgogne-Franche-Comté;70;2;05;427;Purgerot;331;9;340
27;Bourgogne-Franche-Comté;70;2;15;428;Pusey;1452;49;1501
27;Bourgogne-Franche-Comté;70;2;15;429;Pusy-et-Épenoux;544;14;558
27;Bourgogne-Franche-Comté;70;2;05;430;La Quarte;67;0;67
27;Bourgogne-Franche-Comté;70;2;12;431;Quenoche;252;3;255
27;Bourgogne-Franche-Comté;70;1;06;432;Quers;325;7;332
27;Bourgogne-Franche-Comté;70;2;16;433;Quincey;1401;39;1440
27;Bourgogne-Franche-Comté;70;1;10;435;Raddon-et-Chapendu;837;26;863
27;Bourgogne-Franche-Comté;70;2;05;436;Raincourt;113;0;113
27;Bourgogne-Franche-Comté;70;2;05;437;Ranzevelle;16;0;16
27;Bourgogne-Franche-Comté;70;2;01;438;Ray-sur-Saône;215;3;218
27;Bourgogne-Franche-Comté;70;2;14;439;Raze;363;7;370
27;Bourgogne-Franche-Comté;70;2;01;440;Recologne;34;2;36
27;Bourgogne-Franche-Comté;70;2;12;441;Recologne-lès-Rioz;251;3;254
27;Bourgogne-Franche-Comté;70;2;01;442;Renaucourt;111;1;112
27;Bourgogne-Franche-Comté;70;2;09;443;La Grande-Résie;90;1;91
27;Bourgogne-Franche-Comté;70;2;09;444;La Résie-Saint-Martin;167;1;168
27;Bourgogne-Franche-Comté;70;1;10;445;Rignovelle;117;1;118
27;Bourgogne-Franche-Comté;70;2;01;446;Rigny;617;8;625
27;Bourgogne-Franche-Comté;70;2;12;447;Rioz;2395;76;2471
27;Bourgogne-Franche-Comté;70;2;01;448;Roche-et-Raucourt;152;2;154
27;Bourgogne-Franche-Comté;70;2;12;449;Roche-sur-Linotte-et-Sorans-les-Cordiers;62;0;62
27;Bourgogne-Franche-Comté;70;2;05;450;La Rochelle;41;0;41
27;Bourgogne-Franche-Comté;70;1;06;451;Ronchamp;2747;39;2786
27;Bourgogne-Franche-Comté;70;2;14;452;Rosey;255;3;258
27;Bourgogne-Franche-Comté;70;1;10;453;La Rosière;80;0;80
27;Bourgogne-Franche-Comté;70;2;05;454;Rosières-sur-Mance;50;2;52
27;Bourgogne-Franche-Comté;70;1;07;455;Roye;1480;25;1505
27;Bourgogne-Franche-Comté;70;2;12;456;Ruhans;148;5;153
27;Bourgogne-Franche-Comté;70;2;14;457;Rupt-sur-Saône;106;3;109
27;Bourgogne-Franche-Comté;70;1;10;459;Saint-Barthélemy;1100;22;1122
27;Bourgogne-Franche-Comté;70;1;10;460;Saint-Bresson;427;11;438
27;Bourgogne-Franche-Comté;70;2;02;461;Saint-Broing;113;2;115
27;Bourgogne-Franche-Comté;70;1;17;462;Saint-Ferjeux;80;2;82
27;Bourgogne-Franche-Comté;70;2;14;463;Saint-Gand;146;1;147
27;Bourgogne-Franche-Comté;70;1;06;464;Saint-Germain;1355;23;1378
27;Bourgogne-Franche-Comté;70;2;02;466;Saint-Loup-Nantouard;127;3;130
27;Bourgogne-Franche-Comté;70;1;13;467;Saint-Loup-sur-Semouse;3046;46;3092
27;Bourgogne-Franche-Comté;70;2;05;468;Saint-Marcel;90;1;91
27;Bourgogne-Franche-Comté;70;1;10;469;Sainte-Marie-en-Chanois;211;3;214
27;Bourgogne-Franche-Comté;70;1;13;470;Sainte-Marie-en-Chaux;158;2;160
27;Bourgogne-Franche-Comté;70;2;14;471;Sainte-Reine;24;1;25
27;Bourgogne-Franche-Comté;70;2;11;472;Saint-Rémy-en-Comté;442;4;446
27;Bourgogne-Franche-Comté;70;1;08;473;Saint-Sauveur;1936;31;1967
27;Bourgogne-Franche-Comté;70;1;17;474;Saint-Sulpice;125;2;127
27;Bourgogne-Franche-Comté;70;2;11;476;Saponcourt;69;0;69
27;Bourgogne-Franche-Comté;70;1;04;477;Saulnot;779;13;792
27;Bourgogne-Franche-Comté;70;1;06;478;Saulx;880;15;895
27;Bourgogne-Franche-Comté;70;2;02;479;Sauvigney-lès-Gray;96;4;100
27;Bourgogne-Franche-Comté;70;2;09;480;Sauvigney-lès-Pesmes;142;4;146
27;Bourgogne-Franche-Comté;70;2;01;481;Savoyeux;202;4;206
27;Bourgogne-Franche-Comté;70;2;14;482;Scey-sur-Saône-et-Saint-Albin;1533;23;1556
27;Bourgogne-Franche-Comté;70;2;11;483;Scye;138;4;142
27;Bourgogne-Franche-Comté;70;1;17;484;Secenans;182;3;185
27;Bourgogne-Franche-Comté;70;1;05;485;Selles;202;4;206
27;Bourgogne-Franche-Comté;70;2;05;486;Semmadon;110;3;113
27;Bourgogne-Franche-Comté;70;1;17;487;Senargent-Mignafans;291;3;294
27;Bourgogne-Franche-Comté;70;2;11;488;Senoncourt;192;1;193
27;Bourgogne-Franche-Comté;70;1;10;489;Servance-Miellin;773;8;781
27;Bourgogne-Franche-Comté;70;1;06;490;Servigney;124;1;125
27;Bourgogne-Franche-Comté;70;2;14;491;Seveux-Motey;476;15;491
27;Bourgogne-Franche-Comté;70;2;14;492;Soing-Cubry-Charentenay;583;10;593
27;Bourgogne-Franche-Comté;70;2;12;493;Sorans-lès-Breurey;462;10;472
27;Bourgogne-Franche-Comté;70;2;09;494;Sornay;349;6;355
27;Bourgogne-Franche-Comté;70;2;05;496;Tartécourt;24;1;25
27;Bourgogne-Franche-Comté;70;1;10;498;Ternuay-Melay-et-Saint-Hilaire;453;15;468
27;Bourgogne-Franche-Comté;70;2;01;499;Theuley;102;2;104
27;Bourgogne-Franche-Comté;70;2;12;500;Thieffrans;166;9;175
27;Bourgogne-Franche-Comté;70;2;12;501;Thiénans;103;1;104
27;Bourgogne-Franche-Comté;70;2;01;502;Tincey-et-Pontrebeau;84;0;84
27;Bourgogne-Franche-Comté;70;2;12;503;Traitiéfontaine;161;2;163
27;Bourgogne-Franche-Comté;70;2;14;504;Traves;358;12;370
27;Bourgogne-Franche-Comté;70;2;02;505;Le Tremblois;159;7;166
27;Bourgogne-Franche-Comté;70;1;04;506;Trémoins;390;13;403
27;Bourgogne-Franche-Comté;70;2;12;507;Trésilley;259;6;265
27;Bourgogne-Franche-Comté;70;2;09;509;Tromarey;115;0;115
27;Bourgogne-Franche-Comté;70;2;09;510;Vadans;127;3;130
27;Bourgogne-Franche-Comté;70;2;01;511;Vaite;229;3;232
27;Bourgogne-Franche-Comté;70;1;13;512;La Vaivre;219;3;222
27;Bourgogne-Franche-Comté;70;2;15;513;Vaivre-et-Montoille;2420;54;2474
27;Bourgogne-Franche-Comté;70;2;09;514;Valay;658;11;669
27;Bourgogne-Franche-Comté;70;1;07;515;Le Val-de-Gouhenans;66;1;67
27;Bourgogne-Franche-Comté;70;2;17;516;Vallerois-le-Bois;240;3;243
27;Bourgogne-Franche-Comté;70;2;17;517;Vallerois-Lorioz;395;18;413
27;Bourgogne-Franche-Comté;70;2;11;518;Le Val-Saint-Éloi;97;2;99
27;Bourgogne-Franche-Comté;70;2;12;519;Vandelans;108;0;108
27;Bourgogne-Franche-Comté;70;2;01;520;Vanne;119;3;122
27;Bourgogne-Franche-Comté;70;2;09;521;Vantoux-et-Longevelle;186;5;191
27;Bourgogne-Franche-Comté;70;2;16;522;Varogne;158;3;161
27;Bourgogne-Franche-Comté;70;2;01;523;Vars;199;3;202
27;Bourgogne-Franche-Comté;70;2;11;524;Vauchoux;113;3;116
27;Bourgogne-Franche-Comté;70;2;01;525;Vauconcourt-Nervezain;213;3;216
27;Bourgogne-Franche-Comté;70;1;05;526;Vauvillers;620;12;632
27;Bourgogne-Franche-Comté;70;2;14;527;Vaux-le-Moncelot;77;1;78
27;Bourgogne-Franche-Comté;70;2;02;528;Velesmes-Échevanne;486;9;495
27;Bourgogne-Franche-Comté;70;2;02;529;Velet;381;18;399
27;Bourgogne-Franche-Comté;70;1;17;530;Vellechevreux-et-Courbenans;117;0;117
27;Bourgogne-Franche-Comté;70;2;09;531;Velleclaire;102;1;103
27;Bourgogne-Franche-Comté;70;2;12;532;Vellefaux;524;6;530
27;Bourgogne-Franche-Comté;70;2;09;533;Vellefrey-et-Vellefrange;118;1;119
27;Bourgogne-Franche-Comté;70;2;16;534;Vellefrie;124;1;125
27;Bourgogne-Franche-Comté;70;2;14;535;Velleguindry-et-Levrecey;151;0;151
27;Bourgogne-Franche-Comté;70;2;14;536;Velle-le-Châtel;132;2;134
27;Bourgogne-Franche-Comté;70;1;06;537;Velleminfroy;296;6;302
27;Bourgogne-Franche-Comté;70;2;14;538;Vellemoz;84;1;85
27;Bourgogne-Franche-Comté;70;2;14;539;Vellexon-Queutrey-et-Vaudey;454;12;466
27;Bourgogne-Franche-Comté;70;2;09;540;Velloreille-lès-Choye;80;4;84
27;Bourgogne-Franche-Comté;70;1;13;541;Velorcey;201;3;204
27;Bourgogne-Franche-Comté;70;2;09;542;Venère;207;5;212
27;Bourgogne-Franche-Comté;70;1;17;544;La Vergenne;113;5;118
27;Bourgogne-Franche-Comté;70;2;11;545;Venisey;130;1;131
27;Bourgogne-Franche-Comté;70;2;01;546;Vereux;214;22;236
27;Bourgogne-Franche-Comté;70;1;04;547;Verlans;167;3;170
27;Bourgogne-Franche-Comté;70;2;05;548;Vernois-sur-Mance;138;1;139
27;Bourgogne-Franche-Comté;70;2;14;549;La Vernotte;78;1;79
27;Bourgogne-Franche-Comté;70;2;99;550;Vesoul;14866;760;15626
27;Bourgogne-Franche-Comté;70;1;17;552;Villafans;210;7;217
27;Bourgogne-Franche-Comté;70;1;17;553;Villargent;115;2;117
27;Bourgogne-Franche-Comté;70;2;05;554;Villars-le-Pautel;190;1;191
27;Bourgogne-Franche-Comté;70;1;13;555;La Villedieu-en-Fontenette;168;1;169
27;Bourgogne-Franche-Comté;70;2;09;557;Villefrancon;129;4;133
27;Bourgogne-Franche-Comté;70;2;16;558;La Villeneuve-Bellenoye-et-la-Maize;146;2;148
27;Bourgogne-Franche-Comté;70;2;16;559;Villeparois;194;4;198
27;Bourgogne-Franche-Comté;70;2;12;560;Villers-Bouton;166;2;168
27;Bourgogne-Franche-Comté;70;1;17;561;Villersexel;1409;105;1514
27;Bourgogne-Franche-Comté;70;1;17;562;Villers-la-Ville;155;3;158
27;Bourgogne-Franche-Comté;70;2;17;563;Villers-le-Sec;529;13;542
27;Bourgogne-Franche-Comté;70;1;13;564;Villers-lès-Luxeuil;314;16;330
27;Bourgogne-Franche-Comté;70;2;12;565;Villers-Pater;52;2;54
27;Bourgogne-Franche-Comté;70;2;11;566;Villers-sur-Port;200;5;205
27;Bourgogne-Franche-Comté;70;1;04;567;Villers-sur-Saulnot;132;9;141
27;Bourgogne-Franche-Comté;70;2;01;568;Villers-Vaudey;56;4;60
27;Bourgogne-Franche-Comté;70;2;16;569;Vilory;63;0;63
27;Bourgogne-Franche-Comté;70;1;13;571;Visoncourt;39;3;42
27;Bourgogne-Franche-Comté;70;2;05;572;Vitrey-sur-Mance;291;4;295
27;Bourgogne-Franche-Comté;70;1;10;573;La Voivre;115;1;116
27;Bourgogne-Franche-Comté;70;2;01;574;Volon;56;0;56
27;Bourgogne-Franche-Comté;70;2;12;575;Voray-sur-l'Ognon;849;16;865
27;Bourgogne-Franche-Comté;70;2;05;576;Vougécourt;154;1;155
27;Bourgogne-Franche-Comté;70;1;07;577;Vouhenans;381;9;390
27;Bourgogne-Franche-Comté;70;2;09;578;Vregille;177;2;179
27;Bourgogne-Franche-Comté;70;1;04;579;Vyans-le-Val;425;16;441
27;Bourgogne-Franche-Comté;70;2;14;580;Vy-le-Ferroux;155;5;160
27;Bourgogne-Franche-Comté;70;1;07;581;Vy-lès-Lure;709;15;724
27;Bourgogne-Franche-Comté;70;2;14;582;Vy-lès-Rupt;78;0;78
27;Bourgogne-Franche-Comté;70;2;12;583;Vy-lès-Filain;131;1;132
27;Bourgogne-Franche-Comté;71;4;14;001;L'Abergement-de-Cuisery;808;14;822
27;Bourgogne-Franche-Comté;71;4;24;002;L'Abergement-Sainte-Colombe;1241;20;1261
27;Bourgogne-Franche-Comté;71;2;16;003;Allerey-sur-Saône;800;19;819
27;Bourgogne-Franche-Comté;71;2;24;004;Allériot;1163;24;1187
27;Bourgogne-Franche-Comté;71;2;04;005;Aluze;249;10;259
27;Bourgogne-Franche-Comté;71;3;10;006;Amanzé;190;5;195
27;Bourgogne-Franche-Comté;71;5;11;007;Ameugny;167;4;171
27;Bourgogne-Franche-Comté;71;3;10;008;Anglure-sous-Dun;150;5;155
27;Bourgogne-Franche-Comté;71;1;01;009;Anost;714;13;727
27;Bourgogne-Franche-Comté;71;1;02;010;Antully;869;10;879
27;Bourgogne-Franche-Comté;71;3;25;011;Anzy-le-Duc;432;82;514
27;Bourgogne-Franche-Comté;71;3;25;012;Artaix;335;14;349
27;Bourgogne-Franche-Comté;71;4;26;013;Authumes;282;5;287
27;Bourgogne-Franche-Comté;71;1;96;014;Autun;13205;1010;14215
27;Bourgogne-Franche-Comté;71;1;02;015;Auxy;901;26;927
27;Bourgogne-Franche-Comté;71;5;19;016;Azé;1083;27;1110
27;Bourgogne-Franche-Comté;71;3;09;017;Ballore;95;4;99
27;Bourgogne-Franche-Comté;71;4;14;018;Bantanges;546;10;556
27;Bourgogne-Franche-Comté;71;2;17;019;Barizey;140;7;147
27;Bourgogne-Franche-Comté;71;1;01;020;Barnay;98;2;100
27;Bourgogne-Franche-Comté;71;3;09;021;Baron;289;20;309
27;Bourgogne-Franche-Comté;71;3;10;022;Baudemont;624;9;633
27;Bourgogne-Franche-Comté;71;4;24;023;Baudrières;965;26;991
27;Bourgogne-Franche-Comté;71;3;25;024;Baugy;504;13;517
27;Bourgogne-Franche-Comté;71;3;09;025;Beaubery;359;7;366
27;Bourgogne-Franche-Comté;71;2;29;026;Beaumont-sur-Grosne;332;13;345
27;Bourgogne-Franche-Comté;71;4;26;027;Beaurepaire-en-Bresse;730;7;737
27;Bourgogne-Franche-Comté;71;4;26;028;Beauvernois;104;3;107
27;Bourgogne-Franche-Comté;71;4;26;029;Bellevesvre;294;3;297
27;Bourgogne-Franche-Comté;71;5;11;030;Bergesserin;201;4;205
27;Bourgogne-Franche-Comté;71;5;11;031;Berzé-le-Châtel;59;1;60
27;Bourgogne-Franche-Comté;71;5;19;032;Berzé-la-Ville;697;14;711
27;Bourgogne-Franche-Comté;71;2;16;033;Bey;869;19;888
27;Bourgogne-Franche-Comté;71;2;17;034;Bissey-sous-Cruchaud;334;6;340
27;Bourgogne-Franche-Comté;71;5;19;035;Bissy-la-Mâconnaise;204;3;207
27;Bourgogne-Franche-Comté;71;2;11;036;Bissy-sous-Uxelles;70;0;70
27;Bourgogne-Franche-Comté;71;2;17;037;Bissy-sur-Fley;83;6;89
27;Bourgogne-Franche-Comté;71;1;03;038;Les Bizots;469;13;482
27;Bourgogne-Franche-Comté;71;5;11;039;Blanot;181;1;182
27;Bourgogne-Franche-Comté;71;1;03;040;Blanzy;6044;133;6177
27;Bourgogne-Franche-Comté;71;3;10;041;Bois-Sainte-Marie;189;2;191
27;Bourgogne-Franche-Comté;71;5;11;042;Bonnay;312;6;318
27;Bourgogne-Franche-Comté;71;2;16;043;Les Bordes;84;3;87
27;Bourgogne-Franche-Comté;71;4;26;044;Bosjean;290;6;296
27;Bourgogne-Franche-Comté;71;4;26;045;Bouhans;178;5;183
27;Bourgogne-Franche-Comté;71;1;02;046;La Boulaye;93;0;93
27;Bourgogne-Franche-Comté;71;3;15;047;Bourbon-Lancy;4684;72;4756
27;Bourgogne-Franche-Comté;71;3;25;048;Bourg-le-Comte;175;2;177
27;Bourgogne-Franche-Comté;71;5;08;050;Bourgvilain;349;7;356
27;Bourgogne-Franche-Comté;71;2;04;051;Bouzeron;127;7;134
27;Bourgogne-Franche-Comté;71;2;29;052;Boyer;729;9;738
27;Bourgogne-Franche-Comté;71;2;16;054;Bragny-sur-Saône;696;14;710
27;Bourgogne-Franche-Comté;71;4;20;056;Branges;2350;35;2385
27;Bourgogne-Franche-Comté;71;5;11;057;Bray;125;3;128
27;Bourgogne-Franche-Comté;71;2;29;058;Bresse-sur-Grosne;186;11;197
27;Bourgogne-Franche-Comté;71;1;13;059;Le Breuil;3535;61;3596
27;Bourgogne-Franche-Comté;71;3;10;060;Briant;228;2;230
27;Bourgogne-Franche-Comté;71;4;14;061;Brienne;466;14;480
27;Bourgogne-Franche-Comté;71;1;02;062;Brion;291;8;299
27;Bourgogne-Franche-Comté;71;1;02;063;Broye;749;13;762
27;Bourgogne-Franche-Comté;71;4;20;064;Bruailles;980;25;1005
27;Bourgogne-Franche-Comté;71;5;11;065;Buffières;274;4;278
27;Bourgogne-Franche-Comté;71;5;19;066;Burgy;117;3;120
27;Bourgogne-Franche-Comté;71;2;11;067;Burnand;122;2;124
27;Bourgogne-Franche-Comté;71;5;11;068;Burzy;56;2;58
27;Bourgogne-Franche-Comté;71;5;19;069;Bussières;584;27;611
27;Bourgogne-Franche-Comté;71;2;17;070;Buxy;2147;66;2213
27;Bourgogne-Franche-Comté;71;3;25;071;Céron;264;7;271
27;Bourgogne-Franche-Comté;71;2;17;072;Cersot;145;2;147
27;Bourgogne-Franche-Comté;71;2;04;073;Chagny;5516;80;5596
27;Bourgogne-Franche-Comté;71;5;08;074;Chaintré;557;18;575
27;Bourgogne-Franche-Comté;71;3;15;075;Chalmoux;631;17;648
27;Bourgogne-Franche-Comté;71;2;97;076;Chalon-sur-Saône;45094;1473;46567
27;Bourgogne-Franche-Comté;71;3;25;077;Chambilly;499;14;513
27;Bourgogne-Franche-Comté;71;2;04;078;Chamilly;147;3;150
27;Bourgogne-Franche-Comté;71;4;14;079;Champagnat;470;11;481
27;Bourgogne-Franche-Comté;71;2;29;080;Champagny-sous-Uxelles;92;0;92
27;Bourgogne-Franche-Comté;71;2;05;081;Champforgeuil;2594;53;2647
27;Bourgogne-Franche-Comté;71;3;09;082;Champlecy;224;4;228
27;Bourgogne-Franche-Comté;71;5;08;084;Chânes;529;14;543
27;Bourgogne-Franche-Comté;71;2;04;085;Change;223;2;225
27;Bourgogne-Franche-Comté;71;3;09;086;Changy;468;9;477
27;Bourgogne-Franche-Comté;71;2;11;087;Chapaize;164;1;165
27;Bourgogne-Franche-Comté;71;3;18;088;La Chapelle-au-Mans;225;10;235
27;Bourgogne-Franche-Comté;71;2;29;089;La Chapelle-de-Bragny;235;2;237
27;Bourgogne-Franche-Comté;71;5;08;090;La Chapelle-de-Guinchay;4126;83;4209
27;Bourgogne-Franche-Comté;71;5;08;091;La Chapelle-du-Mont-de-France;192;2;194
27;Bourgogne-Franche-Comté;71;4;20;092;La Chapelle-Naude;498;12;510
27;Bourgogne-Franche-Comté;71;4;26;093;La Chapelle-Saint-Sauveur;647;16;663
27;Bourgogne-Franche-Comté;71;5;29;094;La Chapelle-sous-Brancion;139;2;141
27;Bourgogne-Franche-Comté;71;3;10;095;La Chapelle-sous-Dun;432;9;441
27;Bourgogne-Franche-Comté;71;1;02;096;La Chapelle-sous-Uchon;191;1;192
27;Bourgogne-Franche-Comté;71;4;14;097;La Chapelle-Thècle;481;12;493
27;Bourgogne-Franche-Comté;71;1;02;098;Charbonnat;250;4;254
27;Bourgogne-Franche-Comté;71;5;19;099;Charbonnières;323;7;330
27;Bourgogne-Franche-Comté;71;5;29;100;Chardonnay;205;0;205
27;Bourgogne-Franche-Comté;71;4;26;101;Charette-Varennes;453;6;459
27;Bourgogne-Franche-Comté;71;2;27;102;La Charmée;684;24;708
27;Bourgogne-Franche-Comté;71;1;02;103;Charmoy;276;6;282
27;Bourgogne-Franche-Comté;71;2;16;104;Charnay-lès-Chalon;188;8;196
27;Bourgogne-Franche-Comté;71;5;21;105;Charnay-lès-Mâcon;7925;290;8215
27;Bourgogne-Franche-Comté;71;3;09;106;Charolles;2849;384;3233
27;Bourgogne-Franche-Comté;71;2;04;107;Charrecey;332;8;340
27;Bourgogne-Franche-Comté;71;5;08;108;Chasselas;170;4;174
27;Bourgogne-Franche-Comté;71;2;04;109;Chassey-le-Camp;357;6;363
27;Bourgogne-Franche-Comté;71;3;10;110;Chassigny-sous-Dun;556;10;566
27;Bourgogne-Franche-Comté;71;3;18;111;Chassy;299;9;308
27;Bourgogne-Franche-Comté;71;5;11;112;Château;233;7;240
27;Bourgogne-Franche-Comté;71;3;10;113;Châteauneuf;93;0;93
27;Bourgogne-Franche-Comté;71;2;17;115;Châtel-Moron;87;4;91
27;Bourgogne-Franche-Comté;71;3;10;116;Châtenay;171;2;173
27;Bourgogne-Franche-Comté;71;2;24;117;Châtenoy-en-Bresse;1095;30;1125
27;Bourgogne-Franche-Comté;71;2;07;118;Châtenoy-le-Royal;6148;142;6290
27;Bourgogne-Franche-Comté;71;2;04;119;Chaudenay;1125;23;1148
27;Bourgogne-Franche-Comté;71;3;10;120;Chauffailles;3688;71;3759
27;Bourgogne-Franche-Comté;71;4;26;121;La Chaux;323;3;326
27;Bourgogne-Franche-Comté;71;2;04;122;Cheilly-lès-Maranges;558;15;573
27;Bourgogne-Franche-Comté;71;3;25;123;Chenay-le-Châtel;370;4;374
27;Bourgogne-Franche-Comté;71;2;17;124;Chenôves;202;7;209
27;Bourgogne-Franche-Comté;71;5;11;125;Chérizet;20;0;20
27;Bourgogne-Franche-Comté;71;5;19;126;Chevagny-les-Chevrières;591;18;609
27;Bourgogne-Franche-Comté;71;5;11;127;Chevagny-sur-Guye;53;4;57
27;Bourgogne-Franche-Comté;71;5;11;128;Chiddes;86;5;91
27;Bourgogne-Franche-Comté;71;1;01;129;Chissey-en-Morvan;268;6;274
27;Bourgogne-Franche-Comté;71;5;11;130;Chissey-lès-Mâcon;229;6;235
27;Bourgogne-Franche-Comté;71;2;16;131;Ciel;866;12;878
27;Bourgogne-Franche-Comté;71;1;28;132;Ciry-le-Noble;2252;27;2279
27;Bourgogne-Franche-Comté;71;3;10;133;La Clayette;1639;60;1699
27;Bourgogne-Franche-Comté;71;5;08;134;Navour-sur-Grosne;657;11;668
27;Bourgogne-Franche-Comté;71;5;19;135;Clessé;873;21;894
27;Bourgogne-Franche-Comté;71;3;18;136;Clessy;275;8;283
27;Bourgogne-Franche-Comté;71;5;11;137;Cluny;4931;245;5176
27;Bourgogne-Franche-Comté;71;2;03;139;Collonge-en-Charollais;146;6;152
27;Bourgogne-Franche-Comté;71;1;01;140;Collonge-la-Madeleine;46;2;48
27;Bourgogne-Franche-Comté;71;3;09;141;Colombier-en-Brionnais;314;5;319
27;Bourgogne-Franche-Comté;71;1;02;142;La Comelle;247;4;251
27;Bourgogne-Franche-Comté;71;4;14;143;Condal;459;9;468
27;Bourgogne-Franche-Comté;71;1;01;144;Cordesse;192;4;196
27;Bourgogne-Franche-Comté;71;2;11;145;Cormatin;567;5;572
27;Bourgogne-Franche-Comté;71;5;11;146;Cortambert;245;4;249
27;Bourgogne-Franche-Comté;71;5;11;147;Cortevaix;251;6;257
27;Bourgogne-Franche-Comté;71;3;10;148;Coublanc;847;18;865
27;Bourgogne-Franche-Comté;71;1;04;149;Couches;1285;27;1312
27;Bourgogne-Franche-Comté;71;5;08;150;Crêches-sur-Saône;3140;87;3227
27;Bourgogne-Franche-Comté;71;1;01;151;Créot;79;4;83
27;Bourgogne-Franche-Comté;71;3;18;152;Cressy-sur-Somme;175;9;184
27;Bourgogne-Franche-Comté;71;1;98;153;Le Creusot;21057;262;21319
27;Bourgogne-Franche-Comté;71;2;05;154;Crissey;2460;60;2520
27;Bourgogne-Franche-Comté;71;3;15;155;Cronat;516;15;531
27;Bourgogne-Franche-Comté;71;5;19;156;Cruzille;261;66;327
27;Bourgogne-Franche-Comté;71;4;14;157;Cuiseaux;1825;30;1855
27;Bourgogne-Franche-Comté;71;4;14;158;Cuisery;1588;40;1628
27;Bourgogne-Franche-Comté;71;2;17;159;Culles-les-Roches;201;8;209
27;Bourgogne-Franche-Comté;71;3;10;160;Curbigny;306;8;314
27;Bourgogne-Franche-Comté;71;3;18;161;Curdin;325;6;331
27;Bourgogne-Franche-Comté;71;1;01;162;Curgy;1135;23;1158
27;Bourgogne-Franche-Comté;71;5;11;163;Curtil-sous-Buffières;90;1;91
27;Bourgogne-Franche-Comté;71;2;11;164;Curtil-sous-Burnand;133;2;135
27;Bourgogne-Franche-Comté;71;1;01;165;Cussy-en-Morvan;374;8;382
27;Bourgogne-Franche-Comté;71;3;18;166;Cuzy;109;4;113
27;Bourgogne-Franche-Comté;71;2;16;167;Damerey;549;19;568
27;Bourgogne-Franche-Comté;71;4;26;168;Dampierre-en-Bresse;174;1;175
27;Bourgogne-Franche-Comté;71;5;08;169;Davayé;705;107;812
27;Bourgogne-Franche-Comté;71;2;16;170;Demigny;1782;38;1820
27;Bourgogne-Franche-Comté;71;2;04;171;Dennevy;304;5;309
27;Bourgogne-Franche-Comté;71;1;02;172;Dettey;88;1;89
27;Bourgogne-Franche-Comté;71;4;26;173;Devrouze;317;5;322
27;Bourgogne-Franche-Comté;71;2;04;174;Dezize-lès-Maranges;170;4;174
27;Bourgogne-Franche-Comté;71;4;26;175;Diconne;354;6;360
27;Bourgogne-Franche-Comté;71;3;15;176;Digoin;7616;238;7854
27;Bourgogne-Franche-Comté;71;4;14;177;Dommartin-lès-Cuiseaux;806;9;815
27;Bourgogne-Franche-Comté;71;5;08;178;Dompierre-les-Ormes;883;29;912
27;Bourgogne-Franche-Comté;71;3;18;179;Dompierre-sous-Sanvignes;82;1;83
27;Bourgogne-Franche-Comté;71;5;11;181;Donzy-le-Pertuis;161;2;163
27;Bourgogne-Franche-Comté;71;2;17;182;Dracy-le-Fort;1458;52;1510
27;Bourgogne-Franche-Comté;71;1;04;183;Dracy-lès-Couches;153;4;157
27;Bourgogne-Franche-Comté;71;1;01;184;Dracy-Saint-Loup;628;8;636
27;Bourgogne-Franche-Comté;71;3;09;185;Dyo;328;14;342
27;Bourgogne-Franche-Comté;71;2;16;186;Écuelles;259;4;263
27;Bourgogne-Franche-Comté;71;1;03;187;Écuisses;1595;31;1626
27;Bourgogne-Franche-Comté;71;1;01;188;Épertully;61;1;62
27;Bourgogne-Franche-Comté;71;2;27;189;Épervans;1634;49;1683
27;Bourgogne-Franche-Comté;71;1;01;190;Épinac;2145;30;2175
27;Bourgogne-Franche-Comté;71;1;04;191;Essertenne;475;6;481
27;Bourgogne-Franche-Comté;71;1;02;192;Étang-sur-Arroux;1803;148;1951
27;Bourgogne-Franche-Comté;71;2;29;193;Étrigny;476;10;486
27;Bourgogne-Franche-Comté;71;2;05;194;Farges-lès-Chalon;801;17;818
27;Bourgogne-Franche-Comté;71;5;29;195;Farges-lès-Mâcon;220;1;221
27;Bourgogne-Franche-Comté;71;4;20;196;Le Fay;629;9;638
27;Bourgogne-Franche-Comté;71;4;14;198;Flacey-en-Bresse;411;7;418
27;Bourgogne-Franche-Comté;71;5;11;199;Flagy;174;8;182
27;Bourgogne-Franche-Comté;71;3;10;200;Fleury-la-Montagne;707;17;724
27;Bourgogne-Franche-Comté;71;2;17;201;Fley;194;8;202
27;Bourgogne-Franche-Comté;71;2;04;202;Fontaines;1853;362;2215
27;Bourgogne-Franche-Comté;71;3;09;203;Fontenay;53;1;54
27;Bourgogne-Franche-Comté;71;2;05;204;Fragnes-La Loyère;1478;41;1519
27;Bourgogne-Franche-Comté;71;4;26;205;Frangy-en-Bresse;666;9;675
27;Bourgogne-Franche-Comté;71;4;14;206;La Frette;237;4;241
27;Bourgogne-Franche-Comté;71;4;26;207;Fretterans;288;10;298
27;Bourgogne-Franche-Comté;71;4;26;208;Frontenard;208;4;212
27;Bourgogne-Franche-Comté;71;4;14;209;Frontenaud;726;14;740
27;Bourgogne-Franche-Comté;71;5;08;210;Fuissé;370;18;388
27;Bourgogne-Franche-Comté;71;1;28;212;Génelard;1394;31;1425
27;Bourgogne-Franche-Comté;71;4;14;213;La Genête;567;17;584
27;Bourgogne-Franche-Comté;71;2;03;214;Genouilly;421;11;432
27;Bourgogne-Franche-Comté;71;2;16;215;Gergy;2590;73;2663
27;Bourgogne-Franche-Comté;71;2;17;216;Germagny;195;5;200
27;Bourgogne-Franche-Comté;71;5;08;217;Germolles-sur-Grosne;125;5;130
27;Bourgogne-Franche-Comté;71;3;10;218;Gibles;577;20;597
27;Bourgogne-Franche-Comté;71;2;29;219;Gigny-sur-Saône;542;15;557
27;Bourgogne-Franche-Comté;71;3;15;220;Gilly-sur-Loire;472;3;475
27;Bourgogne-Franche-Comté;71;2;17;221;Givry;3678;160;3838
27;Bourgogne-Franche-Comté;71;1;03;222;Gourdon;897;26;923
27;Bourgogne-Franche-Comté;71;1;02;223;La Grande-Verrière;565;8;573
27;Bourgogne-Franche-Comté;71;3;09;224;Grandvaux;85;7;92
27;Bourgogne-Franche-Comté;71;2;17;225;Granges;548;15;563
27;Bourgogne-Franche-Comté;71;5;29;226;Grevilly;28;0;28
27;Bourgogne-Franche-Comté;71;3;18;227;Grury;502;8;510
27;Bourgogne-Franche-Comté;71;2;24;228;Guerfand;215;3;218
27;Bourgogne-Franche-Comté;71;3;15;229;Les Guerreaux;228;1;229
27;Bourgogne-Franche-Comté;71;3;18;230;Gueugnon;6685;177;6862
27;Bourgogne-Franche-Comté;71;5;11;231;La Guiche;619;8;627
27;Bourgogne-Franche-Comté;71;3;25;232;Hautefond;204;14;218
27;Bourgogne-Franche-Comté;71;3;25;233;L'Hôpital-le-Mercier;304;7;311
27;Bourgogne-Franche-Comté;71;4;14;234;Huilly-sur-Seille;347;5;352
27;Bourgogne-Franche-Comté;71;5;19;235;Hurigny;1935;107;2042
27;Bourgogne-Franche-Comté;71;5;19;236;Igé;877;21;898
27;Bourgogne-Franche-Comté;71;1;01;237;Igornay;529;5;534
27;Bourgogne-Franche-Comté;71;3;10;238;Iguerande;990;18;1008
27;Bourgogne-Franche-Comté;71;3;18;239;Issy-l'Évêque;688;11;699
27;Bourgogne-Franche-Comté;71;5;11;240;Jalogny;396;14;410
27;Bourgogne-Franche-Comté;71;2;17;241;Jambles;485;17;502
27;Bourgogne-Franche-Comté;71;5;03;242;Joncy;515;10;525
27;Bourgogne-Franche-Comté;71;4;14;243;Joudes;368;6;374
27;Bourgogne-Franche-Comté;71;4;14;244;Jouvençon;444;2;446
27;Bourgogne-Franche-Comté;71;2;29;245;Jugy;325;4;329
27;Bourgogne-Franche-Comté;71;4;20;246;Juif;245;3;248
27;Bourgogne-Franche-Comté;71;2;17;247;Jully-lès-Buxy;367;10;377
27;Bourgogne-Franche-Comté;71;5;29;248;Lacrost;701;15;716
27;Bourgogne-Franche-Comté;71;2;29;249;Laives;981;37;1018
27;Bourgogne-Franche-Comté;71;5;19;250;Laizé;1091;49;1140
27;Bourgogne-Franche-Comté;71;1;02;251;Laizy;596;13;609
27;Bourgogne-Franche-Comté;71;2;29;252;Lalheue;364;13;377
27;Bourgogne-Franche-Comté;71;2;24;253;Lans;933;25;958
27;Bourgogne-Franche-Comté;71;4;26;254;Lays-sur-le-Doubs;156;1;157
27;Bourgogne-Franche-Comté;71;3;15;255;Lesme;176;2;178
27;Bourgogne-Franche-Comté;71;4;24;256;Lessard-en-Bresse;547;13;560
27;Bourgogne-Franche-Comté;71;2;16;257;Lessard-le-National;658;12;670
27;Bourgogne-Franche-Comté;71;5;08;258;Leynes;500;16;516
27;Bourgogne-Franche-Comté;71;3;10;259;Ligny-en-Brionnais;369;6;375
27;Bourgogne-Franche-Comté;71;4;14;261;Loisy;671;16;687
27;Bourgogne-Franche-Comté;71;2;16;262;Longepierre;155;3;158
27;Bourgogne-Franche-Comté;71;4;20;263;Louhans;6451;224;6675
27;Bourgogne-Franche-Comté;71;5;11;264;Lournand;324;9;333
27;Bourgogne-Franche-Comté;71;1;01;266;Lucenay-l'Évêque;314;4;318
27;Bourgogne-Franche-Comté;71;5;19;267;Lugny;855;84;939
27;Bourgogne-Franche-Comté;71;3;09;268;Lugny-lès-Charolles;350;10;360
27;Bourgogne-Franche-Comté;71;2;27;269;Lux;2012;28;2040
27;Bourgogne-Franche-Comté;71;5;99;270;Mâcon;34414;723;35137
27;Bourgogne-Franche-Comté;71;3;10;271;Mailly;146;5;151
27;Bourgogne-Franche-Comté;71;2;11;272;Malay;197;9;206
27;Bourgogne-Franche-Comté;71;3;15;273;Maltat;284;6;290
27;Bourgogne-Franche-Comté;71;2;29;274;Mancey;387;10;397
27;Bourgogne-Franche-Comté;71;3;25;275;Marcigny;1723;31;1754
27;Bourgogne-Franche-Comté;71;3;09;276;Marcilly-la-Gueurce;129;5;134
27;Bourgogne-Franche-Comté;71;2;17;277;Marcilly-lès-Buxy;666;16;682
27;Bourgogne-Franche-Comté;71;1;03;278;Marigny;162;5;167
27;Bourgogne-Franche-Comté;71;3;09;279;Le Rousset-Marizy;619;22;641
27;Bourgogne-Franche-Comté;71;3;18;280;Marly-sous-Issy;85;2;87
27;Bourgogne-Franche-Comté;71;3;18;281;Marly-sur-Arroux;307;14;321
27;Bourgogne-Franche-Comté;71;1;02;282;Marmagne;1256;21;1277
27;Bourgogne-Franche-Comté;71;2;27;283;Marnay;527;7;534
27;Bourgogne-Franche-Comté;71;5;29;284;Martailly-lès-Brancion;137;5;142
27;Bourgogne-Franche-Comté;71;3;09;285;Martigny-le-Comte;407;7;414
27;Bourgogne-Franche-Comté;71;1;03;286;Mary;270;4;274
27;Bourgogne-Franche-Comté;71;5;11;287;Massilly;314;5;319
27;Bourgogne-Franche-Comté;71;5;08;289;Matour;1156;20;1176
27;Bourgogne-Franche-Comté;71;5;11;290;Mazille;374;75;449
27;Bourgogne-Franche-Comté;71;3;25;291;Melay;956;23;979
27;Bourgogne-Franche-Comté;71;2;17;292;Mellecey;1316;45;1361
27;Bourgogne-Franche-Comté;71;4;14;293;Ménetreuil;409;10;419
27;Bourgogne-Franche-Comté;71;2;17;294;Mercurey;1231;137;1368
27;Bourgogne-Franche-Comté;71;4;26;295;Mervans;1502;25;1527
27;Bourgogne-Franche-Comté;71;2;17;296;Messey-sur-Grosne;741;19;760
27;Bourgogne-Franche-Comté;71;1;02;297;Mesvres;751;22;773
27;Bourgogne-Franche-Comté;71;5;19;299;Milly-Lamartine;311;6;317
27;Bourgogne-Franche-Comté;71;4;14;300;Le Miroir;626;8;634
27;Bourgogne-Franche-Comté;71;3;15;301;Mont;166;2;168
27;Bourgogne-Franche-Comté;71;2;17;302;Montagny-lès-Buxy;215;9;224
27;Bourgogne-Franche-Comté;71;4;20;303;Montagny-près-Louhans;491;6;497
27;Bourgogne-Franche-Comté;71;5;19;305;Montbellet;841;15;856
27;Bourgogne-Franche-Comté;71;1;23;306;Montceau-les-Mines;17239;249;17488
27;Bourgogne-Franche-Comté;71;3;25;307;Montceaux-l'Étoile;289;7;296
27;Bourgogne-Franche-Comté;71;2;29;308;Montceaux-Ragny;31;1;32
27;Bourgogne-Franche-Comté;71;1;12;309;Montcenis;1905;60;1965
27;Bourgogne-Franche-Comté;71;1;03;310;Montchanin;4992;83;5075
27;Bourgogne-Franche-Comté;71;4;20;311;Montcony;250;6;256
27;Bourgogne-Franche-Comté;71;2;24;312;Montcoy;255;1;256
27;Bourgogne-Franche-Comté;71;1;01;313;Monthelon;384;15;399
27;Bourgogne-Franche-Comté;71;4;26;314;Montjay;204;0;204
27;Bourgogne-Franche-Comté;71;2;16;315;Mont-lès-Seurre;184;2;186
27;Bourgogne-Franche-Comté;71;5;08;316;Montmelard;379;7;386
27;Bourgogne-Franche-Comté;71;3;18;317;Montmort;186;3;189
27;Bourgogne-Franche-Comté;71;4;14;318;Montpont-en-Bresse;1103;19;1122
27;Bourgogne-Franche-Comté;71;4;20;319;Montret;768;16;784
27;Bourgogne-Franche-Comté;71;1;03;320;Mont-Saint-Vincent;315;3;318
27;Bourgogne-Franche-Comté;71;1;04;321;Morey;191;4;195
27;Bourgogne-Franche-Comté;71;1;01;322;Morlet;50;1;51
27;Bourgogne-Franche-Comté;71;3;09;323;Mornay;136;0;136
27;Bourgogne-Franche-Comté;71;2;17;324;Moroges;584;22;606
27;Bourgogne-Franche-Comté;71;3;15;325;La Motte-Saint-Jean;1204;37;1241
27;Bourgogne-Franche-Comté;71;4;26;326;Mouthier-en-Bresse;411;6;417
27;Bourgogne-Franche-Comté;71;3;10;327;Mussy-sous-Dun;339;7;346
27;Bourgogne-Franche-Comté;71;2;29;328;Nanton;631;12;643
27;Bourgogne-Franche-Comté;71;2;16;329;Navilly;406;9;415
27;Bourgogne-Franche-Comté;71;3;18;330;Neuvy-Grandchamp;750;12;762
27;Bourgogne-Franche-Comté;71;3;25;331;Nochize;111;4;115
27;Bourgogne-Franche-Comté;71;4;14;332;Ormes;464;5;469
27;Bourgogne-Franche-Comté;71;2;24;333;Oslon;1226;38;1264
27;Bourgogne-Franche-Comté;71;3;09;334;Oudry;378;9;387
27;Bourgogne-Franche-Comté;71;3;09;335;Ouroux-sous-le-Bois-Sainte-Marie;65;0;65
27;Bourgogne-Franche-Comté;71;4;24;336;Ouroux-sur-Saône;3102;78;3180
27;Bourgogne-Franche-Comté;71;3;10;337;Oyé;306;8;314
27;Bourgogne-Franche-Comté;71;5;29;338;Ozenay;218;2;220
27;Bourgogne-Franche-Comté;71;3;09;339;Ozolles;384;8;392
27;Bourgogne-Franche-Comté;71;3;09;340;Palinges;1471;26;1497
27;Bourgogne-Franche-Comté;71;2;16;341;Palleau;268;2;270
27;Bourgogne-Franche-Comté;71;3;25;342;Paray-le-Monial;9218;394;9612
27;Bourgogne-Franche-Comté;71;2;04;343;Paris-l'Hôpital;308;8;316
27;Bourgogne-Franche-Comté;71;5;11;344;Passy;67;2;69
27;Bourgogne-Franche-Comté;71;5;19;345;Péronne;670;19;689
27;Bourgogne-Franche-Comté;71;1;28;346;Perrecy-les-Forges;1557;24;1581
27;Bourgogne-Franche-Comté;71;1;04;347;Perreuil;556;14;570
27;Bourgogne-Franche-Comté;71;3;15;348;Perrigny-sur-Loire;134;3;137
27;Bourgogne-Franche-Comté;71;1;01;349;La Petite-Verrière;51;1;52
27;Bourgogne-Franche-Comté;71;5;08;350;Pierreclos;859;30;889
27;Bourgogne-Franche-Comté;71;4;26;351;Pierre-de-Bresse;1942;29;1971
27;Bourgogne-Franche-Comté;71;4;26;352;Le Planois;86;3;89
27;Bourgogne-Franche-Comté;71;5;29;353;Plottes;535;10;545
27;Bourgogne-Franche-Comté;71;3;25;354;Poisson;565;21;586
27;Bourgogne-Franche-Comté;71;2;16;355;Pontoux;278;7;285
27;Bourgogne-Franche-Comté;71;1;09;356;Pouilloux;969;17;986
27;Bourgogne-Franche-Comté;71;4;26;357;Pourlans;218;0;218
27;Bourgogne-Franche-Comté;71;5;11;358;Pressy-sous-Dondin;102;3;105
27;Bourgogne-Franche-Comté;71;5;29;359;Préty;577;10;587
27;Bourgogne-Franche-Comté;71;5;19;360;Prissé;1900;46;1946
27;Bourgogne-Franche-Comté;71;3;09;361;Prizy;56;5;61
27;Bourgogne-Franche-Comté;71;5;08;362;Pruzilly;347;5;352
27;Bourgogne-Franche-Comté;71;2;03;363;Le Puley;83;5;88
27;Bourgogne-Franche-Comté;71;4;26;364;La Racineuse;175;0;175
27;Bourgogne-Franche-Comté;71;4;14;365;Rancy;604;7;611
27;Bourgogne-Franche-Comté;71;4;14;366;Ratenelle;377;7;384
27;Bourgogne-Franche-Comté;71;4;20;367;Ratte;369;5;374
27;Bourgogne-Franche-Comté;71;1;01;368;Reclesne;298;16;314
27;Bourgogne-Franche-Comté;71;2;04;369;Remigny;423;14;437
27;Bourgogne-Franche-Comté;71;3;18;370;Rigny-sur-Arroux;623;13;636
27;Bourgogne-Franche-Comté;71;5;19;371;La Roche-Vineuse;1573;42;1615
27;Bourgogne-Franche-Comté;71;5;08;372;Romanèche-Thorins;2017;44;2061
27;Bourgogne-Franche-Comté;71;4;14;373;Romenay;1721;22;1743
27;Bourgogne-Franche-Comté;71;2;17;374;Rosey;160;2;162
27;Bourgogne-Franche-Comté;71;1;01;376;Roussillon-en-Morvan;278;8;286
27;Bourgogne-Franche-Comté;71;5;29;377;Royer;131;1;132
27;Bourgogne-Franche-Comté;71;2;04;378;Rully;1551;35;1586
27;Bourgogne-Franche-Comté;71;4;20;379;Sagy;1231;23;1254
27;Bourgogne-Franche-Comté;71;4;26;380;Saillenard;793;14;807
27;Bourgogne-Franche-Comté;71;5;11;381;Sailly;73;0;73
27;Bourgogne-Franche-Comté;71;3;15;382;Saint-Agnan;696;15;711
27;Bourgogne-Franche-Comté;71;5;19;383;Saint-Albain;543;6;549
27;Bourgogne-Franche-Comté;71;2;29;384;Saint-Ambreuil;512;13;525
27;Bourgogne-Franche-Comté;71;5;08;385;Saint-Amour-Bellevue;564;22;586
27;Bourgogne-Franche-Comté;71;4;20;386;Saint-André-en-Bresse;105;1;106
27;Bourgogne-Franche-Comté;71;5;11;387;Saint-André-le-Désert;248;8;256
27;Bourgogne-Franche-Comté;71;3;09;388;Saint-Aubin-en-Charollais;469;20;489
27;Bourgogne-Franche-Comté;71;3;15;389;Saint-Aubin-sur-Loire;275;6;281
27;Bourgogne-Franche-Comté;71;1;23;390;Saint-Berain-sous-Sanvignes;1094;21;1115
27;Bourgogne-Franche-Comté;71;2;04;391;Saint-Bérain-sur-Dheune;553;17;570
27;Bourgogne-Franche-Comté;71;2;17;392;Saint-Boil;490;9;499
27;Bourgogne-Franche-Comté;71;3;10;393;Saint-Bonnet-de-Cray;494;18;512
27;Bourgogne-Franche-Comté;71;3;09;394;Saint-Bonnet-de-Joux;762;20;782
27;Bourgogne-Franche-Comté;71;3;09;395;Saint-Bonnet-de-Vieille-Vigne;210;2;212
27;Bourgogne-Franche-Comté;71;4;26;396;Saint-Bonnet-en-Bresse;487;5;492
27;Bourgogne-Franche-Comté;71;5;11;397;Sainte-Cécile;281;8;289
27;Bourgogne-Franche-Comté;71;4;24;398;Saint-Christophe-en-Bresse;1040;31;1071
27;Bourgogne-Franche-Comté;71;3;10;399;Saint-Christophe-en-Brionnais;532;15;547
27;Bourgogne-Franche-Comté;71;5;11;400;Saint-Clément-sur-Guye;132;3;135
27;Bourgogne-Franche-Comté;71;4;14;401;Sainte-Croix-en-Bresse;638;13;651
27;Bourgogne-Franche-Comté;71;2;29;402;Saint-Cyr;760;25;785
27;Bourgogne-Franche-Comté;71;2;17;403;Saint-Denis-de-Vaux;265;11;276
27;Bourgogne-Franche-Comté;71;2;17;404;Saint-Désert;904;21;925
27;Bourgogne-Franche-Comté;71;2;16;405;Saint-Didier-en-Bresse;193;5;198
27;Bourgogne-Franche-Comté;71;3;10;406;Saint-Didier-en-Brionnais;124;9;133
27;Bourgogne-Franche-Comté;71;1;02;407;Saint-Didier-sur-Arroux;218;4;222
27;Bourgogne-Franche-Comté;71;3;10;408;Saint-Edmond;432;9;441
27;Bourgogne-Franche-Comté;71;1;02;409;Saint-Émiland;312;8;320
27;Bourgogne-Franche-Comté;71;4;20;410;Saint-Étienne-en-Bresse;791;14;805
27;Bourgogne-Franche-Comté;71;1;02;411;Saint-Eugène;153;8;161
27;Bourgogne-Franche-Comté;71;1;03;412;Saint-Eusèbe;1207;25;1232
27;Bourgogne-Franche-Comté;71;1;13;413;Saint-Firmin;805;9;814
27;Bourgogne-Franche-Comté;71;1;01;414;Saint-Forgeot;440;16;456
27;Bourgogne-Franche-Comté;71;3;10;415;Sainte-Foy;140;3;143
27;Bourgogne-Franche-Comté;71;5;19;416;Saint-Gengoux-de-Scissé;584;6;590
27;Bourgogne-Franche-Comté;71;2;11;417;Saint-Gengoux-le-National;1053;6;1059
27;Bourgogne-Franche-Comté;71;4;26;419;Saint-Germain-du-Bois;1890;41;1931
27;Bourgogne-Franche-Comté;71;4;24;420;Saint-Germain-du-Plain;2313;51;2364
27;Bourgogne-Franche-Comté;71;3;09;421;Saint-Germain-en-Brionnais;186;7;193
27;Bourgogne-Franche-Comté;71;2;17;422;Saint-Germain-lès-Buxy;272;12;284
27;Bourgogne-Franche-Comté;71;2;16;423;Saint-Gervais-en-Vallière;431;5;436
27;Bourgogne-Franche-Comté;71;1;01;424;Saint-Gervais-sur-Couches;216;3;219
27;Bourgogne-Franche-Comté;71;2;04;425;Saint-Gilles;278;10;288
27;Bourgogne-Franche-Comté;71;2;17;426;Sainte-Hélène;530;9;539
27;Bourgogne-Franche-Comté;71;5;11;427;Saint-Huruge;51;1;52
27;Bourgogne-Franche-Comté;71;3;10;428;Saint-Igny-de-Roche;763;26;789
27;Bourgogne-Franche-Comté;71;2;17;430;Saint-Jean-de-Vaux;389;16;405
27;Bourgogne-Franche-Comté;71;1;04;431;Saint-Jean-de-Trézy;379;13;392
27;Bourgogne-Franche-Comté;71;3;09;433;Saint-Julien-de-Civry;489;14;503
27;Bourgogne-Franche-Comté;71;3;10;434;Saint-Julien-de-Jonzy;343;10;353
27;Bourgogne-Franche-Comté;71;1;03;435;Saint-Julien-sur-Dheune;242;8;250
27;Bourgogne-Franche-Comté;71;1;03;436;Saint-Laurent-d'Andenay;997;20;1017
27;Bourgogne-Franche-Comté;71;3;10;437;Saint-Laurent-en-Brionnais;322;11;333
27;Bourgogne-Franche-Comté;71;1;01;438;Saint-Léger-du-Bois;525;19;544
27;Bourgogne-Franche-Comté;71;3;25;439;Saint-Léger-lès-Paray;760;21;781
27;Bourgogne-Franche-Comté;71;1;02;440;Saint-Léger-sous-Beuvray;373;9;382
27;Bourgogne-Franche-Comté;71;5;08;441;Saint-Léger-sous-la-Bussière;281;4;285
27;Bourgogne-Franche-Comté;71;2;04;442;Saint-Léger-sur-Dheune;1600;18;1618
27;Bourgogne-Franche-Comté;71;2;16;443;Saint-Loup-Géanges;1644;56;1700
27;Bourgogne-Franche-Comté;71;2;27;444;Saint-Loup-de-Varennes;1207;28;1235
27;Bourgogne-Franche-Comté;71;2;27;445;Saint-Marcel;6188;147;6335
27;Bourgogne-Franche-Comté;71;5;11;446;Saint-Marcelin-de-Cray;190;5;195
27;Bourgogne-Franche-Comté;71;2;17;447;Saint-Mard-de-Vaux;272;14;286
27;Bourgogne-Franche-Comté;71;5;19;448;Saint-Martin-Belle-Roche;1387;34;1421
27;Bourgogne-Franche-Comté;71;2;17;449;Saint-Martin-d'Auxy;135;7;142
27;Bourgogne-Franche-Comté;71;1;02;450;Saint-Martin-de-Commune;101;4;105
27;Bourgogne-Franche-Comté;71;3;10;451;Saint-Martin-de-Lixy;93;0;93
27;Bourgogne-Franche-Comté;71;5;11;452;Saint-Martin-de-Salencey;102;1;103
27;Bourgogne-Franche-Comté;71;3;25;453;Saint-Martin-du-Lac;245;11;256
27;Bourgogne-Franche-Comté;71;4;20;454;Saint-Martin-du-Mont;180;8;188
27;Bourgogne-Franche-Comté;71;2;17;455;Saint-Martin-du-Tartre;156;1;157
27;Bourgogne-Franche-Comté;71;2;24;456;Saint-Martin-en-Bresse;1912;68;1980
27;Bourgogne-Franche-Comté;71;2;16;457;Saint-Martin-en-Gâtinois;119;2;121
27;Bourgogne-Franche-Comté;71;5;03;458;Saint-Martin-la-Patrouille;61;0;61
27;Bourgogne-Franche-Comté;71;2;17;459;Saint-Martin-sous-Montaigu;340;18;358
27;Bourgogne-Franche-Comté;71;5;19;460;Saint-Maurice-de-Satonnay;482;23;505
27;Bourgogne-Franche-Comté;71;2;17;461;Saint-Maurice-des-Champs;62;1;63
27;Bourgogne-Franche-Comté;71;2;16;462;Saint-Maurice-en-Rivière;522;11;533
27;Bourgogne-Franche-Comté;71;3;10;463;Saint-Maurice-lès-Châteauneuf;570;11;581
27;Bourgogne-Franche-Comté;71;1;04;464;Saint-Maurice-lès-Couches;180;3;183
27;Bourgogne-Franche-Comté;71;1;03;465;Saint-Micaud;275;7;282
27;Bourgogne-Franche-Comté;71;1;02;466;Saint-Nizier-sur-Arroux;120;4;124
27;Bourgogne-Franche-Comté;71;1;13;468;Saint-Pierre-de-Varennes;848;14;862
27;Bourgogne-Franche-Comté;71;5;08;469;Saint-Pierre-le-Vieux;368;12;380
27;Bourgogne-Franche-Comté;71;5;08;470;Saint-Point;349;14;363
27;Bourgogne-Franche-Comté;71;2;17;471;Saint-Privé;95;2;97
27;Bourgogne-Franche-Comté;71;1;02;472;Saint-Prix;206;7;213
27;Bourgogne-Franche-Comté;71;3;10;473;Saint-Racho;149;1;150
27;Bourgogne-Franche-Comté;71;3;18;474;Sainte-Radegonde;147;4;151
27;Bourgogne-Franche-Comté;71;2;27;475;Saint-Rémy;6605;158;6763
27;Bourgogne-Franche-Comté;71;1;09;477;Saint-Romain-sous-Gourdon;489;9;498
27;Bourgogne-Franche-Comté;71;3;18;478;Saint-Romain-sous-Versigny;83;1;84
27;Bourgogne-Franche-Comté;71;1;13;479;Saint-Sernin-du-Bois;1736;35;1771
27;Bourgogne-Franche-Comté;71;2;04;480;Saint-Sernin-du-Plain;599;13;612
27;Bourgogne-Franche-Comté;71;5;08;481;Saint-Symphorien-d'Ancelles;1132;20;1152
27;Bourgogne-Franche-Comté;71;1;02;482;Saint-Symphorien-de-Marmagne;837;11;848
27;Bourgogne-Franche-Comté;71;3;10;483;Saint-Symphorien-des-Bois;418;12;430
27;Bourgogne-Franche-Comté;71;4;20;484;Saint-Usuge;1256;29;1285
27;Bourgogne-Franche-Comté;71;2;17;485;Saint-Vallerin;257;14;271
27;Bourgogne-Franche-Comté;71;1;28;486;Saint-Vallier;8541;163;8704
27;Bourgogne-Franche-Comté;71;5;08;487;Saint-Vérand;160;4;164
27;Bourgogne-Franche-Comté;71;5;11;488;Saint-Vincent-des-Prés;102;4;106
27;Bourgogne-Franche-Comté;71;4;20;489;Saint-Vincent-en-Bresse;576;9;585
27;Bourgogne-Franche-Comté;71;3;09;490;Saint-Vincent-Bragny;1013;17;1030
27;Bourgogne-Franche-Comté;71;3;25;491;Saint-Yan;1153;23;1176
27;Bourgogne-Franche-Comté;71;5;11;492;Saint-Ythaire;127;2;129
27;Bourgogne-Franche-Comté;71;1;01;493;Saisy;345;8;353
27;Bourgogne-Franche-Comté;71;5;19;494;La Salle;516;14;530
27;Bourgogne-Franche-Comté;71;5;11;495;Salornay-sur-Guye;873;11;884
27;Bourgogne-Franche-Comté;71;2;04;496;Sampigny-lès-Maranges;140;5;145
27;Bourgogne-Franche-Comté;71;5;21;497;Sancé;2181;54;2235
27;Bourgogne-Franche-Comté;71;2;17;498;Santilly;132;6;138
27;Bourgogne-Franche-Comté;71;1;28;499;Sanvignes-les-Mines;4325;75;4400
27;Bourgogne-Franche-Comté;71;3;10;500;Sarry;90;3;93
27;Bourgogne-Franche-Comté;71;2;17;501;Sassangy;143;3;146
27;Bourgogne-Franche-Comté;71;2;16;502;Sassenay;1586;45;1631
27;Bourgogne-Franche-Comté;71;2;17;503;Saules;128;3;131
27;Bourgogne-Franche-Comté;71;2;16;504;Saunières;81;1;82
27;Bourgogne-Franche-Comté;71;2;17;505;Savianges;77;1;78
27;Bourgogne-Franche-Comté;71;4;26;506;Savigny-en-Revermont;1132;17;1149
27;Bourgogne-Franche-Comté;71;2;11;507;Savigny-sur-Grosne;171;1;172
27;Bourgogne-Franche-Comté;71;4;14;508;Savigny-sur-Seille;399;9;408
27;Bourgogne-Franche-Comté;71;1;01;509;La Celle-en-Morvan;474;6;480
27;Bourgogne-Franche-Comté;71;3;10;510;Semur-en-Brionnais;610;19;629
27;Bourgogne-Franche-Comté;71;2;29;512;Sennecey-le-Grand;2943;66;3009
27;Bourgogne-Franche-Comté;71;5;19;513;Senozan;1128;37;1165
27;Bourgogne-Franche-Comté;71;4;26;514;Sens-sur-Seille;424;5;429
27;Bourgogne-Franche-Comté;71;2;17;515;Sercy;102;3;105
27;Bourgogne-Franche-Comté;71;4;26;516;Serley;603;9;612
27;Bourgogne-Franche-Comté;71;2;16;517;Sermesse;237;5;242
27;Bourgogne-Franche-Comté;71;5;08;518;Serrières;271;9;280
27;Bourgogne-Franche-Comté;71;4;26;519;Serrigny-en-Bresse;188;4;192
27;Bourgogne-Franche-Comté;71;2;27;520;Sevrey;1263;21;1284
27;Bourgogne-Franche-Comté;71;5;11;521;Sigy-le-Châtel;106;4;110
27;Bourgogne-Franche-Comté;71;4;14;522;Simandre;1737;17;1754
27;Bourgogne-Franche-Comté;71;4;20;523;Simard;1184;11;1195
27;Bourgogne-Franche-Comté;71;5;11;524;Sivignon;176;7;183
27;Bourgogne-Franche-Comté;71;5;19;525;Sologny;577;10;587
27;Bourgogne-Franche-Comté;71;5;08;526;Solutré-Pouilly;364;7;371
27;Bourgogne-Franche-Comté;71;1;01;527;Sommant;201;5;206
27;Bourgogne-Franche-Comté;71;4;20;528;Sornay;1990;45;2035
27;Bourgogne-Franche-Comté;71;3;09;529;Suin;263;5;268
27;Bourgogne-Franche-Comté;71;1;01;530;Sully;490;3;493
27;Bourgogne-Franche-Comté;71;1;02;531;La Tagnière;212;1;213
27;Bourgogne-Franche-Comté;71;5;11;532;Taizé;194;3;197
27;Bourgogne-Franche-Comté;71;3;10;533;Tancon;525;18;543
27;Bourgogne-Franche-Comté;71;4;26;534;Le Tartre;111;5;116
27;Bourgogne-Franche-Comté;71;1;01;535;Tavernay;509;11;520
27;Bourgogne-Franche-Comté;71;1;02;537;Thil-sur-Arroux;128;0;128
27;Bourgogne-Franche-Comté;71;4;26;538;Thurey;430;12;442
27;Bourgogne-Franche-Comté;71;1;01;539;Tintry;79;1;80
27;Bourgogne-Franche-Comté;71;1;12;540;Torcy;2810;37;2847
27;Bourgogne-Franche-Comté;71;4;26;541;Torpes;375;4;379
27;Bourgogne-Franche-Comté;71;3;18;542;Toulon-sur-Arroux;1472;26;1498
27;Bourgogne-Franche-Comté;71;5;29;543;Tournus;5552;280;5832
27;Bourgogne-Franche-Comté;71;2;16;544;Toutenant;187;2;189
27;Bourgogne-Franche-Comté;71;5;08;545;Tramayes;1062;18;1080
27;Bourgogne-Franche-Comté;71;5;08;546;Trambly;407;7;414
27;Bourgogne-Franche-Comté;71;5;08;547;Trivy;252;7;259
27;Bourgogne-Franche-Comté;71;4;24;548;Tronchy;245;2;247
27;Bourgogne-Franche-Comté;71;5;29;549;La Truchère;208;6;214
27;Bourgogne-Franche-Comté;71;5;29;550;Uchizy;819;14;833
27;Bourgogne-Franche-Comté;71;1;02;551;Uchon;89;5;94
27;Bourgogne-Franche-Comté;71;3;18;552;Uxeau;519;12;531
27;Bourgogne-Franche-Comté;71;3;10;553;Vareilles;276;5;281
27;Bourgogne-Franche-Comté;71;3;10;554;Varenne-l'Arconce;112;3;115
27;Bourgogne-Franche-Comté;71;2;27;555;Varennes-le-Grand;2331;49;2380
27;Bourgogne-Franche-Comté;71;5;22;556;Varennes-lès-Mâcon;569;7;576
27;Bourgogne-Franche-Comté;71;3;15;557;Varenne-Saint-Germain;713;20;733
27;Bourgogne-Franche-Comté;71;4;14;558;Varennes-Saint-Sauveur;1131;25;1156
27;Bourgogne-Franche-Comté;71;3;10;559;Varennes-sous-Dun;533;13;546
27;Bourgogne-Franche-Comté;71;3;10;561;Vauban;227;10;237
27;Bourgogne-Franche-Comté;71;3;09;562;Vaudebarrier;209;33;242
27;Bourgogne-Franche-Comté;71;2;11;563;Vaux-en-Pré;72;1;73
27;Bourgogne-Franche-Comté;71;3;09;564;Vendenesse-lès-Charolles;745;19;764
27;Bourgogne-Franche-Comté;71;3;18;565;Vendenesse-sur-Arroux;563;12;575
27;Bourgogne-Franche-Comté;71;2;16;566;Verdun-sur-le-Doubs;977;9;986
27;Bourgogne-Franche-Comté;71;5;08;567;Vergisson;255;7;262
27;Bourgogne-Franche-Comté;71;4;20;568;Vérissey;58;0;58
27;Bourgogne-Franche-Comté;71;2;16;570;Verjux;510;11;521
27;Bourgogne-Franche-Comté;71;5;08;571;Verosvres;438;14;452
27;Bourgogne-Franche-Comté;71;2;29;572;Vers;234;0;234
27;Bourgogne-Franche-Comté;71;3;25;573;Versaugues;192;4;196
27;Bourgogne-Franche-Comté;71;5;19;574;Verzé;814;27;841
27;Bourgogne-Franche-Comté;71;5;29;576;Le Villars;279;5;284
27;Bourgogne-Franche-Comté;71;2;24;577;Villegaudin;223;4;227
27;Bourgogne-Franche-Comté;71;2;16;578;Clux-Villeneuve;309;10;319
27;Bourgogne-Franche-Comté;71;2;17;579;Villeneuve-en-Montagne;169;2;171
27;Bourgogne-Franche-Comté;71;4;20;580;Vincelles;429;14;443
27;Bourgogne-Franche-Comté;71;3;25;581;Vindecy;251;5;256
27;Bourgogne-Franche-Comté;71;5;11;582;La Vineuse sur Fregande;651;19;670
27;Bourgogne-Franche-Comté;71;5;08;583;Vinzelles;732;24;756
27;Bourgogne-Franche-Comté;71;5;19;584;Viré;1201;29;1230
27;Bourgogne-Franche-Comté;71;2;05;585;Virey-le-Grand;1369;73;1442
27;Bourgogne-Franche-Comté;71;3;09;586;Viry;259;4;263
27;Bourgogne-Franche-Comté;71;3;25;588;Vitry-en-Charollais;1099;38;1137
27;Bourgogne-Franche-Comté;71;3;15;589;Vitry-sur-Loire;418;8;426
27;Bourgogne-Franche-Comté;71;3;25;590;Volesvres;644;23;667
27;Bourgogne-Franche-Comté;71;5;19;591;Fleurville;512;8;520
52;Pays de la Loire;72;3;11;001;Aigné;1692;32;1724
52;Pays de la Loire;72;2;09;002;Aillières-Beauvoir;199;5;204
52;Pays de la Loire;72;3;16;003;Allonnes;11108;99;11207
52;Pays de la Loire;72;1;07;004;Amné;580;8;588
52;Pays de la Loire;72;2;20;005;Ancinnes;942;22;964
52;Pays de la Loire;72;2;09;006;Arçonnay;1882;232;2114
52;Pays de la Loire;72;2;19;007;Ardenay-sur-Mérize;500;11;511
52;Pays de la Loire;72;3;15;008;Arnage;5520;127;5647
52;Pays de la Loire;72;1;06;009;Arthezé;358;8;366
52;Pays de la Loire;72;1;17;010;Asnières-sur-Vègre;379;9;388
52;Pays de la Loire;72;2;20;011;Assé-le-Boisne;902;17;919
52;Pays de la Loire;72;2;20;012;Assé-le-Riboul;486;10;496
52;Pays de la Loire;72;1;08;013;Aubigné-Racan;2108;26;2134
52;Pays de la Loire;72;2;09;015;Les Aulneaux;112;0;112
52;Pays de la Loire;72;1;17;016;Auvers-le-Hamon;1484;36;1520
52;Pays de la Loire;72;1;07;017;Auvers-sous-Montfaucon;233;3;236
52;Pays de la Loire;72;2;09;018;Avesnes-en-Saosnois;85;1;86
52;Pays de la Loire;72;1;07;019;Avessé;363;9;372
52;Pays de la Loire;72;2;05;020;Avezé;694;17;711
52;Pays de la Loire;72;1;17;021;Avoise;579;7;586
52;Pays de la Loire;72;1;17;022;Le Bailleul;1214;27;1241
52;Pays de la Loire;72;3;01;023;Ballon-Saint Mars;2260;30;2290
52;Pays de la Loire;72;3;01;024;La Bazoge;3651;60;3711
52;Pays de la Loire;72;1;06;025;Bazouges Cré sur Loir;1975;47;2022
52;Pays de la Loire;72;2;01;026;Beaufay;1507;16;1523
52;Pays de la Loire;72;1;03;027;Beaumont-sur-Dême;328;2;330
52;Pays de la Loire;72;1;03;028;Beaumont-Pied-de-Bœuf;481;8;489
52;Pays de la Loire;72;2;20;029;Beaumont-sur-Sarthe;1979;28;2007
52;Pays de la Loire;72;2;05;031;Beillé;529;3;532
52;Pays de la Loire;72;2;18;032;Berfay;335;10;345
52;Pays de la Loire;72;2;20;034;Bérus;438;12;450
52;Pays de la Loire;72;2;18;035;Bessé-sur-Braye;2069;46;2115
52;Pays de la Loire;72;2;20;036;Béthon;307;4;311
52;Pays de la Loire;72;2;09;037;Blèves;123;1;124
52;Pays de la Loire;72;2;05;038;Boëssé-le-Sec;547;1;548
52;Pays de la Loire;72;2;01;039;Bonnétable;3749;57;3806
52;Pays de la Loire;72;2;05;040;La Bosse;144;2;146
52;Pays de la Loire;72;2;05;041;Bouër;349;5;354
52;Pays de la Loire;72;2;18;042;Bouloire;2109;32;2141
52;Pays de la Loire;72;2;20;043;Bourg-le-Roi;329;7;336
52;Pays de la Loire;72;1;06;044;Bousse;432;5;437
52;Pays de la Loire;72;1;07;045;Brains-sur-Gée;828;13;841
52;Pays de la Loire;72;2;19;046;Le Breil-sur-Mérize;1544;26;1570
52;Pays de la Loire;72;3;02;047;Brette-les-Pins;2128;140;2268
52;Pays de la Loire;72;2;01;048;Briosne-lès-Sables;523;4;527
52;Pays de la Loire;72;1;08;049;La Bruère-sur-Loir;248;1;249
52;Pays de la Loire;72;1;07;050;Brûlon;1533;29;1562
52;Pays de la Loire;72;1;08;051;Cérans-Foulletourte;3377;36;3413
52;Pays de la Loire;72;1;03;052;Chahaignes;671;10;681
52;Pays de la Loire;72;3;02;053;Challes;1205;21;1226
52;Pays de la Loire;72;3;02;054;Champagné;3697;60;3757
52;Pays de la Loire;72;2;09;056;Champfleur;1332;24;1356
52;Pays de la Loire;72;2;18;057;Champrond;70;3;73
52;Pays de la Loire;72;3;02;058;Changé;6569;174;6743
52;Pays de la Loire;72;1;07;059;Chantenay-Villedieu;829;19;848
52;Pays de la Loire;72;1;08;060;La Chapelle-aux-Choux;270;1;271
52;Pays de la Loire;72;1;06;061;La Chapelle-d'Aligné;1711;25;1736
52;Pays de la Loire;72;2;05;062;La Chapelle-du-Bois;832;19;851
52;Pays de la Loire;72;2;18;064;La Chapelle-Huon;519;10;529
52;Pays de la Loire;72;3;11;065;La Chapelle-Saint-Aubin;2278;66;2344
52;Pays de la Loire;72;2;07;066;La Chapelle-Saint-Fray;423;7;430
52;Pays de la Loire;72;2;05;067;La Chapelle-Saint-Rémy;993;7;1000
52;Pays de la Loire;72;1;03;068;La Chartre-sur-le-Loir;1367;16;1383
52;Pays de la Loire;72;1;07;070;Chassillé;250;6;256
52;Pays de la Loire;72;1;03;071;Montval-sur-Loir;5903;217;6120
52;Pays de la Loire;72;1;08;072;Château-l'Hermitage;253;2;255
52;Pays de la Loire;72;3;16;073;Chaufour-Notre-Dame;1124;23;1147
52;Pays de la Loire;72;1;07;074;Chemiré-en-Charnie;211;9;220
52;Pays de la Loire;72;1;21;075;Chemiré-le-Gaudin;998;26;1024
52;Pays de la Loire;72;2;09;076;Chenay;247;2;249
52;Pays de la Loire;72;1;08;077;Chenu;426;8;434
52;Pays de la Loire;72;2;20;078;Chérancé;354;3;357
52;Pays de la Loire;72;2;20;079;Chérisay;312;3;315
52;Pays de la Loire;72;2;05;080;Cherré-Au;2723;80;2803
52;Pays de la Loire;72;1;07;083;Chevillé;367;11;378
52;Pays de la Loire;72;1;06;084;Clermont-Créans;1268;35;1303
52;Pays de la Loire;72;2;18;085;Cogners;183;2;185
52;Pays de la Loire;72;2;09;086;Commerveil;138;4;142
52;Pays de la Loire;72;2;18;087;Conflans-sur-Anille;471;14;485
52;Pays de la Loire;72;2;09;088;Congé-sur-Orne;329;11;340
52;Pays de la Loire;72;2;07;089;Conlie;1845;36;1881
52;Pays de la Loire;72;2;19;090;Connerré;2953;58;3011
52;Pays de la Loire;72;2;09;091;Contilly;133;4;137
52;Pays de la Loire;72;2;05;093;Cormes;897;19;916
52;Pays de la Loire;72;2;18;094;Coudrecieux;623;13;636
52;Pays de la Loire;72;3;13;095;Coulaines;7958;118;8076
52;Pays de la Loire;72;1;07;096;Coulans-sur-Gée;1647;78;1725
52;Pays de la Loire;72;1;08;098;Coulongé;508;15;523
52;Pays de la Loire;72;3;01;099;Courcebœufs;642;7;649
52;Pays de la Loire;72;1;06;100;Courcelles-la-Forêt;409;4;413
52;Pays de la Loire;72;2;01;101;Courcemont;675;13;688
52;Pays de la Loire;72;2;01;102;Courcival;93;2;95
52;Pays de la Loire;72;1;03;103;Courdemanche;609;8;617
52;Pays de la Loire;72;2;09;104;Courgains;577;16;593
52;Pays de la Loire;72;2;18;105;Courgenard;482;9;491
52;Pays de la Loire;72;1;17;106;Courtillers;928;29;957
52;Pays de la Loire;72;1;07;107;Crannes-en-Champagne;345;7;352
52;Pays de la Loire;72;2;20;109;Crissé;550;6;556
52;Pays de la Loire;72;1;06;110;Crosmières;1039;20;1059
52;Pays de la Loire;72;2;07;111;Cures;477;17;494
52;Pays de la Loire;72;2;09;112;Dangeul;477;5;482
52;Pays de la Loire;72;2;07;113;Degré;756;12;768
52;Pays de la Loire;72;2;05;114;Dehault;267;7;274
52;Pays de la Loire;72;1;03;115;Dissay-sous-Courcillon;920;23;943
52;Pays de la Loire;72;2;18;118;Dollon;1446;23;1469
52;Pays de la Loire;72;2;07;119;Domfront-en-Champagne;1043;19;1062
52;Pays de la Loire;72;2;20;120;Doucelles;243;5;248
52;Pays de la Loire;72;2;20;121;Douillet;319;10;329
52;Pays de la Loire;72;2;05;122;Duneau;1061;21;1082
52;Pays de la Loire;72;1;17;123;Dureil;68;1;69
52;Pays de la Loire;72;3;04;124;Écommoy;4752;76;4828
52;Pays de la Loire;72;2;18;125;Écorpain;299;10;309
52;Pays de la Loire;72;1;07;126;Épineu-le-Chevreuil;292;9;301
52;Pays de la Loire;72;1;21;127;Étival-lès-le-Mans;1921;38;1959
52;Pays de la Loire;72;2;18;128;Val-d'Étangson;518;6;524
52;Pays de la Loire;72;2;19;129;Fatines;857;16;873
52;Pays de la Loire;72;3;16;130;Fay;716;12;728
52;Pays de la Loire;72;1;21;131;Fercé-sur-Sarthe;588;8;596
52;Pays de la Loire;72;2;05;132;La Ferté-Bernard;8863;335;9198
52;Pays de la Loire;72;1;21;133;Fillé;1507;28;1535
52;Pays de la Loire;72;1;03;134;Flée;528;15;543
52;Pays de la Loire;72;1;08;135;La Fontaine-Saint-Martin;601;6;607
52;Pays de la Loire;72;1;07;136;Fontenay-sur-Vègre;313;8;321
52;Pays de la Loire;72;2;09;137;Villeneuve-en-Perseigne;2218;39;2257
52;Pays de la Loire;72;2;20;138;Fresnay-sur-Sarthe;2871;45;2916
52;Pays de la Loire;72;2;20;139;Fyé;981;41;1022
52;Pays de la Loire;72;2;20;141;Gesnes-le-Gandelin;903;34;937
52;Pays de la Loire;72;2;20;142;Grandchamp;146;5;151
52;Pays de la Loire;72;1;03;143;Le Grand-Lucé;1927;25;1952
52;Pays de la Loire;72;2;18;144;Gréez-sur-Roc;330;4;334
52;Pays de la Loire;72;2;20;145;Le Grez;391;4;395
52;Pays de la Loire;72;1;21;146;Guécélard;3144;41;3185
52;Pays de la Loire;72;3;01;147;La Guierche;1178;24;1202
52;Pays de la Loire;72;2;01;148;Jauzé;81;1;82
52;Pays de la Loire;72;1;07;149;Joué-en-Charnie;614;10;624
52;Pays de la Loire;72;3;01;150;Joué-l'Abbé;1266;22;1288
52;Pays de la Loire;72;1;17;151;Juigné-sur-Sarthe;1131;31;1162
52;Pays de la Loire;72;2;20;152;Juillé;429;11;440
52;Pays de la Loire;72;1;03;153;Jupilles;551;14;565
52;Pays de la Loire;72;1;06;154;La Flèche;15078;1087;16165
52;Pays de la Loire;72;3;04;155;Laigné-en-Belin;2297;30;2327
52;Pays de la Loire;72;2;18;156;Lamnay;925;24;949
52;Pays de la Loire;72;2;07;157;Lavardin;703;13;716
52;Pays de la Loire;72;2;18;158;Lavaré;818;12;830
52;Pays de la Loire;72;1;03;160;Lavernat;586;12;598
52;Pays de la Loire;72;1;03;161;Lhomme;924;11;935
52;Pays de la Loire;72;1;06;163;Ligron;488;9;497
52;Pays de la Loire;72;2;20;164;Livet-en-Saosnois;70;0;70
52;Pays de la Loire;72;2;19;165;Lombron;1912;24;1936
52;Pays de la Loire;72;1;07;166;Longnes;314;10;324
52;Pays de la Loire;72;1;17;167;Louailles;714;11;725
52;Pays de la Loire;72;1;07;168;Loué;2062;40;2102
52;Pays de la Loire;72;1;21;169;Louplande;1458;25;1483
52;Pays de la Loire;72;2;09;170;Louvigny;169;7;176
52;Pays de la Loire;72;2;09;171;Louzes;103;3;106
52;Pays de la Loire;72;2;05;172;Le Luart;1441;17;1458
52;Pays de la Loire;72;1;03;173;Luceau;1234;27;1261
52;Pays de la Loire;72;2;09;174;Lucé-sous-Ballon;100;1;101
52;Pays de la Loire;72;1;08;175;Luché-Pringé;1523;19;1542
52;Pays de la Loire;72;1;08;176;Le Lude;4100;73;4173
52;Pays de la Loire;72;1;07;177;Maigné;357;4;361
52;Pays de la Loire;72;2;18;178;Maisoncelles;190;1;191
52;Pays de la Loire;72;1;21;179;Malicorne-sur-Sarthe;1882;34;1916
52;Pays de la Loire;72;2;09;180;Mamers;5082;170;5252
52;Pays de la Loire;72;3;99;181;Le Mans;145155;2828;147983
52;Pays de la Loire;72;1;08;182;Mansigné;1541;29;1570
52;Pays de la Loire;72;1;03;183;Marçon;1076;17;1093
52;Pays de la Loire;72;1;07;184;Mareil-en-Champagne;371;6;377
52;Pays de la Loire;72;1;06;185;Mareil-sur-Loir;660;5;665
52;Pays de la Loire;72;2;20;186;Maresché;885;11;896
52;Pays de la Loire;72;3;04;187;Marigné-Laillé;1613;17;1630
52;Pays de la Loire;72;2;09;188;Marollette;154;2;156
52;Pays de la Loire;72;2;09;189;Marolles-les-Braults;2061;26;2087
52;Pays de la Loire;72;2;18;190;Marolles-lès-Saint-Calais;280;10;290
52;Pays de la Loire;72;1;08;191;Mayet;3142;43;3185
52;Pays de la Loire;72;2;09;192;Les Mées;98;3;101
52;Pays de la Loire;72;2;18;193;Melleray;429;7;436
52;Pays de la Loire;72;2;09;194;Meurcé;267;2;269
52;Pays de la Loire;72;1;21;195;Mézeray;1853;28;1881
52;Pays de la Loire;72;2;09;196;Mézières-sur-Ponthouin;730;6;736
52;Pays de la Loire;72;2;07;197;Mézières-sous-Lavardin;686;5;691
52;Pays de la Loire;72;3;11;198;La Milesse;2635;36;2671
52;Pays de la Loire;72;2;20;199;Moitron-sur-Sarthe;282;1;283
52;Pays de la Loire;72;3;04;200;Moncé-en-Belin;3669;61;3730
52;Pays de la Loire;72;2;09;201;Moncé-en-Saosnois;259;5;264
52;Pays de la Loire;72;2;09;202;Monhoudou;194;10;204
52;Pays de la Loire;72;2;18;204;Montaillé;512;7;519
52;Pays de la Loire;72;3;01;205;Montbizot;1821;24;1845
52;Pays de la Loire;72;2;18;208;Montmirail;374;9;383
52;Pays de la Loire;72;2;20;209;Montreuil-le-Chétif;304;1;305
52;Pays de la Loire;72;1;03;210;Montreuil-le-Henri;301;5;306
52;Pays de la Loire;72;2;20;211;Mont-Saint-Jean;636;9;645
52;Pays de la Loire;72;2;20;212;Moulins-le-Carbonnel;697;13;710
52;Pays de la Loire;72;3;04;213;Mulsanne;5231;64;5295
52;Pays de la Loire;72;2;09;214;Nauvay;11;0;11
52;Pays de la Loire;72;2;09;215;Neufchâtel-en-Saosnois;1042;12;1054
52;Pays de la Loire;72;2;07;216;Neuvillalais;598;14;612
52;Pays de la Loire;72;3;01;217;Neuville-sur-Sarthe;2461;48;2509
52;Pays de la Loire;72;2;20;218;Neuvillette-en-Charnie;292;4;296
52;Pays de la Loire;72;2;07;219;Bernay-Neuvy-en-Champagne;821;88;909
52;Pays de la Loire;72;2;01;220;Nogent-le-Bernard;899;37;936
52;Pays de la Loire;72;1;03;221;Nogent-sur-Loir;369;5;374
52;Pays de la Loire;72;2;09;222;Nouans;264;0;264
52;Pays de la Loire;72;1;07;223;Noyen-sur-Sarthe;2633;32;2665
52;Pays de la Loire;72;2;19;224;Nuillé-le-Jalais;528;3;531
52;Pays de la Loire;72;2;20;225;Oisseau-le-Petit;669;8;677
52;Pays de la Loire;72;1;08;226;Oizé;1334;19;1353
52;Pays de la Loire;72;2;09;227;Panon;39;0;39
52;Pays de la Loire;72;1;17;228;Parcé-sur-Sarthe;2086;49;2135
52;Pays de la Loire;72;2;20;229;Parennes;465;8;473
52;Pays de la Loire;72;1;21;230;Parigné-le-Pôlin;1062;26;1088
52;Pays de la Loire;72;3;02;231;Parigné-l'Évêque;5320;84;5404
52;Pays de la Loire;72;1;17;232;Notre-Dame-du-Pé;674;13;687
52;Pays de la Loire;72;2;09;233;Peray;64;0;64
52;Pays de la Loire;72;2;20;234;Pezé-le-Robert;359;5;364
52;Pays de la Loire;72;2;20;235;Piacé;373;7;380
52;Pays de la Loire;72;1;17;236;Pincé;190;8;198
52;Pays de la Loire;72;1;07;237;Pirmil;502;6;508
52;Pays de la Loire;72;2;09;238;Pizieux;73;0;73
52;Pays de la Loire;72;1;07;239;Poillé-sur-Vègre;605;21;626
52;Pays de la Loire;72;2;19;241;Montfort-le-Gesnois;2906;48;2954
52;Pays de la Loire;72;1;08;243;Pontvallain;1634;26;1660
52;Pays de la Loire;72;1;17;244;Précigné;2938;63;3001
52;Pays de la Loire;72;2;05;245;Préval;684;14;698
52;Pays de la Loire;72;2;05;246;Prévelles;203;6;209
52;Pays de la Loire;72;3;16;247;Pruillé-le-Chétif;1331;31;1362
52;Pays de la Loire;72;1;03;248;Pruillé-l'Éguillé;818;23;841
52;Pays de la Loire;72;2;07;249;La Quinte;778;13;791
52;Pays de la Loire;72;2;18;250;Rahay;147;9;156
52;Pays de la Loire;72;2;09;251;René;389;5;394
52;Pays de la Loire;72;1;08;252;Requeil;1134;10;1144
52;Pays de la Loire;72;1;21;253;Roëzé-sur-Sarthe;2589;70;2659
52;Pays de la Loire;72;2;20;254;Rouessé-Fontaine;264;6;270
52;Pays de la Loire;72;2;20;255;Rouessé-Vassé;795;16;811
52;Pays de la Loire;72;2;20;256;Rouez;796;16;812
52;Pays de la Loire;72;3;10;257;Rouillon;2297;316;2613
52;Pays de la Loire;72;2;01;259;Rouperroux-le-Coquet;279;7;286
52;Pays de la Loire;72;3;04;260;Ruaudin;3536;64;3600
52;Pays de la Loire;72;2;07;261;Ruillé-en-Champagne;297;12;309
52;Pays de la Loire;72;1;03;262;Loir en Vallée;2120;130;2250
52;Pays de la Loire;72;1;17;264;Sablé-sur-Sarthe;12123;471;12594
52;Pays de la Loire;72;2;09;265;Saint-Aignan;232;2;234
52;Pays de la Loire;72;2;20;266;Saint-Aubin-de-Locquenay;743;17;760
52;Pays de la Loire;72;2;05;267;Saint-Aubin-des-Coudrais;913;21;934
52;Pays de la Loire;72;3;04;268;Saint-Biez-en-Belin;705;11;716
52;Pays de la Loire;72;2;18;269;Saint-Calais;3139;207;3346
52;Pays de la Loire;72;2;09;270;Saint-Calez-en-Saosnois;196;0;196
52;Pays de la Loire;72;2;19;271;Saint-Célerin;897;7;904
52;Pays de la Loire;72;2;18;272;Sainte-Cérotte;316;7;323
52;Pays de la Loire;72;2;20;273;Saint-Christophe-du-Jambet;231;3;234
52;Pays de la Loire;72;1;07;274;Saint-Christophe-en-Champagne;206;7;213
52;Pays de la Loire;72;2;19;275;Saint-Corneille;1520;21;1541
52;Pays de la Loire;72;2;09;276;Saint-Cosme-en-Vairais;1902;46;1948
52;Pays de la Loire;72;2;05;277;Saint-Denis-des-Coudrais;113;1;114
52;Pays de la Loire;72;1;07;278;Saint-Denis-d'Orques;762;11;773
52;Pays de la Loire;72;1;03;279;Saint-Georges-de-la-Couée;151;3;154
52;Pays de la Loire;72;3;16;280;Saint-Georges-du-Bois;2162;37;2199
52;Pays de la Loire;72;2;01;281;Saint-Georges-du-Rosay;447;5;452
52;Pays de la Loire;72;2;20;282;Saint-Georges-le-Gaultier;530;7;537
52;Pays de la Loire;72;1;08;283;Saint-Germain-d'Arcé;337;6;343
52;Pays de la Loire;72;2;18;286;Saint-Gervais-de-Vic;389;7;396
52;Pays de la Loire;72;3;04;287;Saint-Gervais-en-Belin;2004;45;2049
52;Pays de la Loire;72;3;01;289;Sainte-Jamme-sur-Sarthe;2010;34;2044
52;Pays de la Loire;72;3;01;290;Saint-Jean-d'Assé;1842;17;1859
52;Pays de la Loire;72;1;08;291;Saint-Jean-de-la-Motte;975;18;993
52;Pays de la Loire;72;2;18;292;Saint-Jean-des-Échelles;230;5;235
52;Pays de la Loire;72;1;21;293;Saint-Jean-du-Bois;613;7;620
52;Pays de la Loire;72;2;20;294;Saint-Léonard-des-Bois;474;15;489
52;Pays de la Loire;72;2;09;295;Saint-Longis;503;6;509
52;Pays de la Loire;72;2;18;296;Saint-Maixent;744;23;767
52;Pays de la Loire;72;2;20;297;Saint-Marceau;538;12;550
52;Pays de la Loire;72;2;18;298;Saint-Mars-de-Locquenay;565;14;579
52;Pays de la Loire;72;3;02;299;Saint-Mars-d'Outillé;2450;34;2484
52;Pays de la Loire;72;2;19;300;Saint-Mars-la-Brière;2698;28;2726
52;Pays de la Loire;72;2;05;302;Saint-Martin-des-Monts;170;4;174
52;Pays de la Loire;72;2;18;303;Saint-Michel-de-Chavaignes;731;9;740
52;Pays de la Loire;72;2;20;305;Saint-Ouen-de-Mimbré;933;24;957
52;Pays de la Loire;72;3;04;306;Saint-Ouen-en-Belin;1323;24;1347
52;Pays de la Loire;72;1;07;307;Saint-Ouen-en-Champagne;237;6;243
52;Pays de la Loire;72;2;09;308;Saint-Paterne - Le Chevain;2103;250;2353
52;Pays de la Loire;72;2;20;309;Saint-Paul-le-Gaultier;283;7;290
52;Pays de la Loire;72;3;01;310;Saint-Pavace;1909;59;1968
52;Pays de la Loire;72;1;03;311;Saint-Pierre-de-Chevillé;344;6;350
52;Pays de la Loire;72;1;07;312;Saint-Pierre-des-Bois;232;3;235
52;Pays de la Loire;72;2;09;313;Saint-Pierre-des-Ormes;224;5;229
52;Pays de la Loire;72;1;03;314;Saint-Pierre-du-Lorouër;378;8;386
52;Pays de la Loire;72;2;20;315;Saint-Rémy-de-Sillé;834;14;848
52;Pays de la Loire;72;2;09;316;Saint-Rémy-des-Monts;692;13;705
52;Pays de la Loire;72;2;09;317;Saint-Rémy-du-Val;500;15;515
52;Pays de la Loire;72;2;07;319;Sainte-Sabine-sur-Longève;738;19;757
52;Pays de la Loire;72;3;11;320;Saint-Saturnin;2705;82;2787
52;Pays de la Loire;72;2;07;321;Saint-Symphorien;509;10;519
52;Pays de la Loire;72;2;18;322;Saint-Ulphace;223;2;225
52;Pays de la Loire;72;2;20;323;Saint-Victeur;452;7;459
52;Pays de la Loire;72;2;09;324;Saint-Vincent-des-Prés;503;14;517
52;Pays de la Loire;72;1;03;325;Saint-Vincent-du-Lorouër;832;17;849
52;Pays de la Loire;72;2;09;326;Saosnes;211;3;214
52;Pays de la Loire;72;1;08;327;Sarcé;289;8;297
52;Pays de la Loire;72;3;02;328;Sargé-lès-le-Mans;3761;93;3854
52;Pays de la Loire;72;2;19;329;Savigné-l'Évêque;4062;79;4141
52;Pays de la Loire;72;1;08;330;Savigné-sous-le-Lude;436;13;449
52;Pays de la Loire;72;2;05;331;Sceaux-sur-Huisne;577;12;589
52;Pays de la Loire;72;2;20;332;Ségrie;603;8;611
52;Pays de la Loire;72;2;18;333;Semur-en-Vallon;438;11;449
52;Pays de la Loire;72;2;20;334;Sillé-le-Guillaume;2195;85;2280
52;Pays de la Loire;72;2;19;335;Sillé-le-Philippe;1073;15;1088
52;Pays de la Loire;72;1;17;336;Solesmes;1212;40;1252
52;Pays de la Loire;72;2;20;337;Sougé-le-Ganelon;847;20;867
52;Pays de la Loire;72;3;01;338;Souillé;784;11;795
52;Pays de la Loire;72;1;21;339;Souligné-Flacé;665;10;675
52;Pays de la Loire;72;3;01;340;Souligné-sous-Ballon;1239;22;1261
52;Pays de la Loire;72;2;19;341;Soulitré;619;12;631
52;Pays de la Loire;72;2;05;342;Souvigné-sur-Même;163;7;170
52;Pays de la Loire;72;1;17;343;Souvigné-sur-Sarthe;619;13;632
52;Pays de la Loire;72;1;21;344;Spay;2863;50;2913
52;Pays de la Loire;72;2;19;345;Surfonds;339;5;344
52;Pays de la Loire;72;1;21;346;La Suze-sur-Sarthe;4498;59;4557
52;Pays de la Loire;72;1;07;347;Tassé;297;5;302
52;Pays de la Loire;72;1;07;348;Tassillé;129;1;130
52;Pays de la Loire;72;3;01;349;Teillé;476;2;478
52;Pays de la Loire;72;3;04;350;Teloché;3056;62;3118
52;Pays de la Loire;72;2;07;351;Tennie;1048;19;1067
52;Pays de la Loire;72;2;01;352;Terrehault;140;0;140
52;Pays de la Loire;72;2;05;353;Théligny;215;5;220
52;Pays de la Loire;72;2;09;354;Thoigné;163;1;164
52;Pays de la Loire;72;2;20;355;Thoiré-sous-Contensor;110;1;111
52;Pays de la Loire;72;1;03;356;Thoiré-sur-Dinan;406;6;412
52;Pays de la Loire;72;1;06;357;Thorée-les-Pins;735;12;747
52;Pays de la Loire;72;2;18;358;Thorigné-sur-Dué;1613;37;1650
52;Pays de la Loire;72;2;19;359;Torcé-en-Vallée;1430;9;1439
52;Pays de la Loire;72;3;16;360;Trangé;1553;39;1592
52;Pays de la Loire;72;2;18;361;Tresson;491;8;499
52;Pays de la Loire;72;2;20;362;Le Tronchet;166;1;167
52;Pays de la Loire;72;2;05;363;Tuffé Val de la Chéronne;1668;16;1684
52;Pays de la Loire;72;1;08;364;Vaas;1394;25;1419
52;Pays de la Loire;72;2;18;366;Valennes;315;2;317
52;Pays de la Loire;72;1;07;367;Vallon-sur-Gée;785;11;796
52;Pays de la Loire;72;2;18;368;Vancé;310;3;313
52;Pays de la Loire;72;1;08;369;Verneil-le-Chétif;578;55;633
52;Pays de la Loire;72;2;20;370;Vernie;326;6;332
52;Pays de la Loire;72;2;09;372;Vezot;77;0;77
52;Pays de la Loire;72;2;18;373;Vibraye;2509;55;2564
52;Pays de la Loire;72;2;09;374;Villaines-la-Carelle;146;5;151
52;Pays de la Loire;72;2;05;375;Villaines-la-Gonais;529;14;543
52;Pays de la Loire;72;1;03;376;Villaines-sous-Lucé;688;25;713
52;Pays de la Loire;72;1;06;377;Villaines-sous-Malicorne;1034;12;1046
52;Pays de la Loire;72;1;17;378;Vion;1426;28;1454
52;Pays de la Loire;72;1;07;379;Viré-en-Champagne;198;7;205
52;Pays de la Loire;72;2;20;380;Vivoin;931;13;944
52;Pays de la Loire;72;1;21;381;Voivres-lès-le-Mans;1371;12;1383
52;Pays de la Loire;72;2;18;382;Volnay;955;18;973
52;Pays de la Loire;72;2;05;383;Vouvray-sur-Huisne;132;4;136
52;Pays de la Loire;72;1;08;385;Yvré-le-Pôlin;1759;24;1783
52;Pays de la Loire;72;3;02;386;Yvré-l'Évêque;4241;134;4375
84;Auvergne-Rhône-Alpes;73;2;14;001;Aiguebelette-le-Lac;230;9;239
84;Auvergne-Rhône-Alpes;73;1;13;003;Grand-Aigueblanche;3823;104;3927
84;Auvergne-Rhône-Alpes;73;2;16;004;Aillon-le-Jeune;431;15;446
84;Auvergne-Rhône-Alpes;73;2;16;005;Aillon-le-Vieux;194;5;199
84;Auvergne-Rhône-Alpes;73;1;05;006;Aime-la-Plagne;4433;104;4537
84;Auvergne-Rhône-Alpes;73;3;18;007;Aiton;1683;23;1706
84;Auvergne-Rhône-Alpes;73;2;97;008;Aix-les-Bains;31100;542;31642
84;Auvergne-Rhône-Alpes;73;2;01;010;Entrelacs;6340;140;6480
84;Auvergne-Rhône-Alpes;73;1;98;011;Albertville;19830;584;20414
84;Auvergne-Rhône-Alpes;73;3;17;012;Albiez-le-Jeune;146;2;148
84;Auvergne-Rhône-Alpes;73;3;17;013;Albiez-Montrond;364;10;374
84;Auvergne-Rhône-Alpes;73;1;03;014;Allondaz;290;8;298
84;Auvergne-Rhône-Alpes;73;1;13;015;Les Allues;1829;48;1877
84;Auvergne-Rhône-Alpes;73;2;11;017;Apremont;979;21;1000
84;Auvergne-Rhône-Alpes;73;2;11;018;Arbin;765;21;786
84;Auvergne-Rhône-Alpes;73;3;18;019;Argentine;951;21;972
84;Auvergne-Rhône-Alpes;73;2;16;020;Arith;440;11;451
84;Auvergne-Rhône-Alpes;73;2;11;021;Arvillard;846;17;863
84;Auvergne-Rhône-Alpes;73;2;14;022;Attignat-Oncin;566;13;579
84;Auvergne-Rhône-Alpes;73;3;10;023;Aussois;693;18;711
84;Auvergne-Rhône-Alpes;73;1;13;024;Les Avanchers-Valmorel;768;22;790
84;Auvergne-Rhône-Alpes;73;2;06;025;Avressieux;531;11;542
84;Auvergne-Rhône-Alpes;73;3;10;026;Avrieux;389;16;405
84;Auvergne-Rhône-Alpes;73;2;14;027;Ayn;387;6;393
84;Auvergne-Rhône-Alpes;73;2;06;028;La Balme;344;3;347
84;Auvergne-Rhône-Alpes;73;2;15;029;Barberaz;5167;123;5290
84;Auvergne-Rhône-Alpes;73;2;16;030;Barby;3551;53;3604
84;Auvergne-Rhône-Alpes;73;2;16;031;Bassens;5063;127;5190
84;Auvergne-Rhône-Alpes;73;1;03;032;La Bâthie;2129;37;2166
84;Auvergne-Rhône-Alpes;73;2;14;033;La Bauche;510;12;522
84;Auvergne-Rhône-Alpes;73;1;19;034;Beaufort;2024;82;2106
84;Auvergne-Rhône-Alpes;73;2;16;036;Bellecombe-en-Bauges;689;19;708
84;Auvergne-Rhône-Alpes;73;2;14;039;Belmont-Tramonet;523;12;535
84;Auvergne-Rhône-Alpes;73;3;10;040;Bessans;359;8;367
84;Auvergne-Rhône-Alpes;73;2;18;041;Betton-Bettonet;307;8;315
84;Auvergne-Rhône-Alpes;73;2;06;042;Billième;259;6;265
84;Auvergne-Rhône-Alpes;73;2;01;043;La Biolle;2867;37;2904
84;Auvergne-Rhône-Alpes;73;3;10;047;Bonneval-sur-Arc;263;5;268
84;Auvergne-Rhône-Alpes;73;1;04;048;Bonvillard;353;14;367
84;Auvergne-Rhône-Alpes;73;3;18;049;Bonvillaret;147;0;147
84;Auvergne-Rhône-Alpes;73;2;12;050;Bourdeau;579;20;599
84;Auvergne-Rhône-Alpes;73;2;12;051;Le Bourget-du-Lac;4911;98;5009
84;Auvergne-Rhône-Alpes;73;2;11;052;Bourget-en-Huile;147;5;152
84;Auvergne-Rhône-Alpes;73;2;18;053;Bourgneuf;694;11;705
84;Auvergne-Rhône-Alpes;73;1;05;054;Bourg-Saint-Maurice;7160;401;7561
84;Auvergne-Rhône-Alpes;73;1;13;055;Bozel;1876;58;1934
84;Auvergne-Rhône-Alpes;73;1;13;057;Brides-les-Bains;491;13;504
84;Auvergne-Rhône-Alpes;73;2;14;058;La Bridoire;1250;19;1269
84;Auvergne-Rhône-Alpes;73;2;01;059;Brison-Saint-Innocent;2327;73;2400
84;Auvergne-Rhône-Alpes;73;1;19;061;Césarches;421;16;437
84;Auvergne-Rhône-Alpes;73;1;03;063;Cevins;705;9;714
84;Auvergne-Rhône-Alpes;73;2;15;064;Challes-les-Eaux;5609;266;5875
84;Auvergne-Rhône-Alpes;73;2;99;065;Chambéry;59172;1577;60749
84;Auvergne-Rhône-Alpes;73;3;17;067;La Chambre;1164;19;1183
84;Auvergne-Rhône-Alpes;73;2;18;068;Chamousset;597;13;610
84;Auvergne-Rhône-Alpes;73;2;18;069;Chamoux-sur-Gelon;954;17;971
84;Auvergne-Rhône-Alpes;73;2;06;070;Champagneux;692;9;701
84;Auvergne-Rhône-Alpes;73;1;13;071;Champagny-en-Vanoise;557;20;577
84;Auvergne-Rhône-Alpes;73;2;18;072;Champ-Laurent;31;1;32
84;Auvergne-Rhône-Alpes;73;2;06;073;Chanaz;547;7;554
84;Auvergne-Rhône-Alpes;73;3;17;074;La Chapelle;330;11;341
84;Auvergne-Rhône-Alpes;73;2;11;075;La Chapelle-Blanche;577;23;600
84;Auvergne-Rhône-Alpes;73;2;12;076;La Chapelle-du-Mont-du-Chat;260;5;265
84;Auvergne-Rhône-Alpes;73;1;05;077;Les Chapelles;563;9;572
84;Auvergne-Rhône-Alpes;73;2;06;078;La Chapelle-Saint-Martin;142;6;148
84;Auvergne-Rhône-Alpes;73;2;18;079;Châteauneuf;936;16;952
84;Auvergne-Rhône-Alpes;73;2;16;081;Le Châtelard;661;43;704
84;Auvergne-Rhône-Alpes;73;2;11;082;La Chavanne;740;29;769
84;Auvergne-Rhône-Alpes;73;3;17;083;Les Chavannes-en-Maurienne;223;3;226
84;Auvergne-Rhône-Alpes;73;2;11;084;Chignin;938;15;953
84;Auvergne-Rhône-Alpes;73;2;06;085;Chindrieux;1408;21;1429
84;Auvergne-Rhône-Alpes;73;1;04;086;Cléry;388;13;401
84;Auvergne-Rhône-Alpes;73;2;09;087;Cognin;6467;189;6656
84;Auvergne-Rhône-Alpes;73;1;19;088;Cohennoz;151;4;155
84;Auvergne-Rhône-Alpes;73;2;18;089;Coise-Saint-Jean-Pied-Gauthier;1281;26;1307
84;Auvergne-Rhône-Alpes;73;2;16;090;La Compôte;264;7;271
84;Auvergne-Rhône-Alpes;73;2;06;091;Conjux;210;3;213
84;Auvergne-Rhône-Alpes;73;2;14;092;Corbel;154;4;158
84;Auvergne-Rhône-Alpes;73;1;19;094;Crest-Voland;332;13;345
84;Auvergne-Rhône-Alpes;73;2;11;095;La Croix-de-la-Rochette;383;9;392
84;Auvergne-Rhône-Alpes;73;2;18;096;Cruet;1045;19;1064
84;Auvergne-Rhône-Alpes;73;2;16;097;Curienne;671;21;692
84;Auvergne-Rhône-Alpes;73;2;16;098;Les Déserts;812;22;834
84;Auvergne-Rhône-Alpes;73;2;11;099;Détrier;435;4;439
84;Auvergne-Rhône-Alpes;73;2;14;100;Domessin;1929;45;1974
84;Auvergne-Rhône-Alpes;73;2;16;101;Doucy-en-Bauges;97;2;99
84;Auvergne-Rhône-Alpes;73;2;12;103;Drumettaz-Clarafond;2998;67;3065
84;Auvergne-Rhône-Alpes;73;2;14;104;Dullin;483;5;488
84;Auvergne-Rhône-Alpes;73;2;14;105;Les Échelles;1246;16;1262
84;Auvergne-Rhône-Alpes;73;2;16;106;École;306;6;312
84;Auvergne-Rhône-Alpes;73;2;14;107;Entremont-le-Vieux;641;8;649
84;Auvergne-Rhône-Alpes;73;3;18;109;Épierre;770;14;784
84;Auvergne-Rhône-Alpes;73;1;03;110;Esserts-Blay;771;7;778
84;Auvergne-Rhône-Alpes;73;1;13;113;Feissons-sur-Salins;175;3;178
84;Auvergne-Rhône-Alpes;73;1;19;114;Flumet;796;28;824
84;Auvergne-Rhône-Alpes;73;3;17;116;Fontcouverte-la-Toussuire;481;12;493
84;Auvergne-Rhône-Alpes;73;3;10;117;Fourneaux;698;10;708
84;Auvergne-Rhône-Alpes;73;3;10;119;Freney;100;4;104
84;Auvergne-Rhône-Alpes;73;2;18;120;Fréterive;616;10;626
84;Auvergne-Rhône-Alpes;73;1;04;121;Frontenex;1943;48;1991
84;Auvergne-Rhône-Alpes;73;2;06;122;Gerbaix;427;19;446
84;Auvergne-Rhône-Alpes;73;1;19;123;La Giettaz;383;14;397
84;Auvergne-Rhône-Alpes;73;1;04;124;Gilly-sur-Isère;3062;79;3141
84;Auvergne-Rhône-Alpes;73;2;01;128;Grésy-sur-Aix;4598;103;4701
84;Auvergne-Rhône-Alpes;73;1;04;129;Grésy-sur-Isère;1202;39;1241
84;Auvergne-Rhône-Alpes;73;1;04;130;Grignon;2097;40;2137
84;Auvergne-Rhône-Alpes;73;1;13;131;Hautecour;301;9;310
84;Auvergne-Rhône-Alpes;73;1;19;132;Hauteluce;759;23;782
84;Auvergne-Rhône-Alpes;73;2;18;133;Hauteville;351;8;359
84;Auvergne-Rhône-Alpes;73;3;17;135;La Tour-en-Maurienne;1083;19;1102
84;Auvergne-Rhône-Alpes;73;2;08;137;Jacob-Bellecombette;4017;77;4094
84;Auvergne-Rhône-Alpes;73;3;17;138;Jarrier;495;11;506
84;Auvergne-Rhône-Alpes;73;2;16;139;Jarsy;266;4;270
84;Auvergne-Rhône-Alpes;73;2;06;140;Jongieux;281;6;287
84;Auvergne-Rhône-Alpes;73;2;11;141;Laissaud;709;8;717
84;Auvergne-Rhône-Alpes;73;1;05;142;Landry;802;20;822
84;Auvergne-Rhône-Alpes;73;2;14;145;Lépin-le-Lac;469;13;482
84;Auvergne-Rhône-Alpes;73;2;16;146;Lescheraines;790;17;807
84;Auvergne-Rhône-Alpes;73;2;06;147;Loisieux;200;0;200
84;Auvergne-Rhône-Alpes;73;2;06;149;Lucey;298;6;304
84;Auvergne-Rhône-Alpes;73;1;05;150;La Plagne Tarentaise;3828;131;3959
84;Auvergne-Rhône-Alpes;73;2;11;151;Porte-de-Savoie;3830;73;3903
84;Auvergne-Rhône-Alpes;73;2;06;152;Marcieux;225;5;230
84;Auvergne-Rhône-Alpes;73;1;19;153;Marthod;1345;31;1376
84;Auvergne-Rhône-Alpes;73;1;03;154;Mercury;3351;83;3434
84;Auvergne-Rhône-Alpes;73;2;12;155;Méry;2106;42;2148
84;Auvergne-Rhône-Alpes;73;2;06;156;Meyrieux-Trouet;314;6;320
84;Auvergne-Rhône-Alpes;73;3;10;157;Modane;3010;144;3154
84;Auvergne-Rhône-Alpes;73;2;11;159;Les Mollettes;859;9;868
84;Auvergne-Rhône-Alpes;73;2;14;160;Montagnole;976;26;1002
84;Auvergne-Rhône-Alpes;73;1;13;161;Montagny;651;14;665
84;Auvergne-Rhône-Alpes;73;1;04;162;Montailleur;671;24;695
84;Auvergne-Rhône-Alpes;73;2;01;164;Montcel;1037;55;1092
84;Auvergne-Rhône-Alpes;73;2;18;166;Montendry;53;2;55
84;Auvergne-Rhône-Alpes;73;3;18;168;Montgilbert;117;2;119
84;Auvergne-Rhône-Alpes;73;1;04;170;Monthion;526;10;536
84;Auvergne-Rhône-Alpes;73;2;11;171;Montmélian;4064;73;4137
84;Auvergne-Rhône-Alpes;73;3;17;173;Montricher-Albanne;477;10;487
84;Auvergne-Rhône-Alpes;73;3;18;175;Montsapey;78;3;81
84;Auvergne-Rhône-Alpes;73;1;05;176;Montvalezan;718;10;728
84;Auvergne-Rhône-Alpes;73;3;17;177;Montvernier;236;7;243
84;Auvergne-Rhône-Alpes;73;2;16;178;La Motte-en-Bauges;509;12;521
84;Auvergne-Rhône-Alpes;73;2;12;179;La Motte-Servolex;12377;658;13035
84;Auvergne-Rhône-Alpes;73;2;06;180;Motz;436;7;443
84;Auvergne-Rhône-Alpes;73;1;13;181;Moûtiers;3467;465;3932
84;Auvergne-Rhône-Alpes;73;2;02;182;Mouxy;2248;51;2299
84;Auvergne-Rhône-Alpes;73;2;11;183;Myans;1296;34;1330
84;Auvergne-Rhône-Alpes;73;2;14;184;Nances;518;11;529
84;Auvergne-Rhône-Alpes;73;1;19;186;Notre-Dame-de-Bellecombe;474;12;486
84;Auvergne-Rhône-Alpes;73;1;13;187;La Léchère;2601;50;2651
84;Auvergne-Rhône-Alpes;73;1;04;188;Notre-Dame-des-Millières;1024;24;1048
84;Auvergne-Rhône-Alpes;73;3;17;189;Notre-Dame-du-Cruet;223;2;225
84;Auvergne-Rhône-Alpes;73;1;13;190;Notre-Dame-du-Pré;250;6;256
84;Auvergne-Rhône-Alpes;73;2;06;191;Novalaise;2185;66;2251
84;Auvergne-Rhône-Alpes;73;2;16;192;Le Noyer;211;5;216
84;Auvergne-Rhône-Alpes;73;2;06;193;Ontex;107;3;110
84;Auvergne-Rhône-Alpes;73;3;10;194;Orelle;317;9;326
84;Auvergne-Rhône-Alpes;73;1;19;196;Pallud;794;18;812
84;Auvergne-Rhône-Alpes;73;1;05;197;Peisey-Nancroix;636;24;660
84;Auvergne-Rhône-Alpes;73;2;11;200;Planaise;555;7;562
84;Auvergne-Rhône-Alpes;73;1;13;201;Planay;441;11;452
84;Auvergne-Rhône-Alpes;73;1;04;202;Plancherine;463;11;474
84;Auvergne-Rhône-Alpes;73;2;14;204;Le Pont-de-Beauvoisin;2069;30;2099
84;Auvergne-Rhône-Alpes;73;2;11;205;Le Pontet;122;1;123
84;Auvergne-Rhône-Alpes;73;1;13;206;Pralognan-la-Vanoise;712;22;734
84;Auvergne-Rhône-Alpes;73;2;11;207;Presle;433;12;445
84;Auvergne-Rhône-Alpes;73;2;01;208;Pugny-Chatenod;987;25;1012
84;Auvergne-Rhône-Alpes;73;2;16;210;Puygros;377;6;383
84;Auvergne-Rhône-Alpes;73;1;19;211;Queige;821;23;844
84;Auvergne-Rhône-Alpes;73;3;18;212;Val-d'Arc;2015;23;2038
84;Auvergne-Rhône-Alpes;73;2;15;213;La Ravoire;8939;548;9487
84;Auvergne-Rhône-Alpes;73;2;06;214;Rochefort;243;10;253
84;Auvergne-Rhône-Alpes;73;2;11;215;Valgelon-La Rochette;4175;69;4244
84;Auvergne-Rhône-Alpes;73;1;03;216;Rognaix;492;6;498
84;Auvergne-Rhône-Alpes;73;2;11;217;Rotherens;368;12;380
84;Auvergne-Rhône-Alpes;73;2;06;218;Ruffieux;808;17;825
84;Auvergne-Rhône-Alpes;73;2;14;219;Saint-Alban-de-Montbel;666;15;681
84;Auvergne-Rhône-Alpes;73;3;18;220;Saint-Alban-d'Hurtières;369;10;379
84;Auvergne-Rhône-Alpes;73;3;17;221;Saint-Alban-des-Villards;87;3;90
84;Auvergne-Rhône-Alpes;73;2;16;222;Saint-Alban-Leysse;6286;213;6499
84;Auvergne-Rhône-Alpes;73;3;10;223;Saint-André;446;7;453
84;Auvergne-Rhône-Alpes;73;3;17;224;Saint-Avre;899;21;920
84;Auvergne-Rhône-Alpes;73;2;15;225;Saint-Baldoph;2730;89;2819
84;Auvergne-Rhône-Alpes;73;2;14;226;Saint-Béron;1710;21;1731
84;Auvergne-Rhône-Alpes;73;1;13;227;Courchevel;2358;77;2435
84;Auvergne-Rhône-Alpes;73;2;14;228;Saint-Cassin;936;23;959
84;Auvergne-Rhône-Alpes;73;2;14;229;Saint-Christophe;529;13;542
84;Auvergne-Rhône-Alpes;73;3;17;230;Saint-Colomban-des-Villards;130;1;131
84;Auvergne-Rhône-Alpes;73;3;17;231;Saint-Étienne-de-Cuines;1208;24;1232
84;Auvergne-Rhône-Alpes;73;1;05;232;Sainte-Foy-Tarentaise;707;22;729
84;Auvergne-Rhône-Alpes;73;2;14;233;Saint-Franc;158;4;162
84;Auvergne-Rhône-Alpes;73;2;16;234;Saint-François-de-Sales;148;3;151
84;Auvergne-Rhône-Alpes;73;3;17;235;Saint François Longchamp;545;6;551
84;Auvergne-Rhône-Alpes;73;2;06;236;Saint-Genix-les-Villages;2895;67;2962
84;Auvergne-Rhône-Alpes;73;3;18;237;Saint-Georges-d'Hurtières;369;4;373
84;Auvergne-Rhône-Alpes;73;2;11;240;Sainte-Hélène-du-Lac;803;21;824
84;Auvergne-Rhône-Alpes;73;1;04;241;Sainte-Hélène-sur-Isère;1201;20;1221
84;Auvergne-Rhône-Alpes;73;3;17;242;Saint-Jean-d'Arves;272;10;282
84;Auvergne-Rhône-Alpes;73;2;16;243;Saint-Jean-d'Arvey;1724;59;1783
84;Auvergne-Rhône-Alpes;73;2;06;245;Saint-Jean-de-Chevelu;834;15;849
84;Auvergne-Rhône-Alpes;73;2;14;246;Saint-Jean-de-Couz;303;5;308
84;Auvergne-Rhône-Alpes;73;2;18;247;Saint-Jean-de-la-Porte;963;73;1036
84;Auvergne-Rhône-Alpes;73;3;17;248;Saint-Jean-de-Maurienne;7560;334;7894
84;Auvergne-Rhône-Alpes;73;2;15;249;Saint-Jeoire-Prieuré;1898;50;1948
84;Auvergne-Rhône-Alpes;73;3;17;250;Saint-Julien-Mont-Denis;1588;37;1625
84;Auvergne-Rhône-Alpes;73;3;18;252;Saint-Léger;247;3;250
84;Auvergne-Rhône-Alpes;73;1;13;253;Saint-Marcel;606;5;611
84;Auvergne-Rhône-Alpes;73;2;06;254;Sainte-Marie-d'Alvey;123;2;125
84;Auvergne-Rhône-Alpes;73;3;17;255;Sainte-Marie-de-Cuines;826;21;847
84;Auvergne-Rhône-Alpes;73;3;10;256;Saint-Martin-d'Arc;310;8;318
84;Auvergne-Rhône-Alpes;73;1;13;257;Les Belleville;3476;116;3592
84;Auvergne-Rhône-Alpes;73;3;10;258;Saint-Martin-de-la-Porte;679;20;699
84;Auvergne-Rhône-Alpes;73;3;17;259;Saint-Martin-sur-la-Chambre;541;15;556
84;Auvergne-Rhône-Alpes;73;3;10;261;Saint-Michel-de-Maurienne;2474;280;2754
84;Auvergne-Rhône-Alpes;73;1;19;262;Saint-Nicolas-la-Chapelle;476;35;511
84;Auvergne-Rhône-Alpes;73;2;01;263;Saint-Offenge;1151;31;1182
84;Auvergne-Rhône-Alpes;73;2;01;265;Saint-Ours;732;20;752
84;Auvergne-Rhône-Alpes;73;3;17;267;Saint-Pancrace;301;10;311
84;Auvergne-Rhône-Alpes;73;1;03;268;Saint-Paul-sur-Isère;526;61;587
84;Auvergne-Rhône-Alpes;73;2;06;269;Saint-Paul;730;14;744
84;Auvergne-Rhône-Alpes;73;2;18;270;Saint-Pierre-d'Albigny;4168;104;4272
84;Auvergne-Rhône-Alpes;73;2;06;271;Saint-Pierre-d'Alvey;310;10;320
84;Auvergne-Rhône-Alpes;73;3;18;272;Saint-Pierre-de-Belleville;177;4;181
84;Auvergne-Rhône-Alpes;73;2;06;273;Saint-Pierre-de-Curtille;488;6;494
84;Auvergne-Rhône-Alpes;73;2;14;274;Saint-Pierre-d'Entremont;447;15;462
84;Auvergne-Rhône-Alpes;73;2;14;275;Saint-Pierre-de-Genebroz;319;9;328
84;Auvergne-Rhône-Alpes;73;2;11;276;Saint-Pierre-de-Soucy;418;19;437
84;Auvergne-Rhône-Alpes;73;2;16;277;Sainte-Reine;172;7;179
84;Auvergne-Rhône-Alpes;73;3;17;278;Saint-Rémy-de-Maurienne;1238;21;1259
84;Auvergne-Rhône-Alpes;73;3;17;280;Saint-Sorlin-d'Arves;349;8;357
84;Auvergne-Rhône-Alpes;73;2;14;281;Saint-Sulpice;771;20;791
84;Auvergne-Rhône-Alpes;73;2;14;282;Saint-Thibaud-de-Couz;1074;18;1092
84;Auvergne-Rhône-Alpes;73;1;04;283;Saint-Vital;726;18;744
84;Auvergne-Rhône-Alpes;73;1;13;284;Salins-Fontaine;994;20;1014
84;Auvergne-Rhône-Alpes;73;1;05;285;Séez;2367;49;2416
84;Auvergne-Rhône-Alpes;73;2;06;286;Serrières-en-Chautagne;1166;18;1184
84;Auvergne-Rhône-Alpes;73;2;07;288;Sonnaz;2072;47;2119
84;Auvergne-Rhône-Alpes;73;2;11;289;La Table;421;10;431
84;Auvergne-Rhône-Alpes;73;3;10;290;Val-Cenis;2068;38;2106
84;Auvergne-Rhône-Alpes;73;1;19;292;Thénésol;317;8;325
84;Auvergne-Rhône-Alpes;73;2;16;293;Thoiry;454;7;461
84;Auvergne-Rhône-Alpes;73;2;16;294;La Thuile;341;6;347
84;Auvergne-Rhône-Alpes;73;1;05;296;Tignes;2016;42;2058
84;Auvergne-Rhône-Alpes;73;1;04;297;Tournon;583;23;606
84;Auvergne-Rhône-Alpes;73;1;03;298;Tours-en-Savoie;908;11;919
84;Auvergne-Rhône-Alpes;73;2;06;299;Traize;326;6;332
84;Auvergne-Rhône-Alpes;73;2;02;300;Tresserve;2981;107;3088
84;Auvergne-Rhône-Alpes;73;2;01;301;Trévignin;833;16;849
84;Auvergne-Rhône-Alpes;73;2;11;302;La Trinité;352;6;358
84;Auvergne-Rhône-Alpes;73;1;19;303;Ugine;7135;231;7366
84;Auvergne-Rhône-Alpes;73;1;05;304;Val-d'Isère;1589;47;1636
84;Auvergne-Rhône-Alpes;73;3;10;306;Valloire;1071;25;1096
84;Auvergne-Rhône-Alpes;73;3;10;307;Valmeinier;569;3;572
84;Auvergne-Rhône-Alpes;73;1;19;308;Venthon;584;18;602
84;Auvergne-Rhône-Alpes;73;2;14;309;Verel-de-Montbel;313;6;319
84;Auvergne-Rhône-Alpes;73;2;16;310;Verel-Pragondran;480;12;492
84;Auvergne-Rhône-Alpes;73;2;11;311;Le Verneil;100;5;105
84;Auvergne-Rhône-Alpes;73;1;04;312;Verrens-Arvey;932;35;967
84;Auvergne-Rhône-Alpes;73;2;06;313;Verthemex;231;2;233
84;Auvergne-Rhône-Alpes;73;2;11;314;Villard-d'Héry;257;5;262
84;Auvergne-Rhône-Alpes;73;2;18;315;Villard-Léger;450;13;463
84;Auvergne-Rhône-Alpes;73;2;11;316;Villard-Sallet;288;4;292
84;Auvergne-Rhône-Alpes;73;1;19;317;Villard-sur-Doron;692;26;718
84;Auvergne-Rhône-Alpes;73;3;17;318;Villarembert;250;9;259
84;Auvergne-Rhône-Alpes;73;3;17;320;Villargondran;834;26;860
84;Auvergne-Rhône-Alpes;73;3;10;322;Villarodin-Bourget;538;14;552
84;Auvergne-Rhône-Alpes;73;1;05;323;Villaroger;362;15;377
84;Auvergne-Rhône-Alpes;73;2;11;324;Villaroux;189;7;196
84;Auvergne-Rhône-Alpes;73;2;14;326;Vimines;2172;40;2212
84;Auvergne-Rhône-Alpes;73;2;06;327;Vions;405;3;408
84;Auvergne-Rhône-Alpes;73;2;12;328;Viviers-du-Lac;2286;56;2342
84;Auvergne-Rhône-Alpes;73;2;12;329;Voglans;1941;30;1971
84;Auvergne-Rhône-Alpes;73;2;06;330;Yenne;3083;31;3114
84;Auvergne-Rhône-Alpes;74;4;07;001;Abondance;1450;118;1568
84;Auvergne-Rhône-Alpes;74;1;12;002;Alby-sur-Chéran;2665;58;2723
84;Auvergne-Rhône-Alpes;74;1;08;003;Alex;1106;34;1140
84;Auvergne-Rhône-Alpes;74;1;12;004;Allèves;411;8;419
84;Auvergne-Rhône-Alpes;74;4;17;005;Allinges;4767;118;4885
84;Auvergne-Rhône-Alpes;74;3;11;006;Allonzier-la-Caille;2182;37;2219
84;Auvergne-Rhône-Alpes;74;2;11;007;Amancy;2767;56;2823
84;Auvergne-Rhône-Alpes;74;3;04;008;Ambilly;6014;66;6080
84;Auvergne-Rhône-Alpes;74;3;11;009;Andilly;980;19;999
84;Auvergne-Rhône-Alpes;74;1;99;010;Annecy;131766;3176;134942
84;Auvergne-Rhône-Alpes;74;3;04;012;Annemasse;37485;374;37859
84;Auvergne-Rhône-Alpes;74;4;15;013;Anthy-sur-Léman;2253;92;2345
84;Auvergne-Rhône-Alpes;74;2;14;014;Arâches-la-Frasse;1814;51;1865
84;Auvergne-Rhône-Alpes;74;3;11;015;Arbusigny;1135;24;1159
84;Auvergne-Rhône-Alpes;74;3;13;016;Archamps;2621;36;2657
84;Auvergne-Rhône-Alpes;74;2;05;018;Arenthon;1888;50;1938
84;Auvergne-Rhône-Alpes;74;1;03;019;Argonay;3508;273;3781
84;Auvergne-Rhône-Alpes;74;4;17;020;Armoy;1398;58;1456
84;Auvergne-Rhône-Alpes;74;3;09;021;Arthaz-Pont-Notre-Dame;1646;31;1677
84;Auvergne-Rhône-Alpes;74;2;05;024;Ayse;2225;60;2285
84;Auvergne-Rhône-Alpes;74;4;15;025;Ballaison;1495;21;1516
84;Auvergne-Rhône-Alpes;74;1;01;026;La Balme-de-Sillingy;5119;140;5259
84;Auvergne-Rhône-Alpes;74;1;08;027;La Balme-de-Thuy;451;9;460
84;Auvergne-Rhône-Alpes;74;3;13;029;Bassy;414;14;428
84;Auvergne-Rhône-Alpes;74;4;07;030;La Baume;322;6;328
84;Auvergne-Rhône-Alpes;74;3;13;031;Beaumont;3045;57;3102
84;Auvergne-Rhône-Alpes;74;4;17;032;Bellevaux;1275;39;1314
84;Auvergne-Rhône-Alpes;74;4;07;033;Bernex;1407;28;1435
84;Auvergne-Rhône-Alpes;74;4;07;034;Le Biot;636;7;643
84;Auvergne-Rhône-Alpes;74;1;12;035;Bloye;587;23;610
84;Auvergne-Rhône-Alpes;74;1;08;036;Bluffy;382;12;394
84;Auvergne-Rhône-Alpes;74;4;15;037;Boëge;1870;62;1932
84;Auvergne-Rhône-Alpes;74;4;15;038;Bogève;1128;29;1157
84;Auvergne-Rhône-Alpes;74;3;09;040;Bonne;3246;146;3392
84;Auvergne-Rhône-Alpes;74;4;07;041;Bonnevaux;283;5;288
84;Auvergne-Rhône-Alpes;74;2;05;042;Bonneville;12511;391;12902
84;Auvergne-Rhône-Alpes;74;4;15;043;Bons-en-Chablais;5806;109;5915
84;Auvergne-Rhône-Alpes;74;3;13;044;Bossey;1010;10;1020
84;Auvergne-Rhône-Alpes;74;1;08;045;Le Bouchet-Mont-Charvin;253;6;259
84;Auvergne-Rhône-Alpes;74;1;12;046;Boussy;512;12;524
84;Auvergne-Rhône-Alpes;74;4;15;048;Brenthonne;1103;20;1123
84;Auvergne-Rhône-Alpes;74;2;05;049;Brizon;481;1;482
84;Auvergne-Rhône-Alpes;74;4;15;050;Burdignin;680;16;696
84;Auvergne-Rhône-Alpes;74;3;11;051;Cercier;712;11;723
84;Auvergne-Rhône-Alpes;74;3;11;052;Cernex;1109;19;1128
84;Auvergne-Rhône-Alpes;74;4;17;053;Cervens;1237;29;1266
84;Auvergne-Rhône-Alpes;74;1;12;054;Chainaz-les-Frasses;763;29;792
84;Auvergne-Rhône-Alpes;74;3;13;055;Challonges;546;13;559
84;Auvergne-Rhône-Alpes;74;2;10;056;Chamonix-Mont-Blanc;8644;375;9019
84;Auvergne-Rhône-Alpes;74;4;07;057;Champanges;1128;32;1160
84;Auvergne-Rhône-Alpes;74;4;07;058;La Chapelle-d'Abondance;909;16;925
84;Auvergne-Rhône-Alpes;74;2;11;059;La Chapelle-Rambaud;258;9;267
84;Auvergne-Rhône-Alpes;74;1;16;060;La Chapelle-Saint-Maurice;113;0;113
84;Auvergne-Rhône-Alpes;74;1;12;061;Chapeiry;948;16;964
84;Auvergne-Rhône-Alpes;74;1;03;062;Charvonnex;1454;28;1482
84;Auvergne-Rhône-Alpes;74;4;07;063;Châtel;1219;29;1248
84;Auvergne-Rhône-Alpes;74;2;06;064;Châtillon-sur-Cluses;1190;42;1232
84;Auvergne-Rhône-Alpes;74;3;13;065;Chaumont;513;11;524
84;Auvergne-Rhône-Alpes;74;3;13;066;Chavannaz;249;1;250
84;Auvergne-Rhône-Alpes;74;1;16;067;Chavanod;2803;171;2974
84;Auvergne-Rhône-Alpes;74;3;13;068;Chêne-en-Semine;515;9;524
84;Auvergne-Rhône-Alpes;74;3;13;069;Chênex;807;14;821
84;Auvergne-Rhône-Alpes;74;4;15;070;Chens-sur-Léman;2877;35;2912
84;Auvergne-Rhône-Alpes;74;3;13;071;Chessenaz;224;7;231
84;Auvergne-Rhône-Alpes;74;1;08;072;Chevaline;195;4;199
84;Auvergne-Rhône-Alpes;74;4;07;073;Chevenoz;674;11;685
84;Auvergne-Rhône-Alpes;74;3;13;074;Chevrier;638;7;645
84;Auvergne-Rhône-Alpes;74;3;13;075;Chilly;1507;24;1531
84;Auvergne-Rhône-Alpes;74;1;01;076;Choisy;1688;44;1732
84;Auvergne-Rhône-Alpes;74;3;13;077;Clarafond-Arcine;1040;23;1063
84;Auvergne-Rhône-Alpes;74;3;13;078;Clermont;400;5;405
84;Auvergne-Rhône-Alpes;74;1;08;079;Les Clefs;684;6;690
84;Auvergne-Rhône-Alpes;74;1;08;080;La Clusaz;1706;52;1758
84;Auvergne-Rhône-Alpes;74;2;06;081;Cluses;16976;396;17372
84;Auvergne-Rhône-Alpes;74;3;13;082;Collonges-sous-Salève;3973;116;4089
84;Auvergne-Rhône-Alpes;74;2;14;083;Combloux;2109;114;2223
84;Auvergne-Rhône-Alpes;74;2;10;085;Les Contamines-Montjoie;1107;46;1153
84;Auvergne-Rhône-Alpes;74;3;13;086;Contamine-Sarzin;743;13;756
84;Auvergne-Rhône-Alpes;74;2;05;087;Contamine-sur-Arve;2256;150;2406
84;Auvergne-Rhône-Alpes;74;3;11;088;Copponex;1243;23;1266
84;Auvergne-Rhône-Alpes;74;2;14;089;Cordon;984;26;1010
84;Auvergne-Rhône-Alpes;74;2;11;090;Cornier;1385;20;1405
84;Auvergne-Rhône-Alpes;74;2;07;091;La Côte-d'Arbroz;359;2;361
84;Auvergne-Rhône-Alpes;74;3;09;094;Cranves-Sales;7069;170;7239
84;Auvergne-Rhône-Alpes;74;1;12;095;Crempigny-Bonneguête;321;11;332
84;Auvergne-Rhône-Alpes;74;3;11;096;Cruseilles;4665;316;4981
84;Auvergne-Rhône-Alpes;74;1;12;097;Cusy;1843;50;1893
84;Auvergne-Rhône-Alpes;74;1;11;098;Cuvat;1584;57;1641
84;Auvergne-Rhône-Alpes;74;2;14;099;Demi-Quartier;814;36;850
84;Auvergne-Rhône-Alpes;74;3;13;100;Desingy;775;26;801
84;Auvergne-Rhône-Alpes;74;3;13;101;Dingy-en-Vuache;737;18;755
84;Auvergne-Rhône-Alpes;74;1;08;102;Dingy-Saint-Clair;1445;47;1492
84;Auvergne-Rhône-Alpes;74;2;14;103;Domancy;2236;76;2312
84;Auvergne-Rhône-Alpes;74;1;08;104;Doussard;3626;87;3713
84;Auvergne-Rhône-Alpes;74;4;15;105;Douvaine;6688;84;6772
84;Auvergne-Rhône-Alpes;74;4;17;106;Draillant;895;23;918
84;Auvergne-Rhône-Alpes;74;3;13;107;Droisy;153;5;158
84;Auvergne-Rhône-Alpes;74;1;16;108;Duingt;1020;26;1046
84;Auvergne-Rhône-Alpes;74;3;13;109;Éloise;931;20;951
84;Auvergne-Rhône-Alpes;74;1;16;111;Entrevernes;210;3;213
84;Auvergne-Rhône-Alpes;74;1;03;112;Epagny Metz-Tessy;8271;202;8473
84;Auvergne-Rhône-Alpes;74;4;07;114;Essert-Romand;516;6;522
84;Auvergne-Rhône-Alpes;74;2;11;116;Etaux;2032;73;2105
84;Auvergne-Rhône-Alpes;74;1;12;117;Étercy;884;18;902
84;Auvergne-Rhône-Alpes;74;3;09;118;Étrembières;2612;29;2641
84;Auvergne-Rhône-Alpes;74;4;07;119;Évian-les-Bains;9117;252;9369
84;Auvergne-Rhône-Alpes;74;4;15;121;Excenevex;1231;17;1248
84;Auvergne-Rhône-Alpes;74;2;05;122;Faucigny;646;21;667
84;Auvergne-Rhône-Alpes;74;1;08;123;Faverges-Seythenex;7591;223;7814
84;Auvergne-Rhône-Alpes;74;3;13;124;Feigères;1791;42;1833
84;Auvergne-Rhône-Alpes;74;4;15;126;Fessy;1026;32;1058
84;Auvergne-Rhône-Alpes;74;4;07;127;Féternes;1461;45;1506
84;Auvergne-Rhône-Alpes;74;3;05;128;Fillinges;3525;71;3596
84;Auvergne-Rhône-Alpes;74;4;07;129;La Forclaz;226;3;229
84;Auvergne-Rhône-Alpes;74;3;13;130;Franclens;540;31;571
84;Auvergne-Rhône-Alpes;74;3;13;131;Frangy;2047;39;2086
84;Auvergne-Rhône-Alpes;74;3;09;133;Gaillard;10350;118;10468
84;Auvergne-Rhône-Alpes;74;2;07;134;Les Gets;1224;26;1250
84;Auvergne-Rhône-Alpes;74;1;08;135;Giez;540;12;552
84;Auvergne-Rhône-Alpes;74;1;08;136;Le Grand-Bornand;2082;53;2135
84;Auvergne-Rhône-Alpes;74;1;03;137;Groisy;3936;156;4092
84;Auvergne-Rhône-Alpes;74;1;12;138;Gruffy;1508;63;1571
84;Auvergne-Rhône-Alpes;74;4;15;139;Habère-Lullin;1049;31;1080
84;Auvergne-Rhône-Alpes;74;4;15;140;Habère-Poche;1476;25;1501
84;Auvergne-Rhône-Alpes;74;1;12;141;Hauteville-sur-Fier;1045;27;1072
84;Auvergne-Rhône-Alpes;74;1;12;142;Héry-sur-Alby;979;32;1011
84;Auvergne-Rhône-Alpes;74;2;10;143;Les Houches;3177;74;3251
84;Auvergne-Rhône-Alpes;74;3;13;144;Jonzier-Épagny;833;20;853
84;Auvergne-Rhône-Alpes;74;3;09;145;Juvigny;629;12;641
84;Auvergne-Rhône-Alpes;74;4;07;146;Larringes;1584;48;1632
84;Auvergne-Rhône-Alpes;74;1;08;147;Lathuile;1018;29;1047
84;Auvergne-Rhône-Alpes;74;1;16;148;Leschaux;270;7;277
84;Auvergne-Rhône-Alpes;74;4;15;150;Loisin;1647;30;1677
84;Auvergne-Rhône-Alpes;74;1;12;151;Lornay;578;9;587
84;Auvergne-Rhône-Alpes;74;1;01;152;Lovagny;1271;42;1313
84;Auvergne-Rhône-Alpes;74;3;09;153;Lucinges;1594;65;1659
84;Auvergne-Rhône-Alpes;74;4;07;154;Lugrin;2511;52;2563
84;Auvergne-Rhône-Alpes;74;4;17;155;Lullin;804;27;831
84;Auvergne-Rhône-Alpes;74;4;15;156;Lully;700;14;714
84;Auvergne-Rhône-Alpes;74;4;17;157;Lyaud;1745;63;1808
84;Auvergne-Rhône-Alpes;74;3;09;158;Machilly;1104;17;1121
84;Auvergne-Rhône-Alpes;74;2;14;159;Magland;3266;64;3330
84;Auvergne-Rhône-Alpes;74;1;08;160;Manigod;999;27;1026
84;Auvergne-Rhône-Alpes;74;1;12;161;Marcellaz-Albanais;1977;58;2035
84;Auvergne-Rhône-Alpes;74;2;05;162;Marcellaz;1067;19;1086
84;Auvergne-Rhône-Alpes;74;4;15;163;Margencel;2235;80;2315
84;Auvergne-Rhône-Alpes;74;2;05;164;Marignier;6333;180;6513
84;Auvergne-Rhône-Alpes;74;1;12;165;Marigny-Saint-Marcel;696;15;711
84;Auvergne-Rhône-Alpes;74;4;07;166;Marin;1885;53;1938
84;Auvergne-Rhône-Alpes;74;1;08;167;Val de Chaise;1387;24;1411
84;Auvergne-Rhône-Alpes;74;3;13;168;Marlioz;1053;14;1067
84;Auvergne-Rhône-Alpes;74;2;06;169;Marnaz;5735;102;5837
84;Auvergne-Rhône-Alpes;74;1;12;170;Massingy;869;21;890
84;Auvergne-Rhône-Alpes;74;4;15;171;Massongy;1540;33;1573
84;Auvergne-Rhône-Alpes;74;4;07;172;Maxilly-sur-Léman;1451;34;1485
84;Auvergne-Rhône-Alpes;74;2;14;173;Megève;2999;124;3123
84;Auvergne-Rhône-Alpes;74;2;05;174;Mégevette;590;25;615
84;Auvergne-Rhône-Alpes;74;4;07;175;Meillerie;313;6;319
84;Auvergne-Rhône-Alpes;74;1;08;176;Menthon-Saint-Bernard;1884;70;1954
84;Auvergne-Rhône-Alpes;74;3;11;177;Menthonnex-en-Bornes;1097;20;1117
84;Auvergne-Rhône-Alpes;74;3;13;178;Menthonnex-sous-Clermont;733;14;747
84;Auvergne-Rhône-Alpes;74;1;01;179;Mésigny;794;26;820
84;Auvergne-Rhône-Alpes;74;4;15;180;Messery;2164;50;2214
84;Auvergne-Rhône-Alpes;74;2;06;183;Mieussy;2461;66;2527
84;Auvergne-Rhône-Alpes;74;3;13;184;Minzier;1043;12;1055
84;Auvergne-Rhône-Alpes;74;3;11;185;Monnetier-Mornex;2332;46;2378
84;Auvergne-Rhône-Alpes;74;1;16;186;Montagny-les-Lanches;772;23;795
84;Auvergne-Rhône-Alpes;74;4;07;188;Montriond;944;24;968
84;Auvergne-Rhône-Alpes;74;2;06;189;Mont-Saxonnex;1666;49;1715
84;Auvergne-Rhône-Alpes;74;2;06;190;Morillon;671;13;684
84;Auvergne-Rhône-Alpes;74;4;07;191;Morzine;2690;74;2764
84;Auvergne-Rhône-Alpes;74;1;12;192;Moye;970;36;1006
84;Auvergne-Rhône-Alpes;74;3;11;193;La Muraz;1059;23;1082
84;Auvergne-Rhône-Alpes;74;1;12;194;Mûres;892;24;916
84;Auvergne-Rhône-Alpes;74;3;13;195;Musièges;416;8;424
84;Auvergne-Rhône-Alpes;74;2;06;196;Nancy-sur-Cluses;473;15;488
84;Auvergne-Rhône-Alpes;74;3;11;197;Nangy;1629;34;1663
84;Auvergne-Rhône-Alpes;74;1;03;198;Nâves-Parmelan;1003;23;1026
84;Auvergne-Rhône-Alpes;74;4;15;199;Nernier;398;11;409
84;Auvergne-Rhône-Alpes;74;4;07;200;Neuvecelle;3181;97;3278
84;Auvergne-Rhône-Alpes;74;3;13;201;Neydens;2271;24;2295
84;Auvergne-Rhône-Alpes;74;1;01;202;Nonglard;724;10;734
84;Auvergne-Rhône-Alpes;74;4;07;203;Novel;50;2;52
84;Auvergne-Rhône-Alpes;74;2;05;205;Onnion;1280;29;1309
84;Auvergne-Rhône-Alpes;74;4;17;206;Orcier;1053;19;1072
84;Auvergne-Rhône-Alpes;74;2;10;208;Passy;11350;440;11790
84;Auvergne-Rhône-Alpes;74;2;05;209;Peillonnex;1371;40;1411
84;Auvergne-Rhône-Alpes;74;4;17;210;Perrignier;1875;39;1914
84;Auvergne-Rhône-Alpes;74;3;11;211;Pers-Jussy;3145;91;3236
84;Auvergne-Rhône-Alpes;74;2;05;212;Glières-Val-de-Borne;1828;31;1859
84;Auvergne-Rhône-Alpes;74;1;01;213;Poisy;8522;364;8886
84;Auvergne-Rhône-Alpes;74;2;14;215;Praz-sur-Arly;1245;34;1279
84;Auvergne-Rhône-Alpes;74;3;13;216;Présilly;1053;17;1070
84;Auvergne-Rhône-Alpes;74;4;07;218;Publier;7499;187;7686
84;Auvergne-Rhône-Alpes;74;1;16;219;Quintal;1254;51;1305
84;Auvergne-Rhône-Alpes;74;3;11;220;Reignier-Ésery;8150;199;8349
84;Auvergne-Rhône-Alpes;74;2;06;221;Le Reposoir;539;23;562
84;Auvergne-Rhône-Alpes;74;4;17;222;Reyvroz;502;9;511
84;Auvergne-Rhône-Alpes;74;2;06;223;La Rivière-Enverse;477;8;485
84;Auvergne-Rhône-Alpes;74;2;11;224;La Roche-sur-Foron;11155;382;11537
84;Auvergne-Rhône-Alpes;74;1;12;225;Rumilly;15944;418;16362
84;Auvergne-Rhône-Alpes;74;4;15;226;Saint-André-de-Boëge;592;12;604
84;Auvergne-Rhône-Alpes;74;3;11;228;Saint-Blaise;358;12;370
84;Auvergne-Rhône-Alpes;74;3;09;229;Saint-Cergues;3682;73;3755
84;Auvergne-Rhône-Alpes;74;1;12;231;Saint-Eusèbe;620;14;634
84;Auvergne-Rhône-Alpes;74;1;16;232;Saint-Eustache;491;21;512
84;Auvergne-Rhône-Alpes;74;1;12;233;Saint-Félix;2425;45;2470
84;Auvergne-Rhône-Alpes;74;1;08;234;Saint-Ferréol;897;23;920
84;Auvergne-Rhône-Alpes;74;3;13;235;Saint-Germain-sur-Rhône;617;12;629
84;Auvergne-Rhône-Alpes;74;2;10;236;Saint-Gervais-les-Bains;5606;124;5730
84;Auvergne-Rhône-Alpes;74;4;07;237;Saint-Gingolph;890;4;894
84;Auvergne-Rhône-Alpes;74;4;07;238;Saint-Jean-d'Aulps;1580;26;1606
84;Auvergne-Rhône-Alpes;74;1;08;239;Saint-Jean-de-Sixt;1465;37;1502
84;Auvergne-Rhône-Alpes;74;2;05;240;Saint-Jean-de-Tholome;1057;22;1079
84;Auvergne-Rhône-Alpes;74;2;05;241;Saint-Jeoire;3426;101;3527
84;Auvergne-Rhône-Alpes;74;1;16;242;Saint-Jorioz;6151;207;6358
84;Auvergne-Rhône-Alpes;74;3;13;243;Saint-Julien-en-Genevois;15739;229;15968
84;Auvergne-Rhône-Alpes;74;2;11;244;Saint-Laurent;840;34;874
84;Auvergne-Rhône-Alpes;74;4;07;249;Saint-Paul-en-Chablais;2522;61;2583
84;Auvergne-Rhône-Alpes;74;2;05;250;Saint-Pierre-en-Faucigny;7333;131;7464
84;Auvergne-Rhône-Alpes;74;2;06;252;Saint-Sigismond;608;20;628
84;Auvergne-Rhône-Alpes;74;2;11;253;Saint-Sixt;1017;38;1055
84;Auvergne-Rhône-Alpes;74;1;12;254;Saint-Sylvestre;603;16;619
84;Auvergne-Rhône-Alpes;74;1;12;255;Sales;2152;52;2204
84;Auvergne-Rhône-Alpes;74;2;14;256;Sallanches;16986;464;17450
84;Auvergne-Rhône-Alpes;74;1;01;257;Sallenôves;792;19;811
84;Auvergne-Rhône-Alpes;74;2;06;258;Samoëns;2380;58;2438
84;Auvergne-Rhône-Alpes;74;3;11;259;Le Sappey;446;8;454
84;Auvergne-Rhône-Alpes;74;3;13;260;Savigny;985;21;1006
84;Auvergne-Rhône-Alpes;74;4;15;261;Saxel;491;8;499
84;Auvergne-Rhône-Alpes;74;3;11;262;Scientrier;1159;21;1180
84;Auvergne-Rhône-Alpes;74;4;15;263;Sciez;6375;141;6516
84;Auvergne-Rhône-Alpes;74;2;06;264;Scionzier;9057;138;9195
84;Auvergne-Rhône-Alpes;74;1;08;265;Serraval;702;72;774
84;Auvergne-Rhône-Alpes;74;2;10;266;Servoz;1068;35;1103
84;Auvergne-Rhône-Alpes;74;1;02;267;Sevrier;4151;185;4336
84;Auvergne-Rhône-Alpes;74;3;13;269;Seyssel;2353;73;2426
84;Auvergne-Rhône-Alpes;74;4;07;271;Seytroux;529;13;542
84;Auvergne-Rhône-Alpes;74;1;01;272;Sillingy;5480;139;5619
84;Auvergne-Rhône-Alpes;74;2;06;273;Sixt-Fer-à-Cheval;752;17;769
84;Auvergne-Rhône-Alpes;74;1;08;275;Talloires-Montmin;1924;66;1990
84;Auvergne-Rhône-Alpes;74;2;06;276;Taninges;3429;93;3522
84;Auvergne-Rhône-Alpes;74;2;06;278;Thyez;6419;148;6567
84;Auvergne-Rhône-Alpes;74;4;07;279;Thollon-les-Mémises;825;24;849
84;Auvergne-Rhône-Alpes;74;1;08;280;Thônes;6599;277;6876
84;Auvergne-Rhône-Alpes;74;4;17;281;Thonon-les-Bains;36626;1106;37732
84;Auvergne-Rhône-Alpes;74;1;03;282;Fillière;9534;247;9781
84;Auvergne-Rhône-Alpes;74;1;12;283;Thusy;1143;19;1162
84;Auvergne-Rhône-Alpes;74;2;05;284;La Tour;1313;25;1338
84;Auvergne-Rhône-Alpes;74;3;13;285;Usinens;421;9;430
84;Auvergne-Rhône-Alpes;74;4;07;286;Vacheresse;860;17;877
84;Auvergne-Rhône-Alpes;74;4;17;287;Vailly;916;20;936
84;Auvergne-Rhône-Alpes;74;3;13;288;Valleiry;4907;61;4968
84;Auvergne-Rhône-Alpes;74;1;12;289;Vallières-sur-Fier;2633;61;2694
84;Auvergne-Rhône-Alpes;74;2;10;290;Vallorcine;407;12;419
84;Auvergne-Rhône-Alpes;74;3;13;291;Vanzy;340;5;345
84;Auvergne-Rhône-Alpes;74;1;12;292;Vaulx;1044;31;1075
84;Auvergne-Rhône-Alpes;74;4;15;293;Veigy-Foncenex;3967;45;4012
84;Auvergne-Rhône-Alpes;74;2;06;294;Verchaix;766;25;791
84;Auvergne-Rhône-Alpes;74;4;07;295;La Vernaz;323;8;331
84;Auvergne-Rhône-Alpes;74;3;13;296;Vers;933;17;950
84;Auvergne-Rhône-Alpes;74;1;12;297;Versonnex;643;27;670
84;Auvergne-Rhône-Alpes;74;3;09;298;Vétraz-Monthoux;9360;271;9631
84;Auvergne-Rhône-Alpes;74;1;08;299;Veyrier-du-Lac;2286;83;2369
84;Auvergne-Rhône-Alpes;74;4;15;301;Villard;941;21;962
84;Auvergne-Rhône-Alpes;74;1;08;302;Les Villards-sur-Thônes;1089;21;1110
84;Auvergne-Rhône-Alpes;74;1;03;303;Villaz;3348;129;3477
84;Auvergne-Rhône-Alpes;74;2;05;304;Ville-en-Sallaz;935;10;945
84;Auvergne-Rhône-Alpes;74;3;04;305;Ville-la-Grand;9031;118;9149
84;Auvergne-Rhône-Alpes;74;3;11;306;Villy-le-Bouveret;608;17;625
84;Auvergne-Rhône-Alpes;74;1;11;307;Villy-le-Pelloux;995;16;1011
84;Auvergne-Rhône-Alpes;74;4;07;308;Vinzier;858;22;880
84;Auvergne-Rhône-Alpes;74;3;13;309;Viry;5590;84;5674
84;Auvergne-Rhône-Alpes;74;1;12;310;Viuz-la-Chiésaz;1299;33;1332
84;Auvergne-Rhône-Alpes;74;2;05;311;Viuz-en-Sallaz;4532;104;4636
84;Auvergne-Rhône-Alpes;74;2;05;312;Vougy;1584;27;1611
84;Auvergne-Rhône-Alpes;74;3;11;313;Vovray-en-Bornes;554;8;562
84;Auvergne-Rhône-Alpes;74;3;13;314;Vulbens;1645;54;1699
84;Auvergne-Rhône-Alpes;74;4;15;315;Yvoire;1084;22;1106
11;Île-de-France;75;1;NA;101;Paris 1er Arrondissement;16030;119;16149
11;Île-de-France;75;1;NA;102;Paris 2e Arrondissement;21130;147;21277
11;Île-de-France;75;1;NA;103;Paris 3e Arrondissement;33402;249;33651
11;Île-de-France;75;1;NA;104;Paris 4e Arrondissement;29064;262;29326
11;Île-de-France;75;1;NA;105;Paris 5e Arrondissement;57380;670;58050
11;Île-de-France;75;1;NA;106;Paris 6e Arrondissement;39625;827;40452
11;Île-de-France;75;1;NA;107;Paris 7e Arrondissement;48520;780;49300
11;Île-de-France;75;1;NA;108;Paris 8e Arrondissement;35631;587;36218
11;Île-de-France;75;1;NA;109;Paris 9e Arrondissement;60168;616;60784
11;Île-de-France;75;1;NA;110;Paris 10e Arrondissement;83459;414;83873
11;Île-de-France;75;1;NA;111;Paris 11e Arrondissement;144292;832;145124
11;Île-de-France;75;1;NA;112;Paris 12e Arrondissement;140311;964;141275
11;Île-de-France;75;1;NA;113;Paris 13e Arrondissement;177833;1180;179013
11;Île-de-France;75;1;NA;114;Paris 14e Arrondissement;133967;959;134926
11;Île-de-France;75;1;NA;115;Paris 15e Arrondissement;229472;1714;231186
11;Île-de-France;75;1;NA;116;Paris 16e Arrondissement;162820;2298;165118
11;Île-de-France;75;1;NA;117;Paris 17e Arrondissement;166336;1429;167765
11;Île-de-France;75;1;NA;118;Paris 18e Arrondissement;191135;776;191911
11;Île-de-France;75;1;NA;119;Paris 19e Arrondissement;183211;945;184156
11;Île-de-France;75;1;NA;120;Paris 20e Arrondissement;192120;924;193044
28;Normandie;76;3;35;001;Allouville-Bellefosse;1155;19;1174
28;Normandie;76;2;33;002;Alvimare;618;9;627
28;Normandie;76;1;07;004;Ambrumesnil;473;14;487
28;Normandie;76;3;06;005;Amfreville-la-Mi-Voie;3299;30;3329
28;Normandie;76;3;35;006;Amfreville-les-Champs;179;4;183
28;Normandie;76;3;02;007;Anceaumeville;689;10;699
28;Normandie;76;1;08;008;Ancourt;630;11;641
28;Normandie;76;1;33;009;Ancourteville-sur-Héricourt;349;4;353
28;Normandie;76;3;35;010;Ancretiéville-Saint-Victor;371;6;377
28;Normandie;76;2;11;011;Ancretteville-sur-Mer;151;4;155
28;Normandie;76;2;32;012;Angerville-Bailleul;186;3;189
28;Normandie;76;2;11;013;Angerville-la-Martel;1084;31;1115
28;Normandie;76;2;26;014;Angerville-l'Orcher;1400;15;1415
28;Normandie;76;1;33;015;Angiens;514;9;523
28;Normandie;76;1;33;016;Anglesqueville-la-Bras-Long;125;2;127
28;Normandie;76;2;26;017;Anglesqueville-l'Esneval;662;6;668
28;Normandie;76;1;20;018;Val-de-Saâne;1484;32;1516
28;Normandie;76;1;20;019;Anneville-sur-Scie;425;10;435
28;Normandie;76;3;01;020;Anneville-Ambourville;1176;23;1199
28;Normandie;76;2;32;021;Annouville-Vilmesnil;461;3;464
28;Normandie;76;3;25;022;Anquetierville;334;13;347
28;Normandie;76;3;35;023;Anvéville;300;5;305
28;Normandie;76;1;23;024;Ardouval;156;4;160
28;Normandie;76;1;12;025;Argueil;343;5;348
28;Normandie;76;1;08;026;Arques-la-Bataille;2526;44;2570
28;Normandie;76;1;12;028;Aubéguimont;186;1;187
28;Normandie;76;1;10;029;Aubermesnil-aux-Érables;200;3;203
28;Normandie;76;1;07;030;Aubermesnil-Beaumais;516;3;519
28;Normandie;76;1;33;032;Auberville-la-Manuel;138;2;140
28;Normandie;76;2;32;033;Auberville-la-Renault;456;6;462
28;Normandie;76;1;20;034;Val-de-Scie;2525;25;2550
28;Normandie;76;1;12;035;Aumale;1963;51;2014
28;Normandie;76;1;20;036;Auppegard;692;19;711
28;Normandie;76;3;02;038;Authieux-Ratiéville;401;6;407
28;Normandie;76;3;06;039;Les Authieux-sur-le-Port-Saint-Ouen;1254;26;1280
28;Normandie;76;1;33;040;Autigny;312;0;312
28;Normandie;76;3;35;041;Les Hauts-de-Caux;1347;18;1365
28;Normandie;76;1;23;042;Auvilliers;103;3;106
28;Normandie;76;3;35;043;Auzebosc;1138;360;1498
28;Normandie;76;3;35;045;Auzouville-l'Esneval;358;9;367
28;Normandie;76;3;21;046;Auzouville-sur-Ry;690;12;702
28;Normandie;76;1;20;047;Auzouville-sur-Saâne;150;1;151
28;Normandie;76;1;12;048;Avesnes-en-Bray;291;6;297
28;Normandie;76;1;23;049;Avesnes-en-Val;275;8;283
28;Normandie;76;1;20;050;Avremesnil;1008;27;1035
28;Normandie;76;1;20;051;Bacqueville-en-Caux;1904;37;1941
28;Normandie;76;1;23;052;Bailleul-Neuville;223;1;224
28;Normandie;76;1;23;053;Baillolet;109;2;111
28;Normandie;76;1;08;054;Bailly-en-Rivière;522;4;526
28;Normandie;76;3;35;055;Baons-le-Comte;334;17;351
28;Normandie;76;3;01;056;Bardouville;622;10;632
28;Normandie;76;3;01;057;Barentin;12239;239;12478
28;Normandie;76;1;10;058;Baromesnil;216;5;221
28;Normandie;76;1;10;059;Bazinval;419;11;430
28;Normandie;76;1;12;060;Beaubec-la-Rosière;485;10;495
28;Normandie;76;3;23;062;Beaumont-le-Hareng;264;3;267
28;Normandie;76;1;20;063;Beauval-en-Caux;463;10;473
28;Normandie;76;2;26;064;Beaurepaire;498;13;511
28;Normandie;76;1;12;065;Beaussault;413;4;417
28;Normandie;76;1;20;066;Beautot;152;4;156
28;Normandie;76;1;12;067;Beauvoir-en-Lyons;596;14;610
28;Normandie;76;2;32;068;Bec-de-Mortagne;643;17;660
28;Normandie;76;3;06;069;Belbeuf;2242;53;2295
28;Normandie;76;1;23;070;Bellencombre;596;11;607
28;Normandie;76;1;08;071;Bellengreville;473;14;487
28;Normandie;76;1;20;072;Belleville-en-Caux;742;11;753
28;Normandie;76;1;12;074;La Bellière;53;0;53
28;Normandie;76;1;20;075;Belmesnil;450;3;453
28;Normandie;76;2;32;076;Bénarville;267;5;272
28;Normandie;76;3;35;077;Bénesville;170;5;175
28;Normandie;76;2;26;079;Bénouville;182;1;183
28;Normandie;76;2;03;082;Bernières;634;6;640
28;Normandie;76;1;33;083;Bertheauville;96;1;97
28;Normandie;76;1;33;084;Bertreville;119;2;121
28;Normandie;76;1;20;085;Bertreville-Saint-Ouen;335;9;344
28;Normandie;76;1;20;086;Bertrimont;216;2;218
28;Normandie;76;3;35;087;Berville-en-Caux;687;10;697
28;Normandie;76;3;01;088;Berville-sur-Seine;544;11;555
28;Normandie;76;2;03;090;Beuzeville-la-Grenier;1253;16;1269
28;Normandie;76;1;33;091;Beuzeville-la-Guérard;231;7;238
28;Normandie;76;2;03;092;Beuzevillette;626;10;636
28;Normandie;76;1;12;093;Bézancourt;360;13;373
28;Normandie;76;3;21;094;Bierville;331;2;333
28;Normandie;76;3;02;095;Bihorel;8197;166;8363
28;Normandie;76;1;20;096;Biville-la-Baignarde;660;10;670
28;Normandie;76;1;20;097;Biville-la-Rivière;105;0;105
28;Normandie;76;3;01;099;Blacqueville;730;9;739
28;Normandie;76;3;21;100;Blainville-Crevon;1227;18;1245
28;Normandie;76;1;10;101;Blangy-sur-Bresle;2882;30;2912
28;Normandie;76;3;06;103;Bonsecours;6466;95;6561
28;Normandie;76;1;33;104;Blosseville;252;13;265
28;Normandie;76;3;02;105;Le Bocasse;657;7;664
28;Normandie;76;3;21;106;Bois-d'Ennebourg;569;8;577
28;Normandie;76;3;21;107;Bois-Guilbert;297;4;301
28;Normandie;76;3;02;108;Bois-Guillaume;14378;375;14753
28;Normandie;76;3;21;109;Bois-Héroult;173;4;177
28;Normandie;76;3;35;110;Bois-Himont;469;5;474
28;Normandie;76;3;21;111;Bois-l'Évêque;610;10;620
28;Normandie;76;1;20;112;Le Bois-Robert;364;10;374
28;Normandie;76;3;21;113;Boissay;409;7;416
28;Normandie;76;2;03;114;Bolbec;11551;133;11684
28;Normandie;76;2;25;115;Bolleville;579;3;582
28;Normandie;76;3;21;116;Boos;3990;46;4036
28;Normandie;76;2;26;117;Bordeaux-Saint-Clair;644;20;664
28;Normandie;76;2;32;118;Bornambusc;248;8;256
28;Normandie;76;1;23;119;Bosc-Bérenger;201;2;203
28;Normandie;76;3;21;120;Bosc-Bordel;441;10;451
28;Normandie;76;3;21;121;Bosc-Édeline;366;3;369
28;Normandie;76;1;23;122;Callengeville;504;8;512
28;Normandie;76;3;02;123;Bosc-Guérard-Saint-Adrien;1062;29;1091
28;Normandie;76;1;12;124;Bosc-Hyons;433;8;441
28;Normandie;76;3;23;125;Bosc-le-Hard;1567;19;1586
28;Normandie;76;1;23;126;Bosc-Mesnil;318;6;324
28;Normandie;76;1;33;128;Bosville;580;15;595
28;Normandie;76;3;35;129;Boudeville;211;5;216
28;Normandie;76;1;23;130;Bouelles;281;4;285
28;Normandie;76;3;09;131;La Bouille;707;12;719
28;Normandie;76;3;35;132;Bourdainville;468;2;470
28;Normandie;76;1;33;133;Le Bourg-Dun;433;9;442
28;Normandie;76;1;33;134;Bourville;293;4;297
28;Normandie;76;3;01;135;Bouville;996;12;1008
28;Normandie;76;1;20;136;Brachy;700;13;713
28;Normandie;76;1;23;138;Bracquetuit;330;8;338
28;Normandie;76;1;23;139;Bradiancourt;221;3;224
28;Normandie;76;1;33;140;Brametot;195;2;197
28;Normandie;76;2;32;141;Bréauté;1367;13;1380
28;Normandie;76;1;12;142;Brémontier-Merval;447;125;572
28;Normandie;76;2;32;143;Bretteville-du-Grand-Caux;1366;23;1389
28;Normandie;76;3;35;144;Bretteville-Saint-Laurent;157;2;159
28;Normandie;76;3;21;146;Buchy;2820;113;2933
28;Normandie;76;1;23;147;Bully;898;22;920
28;Normandie;76;1;23;148;Bures-en-Bray;328;4;332
28;Normandie;76;3;35;149;Butot;285;5;290
28;Normandie;76;1;33;151;Cailleville;257;7;264
28;Normandie;76;3;21;152;Cailly;749;4;753
28;Normandie;76;1;20;153;Calleville-les-Deux-Églises;333;3;336
28;Normandie;76;1;10;154;Campneuseville;465;7;472
28;Normandie;76;1;10;155;Canehan;383;4;387
28;Normandie;76;1;33;156;Canouville;344;9;353
28;Normandie;76;3;04;157;Canteleu;13807;350;14157
28;Normandie;76;3;35;158;Canville-les-Deux-Églises;319;1;320
28;Normandie;76;1;33;159;Cany-Barville;2997;46;3043
28;Normandie;76;3;24;160;Carville-la-Folletière;424;9;433
28;Normandie;76;3;35;161;Carville-Pot-de-Fer;98;3;101
28;Normandie;76;1;20;162;Le Catelier;275;5;280
28;Normandie;76;3;21;163;Catenay;681;14;695
28;Normandie;76;3;25;164;Rives-en-Seine;4092;66;4158
28;Normandie;76;3;05;165;Caudebec-lès-Elbeuf;9996;65;10061
28;Normandie;76;1;12;166;Le Caule-Sainte-Beuve;481;4;485
28;Normandie;76;2;26;167;Cauville-sur-Mer;1599;28;1627
28;Normandie;76;1;20;168;Les Cent-Acres;65;1;66
28;Normandie;76;2;32;169;La Cerlangue;1287;115;1402
28;Normandie;76;1;20;170;La Chapelle-du-Bourgay;112;1;113
28;Normandie;76;1;12;171;La Chapelle-Saint-Ouen;137;1;138
28;Normandie;76;1;33;172;La Chapelle-sur-Dun;159;3;162
28;Normandie;76;1;20;173;La Chaussée;538;6;544
28;Normandie;76;3;35;174;Cideville;409;5;414
28;Normandie;76;1;23;175;Clais;261;7;268
28;Normandie;76;1;33;176;Clasville;348;7;355
28;Normandie;76;3;02;177;Claville-Motteville;276;6;282
28;Normandie;76;3;05;178;Cléon;4919;26;4945
28;Normandie;76;3;02;179;Clères;1376;17;1393
28;Normandie;76;1;33;180;Cleuville;190;8;198
28;Normandie;76;2;33;181;Cléville;149;3;152
28;Normandie;76;2;33;182;Cliponville;254;2;256
28;Normandie;76;2;11;183;Colleville;765;19;784
28;Normandie;76;1;07;184;Colmesnil-Manneville;110;3;113
28;Normandie;76;1;12;185;Compainville;165;4;169
28;Normandie;76;1;12;186;Conteville;497;3;500
28;Normandie;76;2;11;187;Contremoulins;166;3;169
28;Normandie;76;3;23;188;Cottévrard;474;4;478
28;Normandie;76;1;33;189;Crasville-la-Mallet;165;3;168
28;Normandie;76;1;33;190;Crasville-la-Rocquefort;209;3;212
28;Normandie;76;1;10;192;Criel-sur-Mer;2617;52;2669
28;Normandie;76;1;23;193;La Crique;336;5;341
28;Normandie;76;2;11;194;Criquebeuf-en-Caux;402;3;405
28;Normandie;76;2;11;195;Criquetot-le-Mauconduit;183;4;187
28;Normandie;76;2;26;196;Criquetot-l'Esneval;2563;82;2645
28;Normandie;76;1;20;197;Criquetot-sur-Longueville;218;2;220
28;Normandie;76;3;35;198;Criquetot-sur-Ouville;794;19;813
28;Normandie;76;1;12;199;Criquiers;711;10;721
28;Normandie;76;1;23;200;Critot;481;11;492
28;Normandie;76;1;12;201;Croisy-sur-Andelle;527;4;531
28;Normandie;76;1;23;202;Croixdalle;319;3;322
28;Normandie;76;3;24;203;Croix-Mare;733;7;740
28;Normandie;76;1;23;204;Cropus;258;1;259
28;Normandie;76;1;20;205;Crosville-sur-Scie;248;2;250
28;Normandie;76;2;26;206;Cuverville;344;8;352
28;Normandie;76;1;10;207;Cuverville-sur-Yères;196;6;202
28;Normandie;76;1;12;208;Cuy-Saint-Fiacre;654;9;663
28;Normandie;76;1;12;209;Dampierre-en-Bray;444;8;452
28;Normandie;76;1;08;210;Dampierre-Saint-Nicolas;453;1;454
28;Normandie;76;1;10;211;Dancourt;232;2;234
28;Normandie;76;3;06;212;Darnétal;9780;84;9864
28;Normandie;76;2;32;213;Daubeuf-Serville;399;9;408
28;Normandie;76;1;20;214;Dénestanville;271;2;273
28;Normandie;76;3;22;216;Déville-lès-Rouen;10644;79;10723
28;Normandie;76;1;95;217;Dieppe;28091;444;28535
28;Normandie;76;1;12;218;Doudeauville;104;2;106
28;Normandie;76;3;35;219;Doudeville;2472;44;2516
28;Normandie;76;1;08;220;Douvrend;522;12;534
28;Normandie;76;1;33;221;Drosay;192;5;197
28;Normandie;76;3;01;222;Duclair;4010;51;4061
28;Normandie;76;3;24;223;Écalles-Alix;509;6;515
28;Normandie;76;2;32;224;Écrainville;972;19;991
28;Normandie;76;3;35;225;Écretteville-lès-Baons;369;6;375
28;Normandie;76;2;11;226;Écretteville-sur-Mer;162;2;164
28;Normandie;76;3;35;227;Ectot-l'Auber;701;10;711
28;Normandie;76;3;35;228;Ectot-lès-Baons;397;7;404
28;Normandie;76;1;12;229;Elbeuf-en-Bray;401;14;415
28;Normandie;76;3;21;230;Elbeuf-sur-Andelle;475;6;481
28;Normandie;76;3;09;231;Elbeuf;16087;138;16225
28;Normandie;76;2;11;232;Életot;639;8;647
28;Normandie;76;1;12;233;Ellecourt;153;4;157
28;Normandie;76;3;24;234;Émanville;753;12;765
28;Normandie;76;1;08;235;Envermeu;1993;133;2126
28;Normandie;76;2;33;236;Envronville;351;1;352
28;Normandie;76;3;01;237;Épinay-sur-Duclair;510;7;517
28;Normandie;76;2;26;238;Épouville;2638;39;2677
28;Normandie;76;2;32;239;Épretot;784;14;798
28;Normandie;76;2;11;240;Épreville;1036;13;1049
28;Normandie;76;1;33;241;Ermenouville;139;6;145
28;Normandie;76;1;12;242;Ernemont-la-Villette;204;4;208
28;Normandie;76;3;21;243;Ernemont-sur-Buchy;293;2;295
28;Normandie;76;1;23;244;Esclavelles;385;6;391
28;Normandie;76;3;24;245;Eslettes;1638;16;1654
28;Normandie;76;3;02;247;Esteville;496;4;500
28;Normandie;76;1;20;249;Étaimpuis;838;7;845
28;Normandie;76;2;32;250;Étainhus;1203;27;1230
28;Normandie;76;3;35;251;Étalleville;434;3;437
28;Normandie;76;1;10;252;Étalondes;1047;30;1077
28;Normandie;76;3;35;253;Étoutteville;834;14;848
28;Normandie;76;2;26;254;Étretat;1238;6;1244
28;Normandie;76;1;10;255;Eu;6653;200;6853
28;Normandie;76;1;10;257;Fallencourt;183;2;185
28;Normandie;76;2;33;258;Terres-de-Caux;4205;112;4317
28;Normandie;76;2;11;259;Fécamp;18054;280;18334
28;Normandie;76;1;12;260;Ferrières-en-Bray;1669;18;1687
28;Normandie;76;1;12;261;La Ferté-Saint-Samson;450;11;461
28;Normandie;76;1;23;262;Fesques;142;2;144
28;Normandie;76;1;12;263;La Feuillie;1280;23;1303
28;Normandie;76;3;35;264;Flamanville;476;9;485
28;Normandie;76;1;23;265;Flamets-Frétils;162;4;166
28;Normandie;76;1;10;266;Flocques;701;15;716
28;Normandie;76;2;26;268;Fongueusemare;182;5;187
28;Normandie;76;1;23;269;Fontaine-en-Bray;172;3;175
28;Normandie;76;2;26;270;Fontaine-la-Mallet;2637;54;2691
28;Normandie;76;3;02;271;Fontaine-le-Bourg;1817;18;1835
28;Normandie;76;1;33;272;Fontaine-le-Dun;893;10;903
28;Normandie;76;3;06;273;Fontaine-sous-Préaux;558;14;572
28;Normandie;76;1;20;274;La Fontelaye;27;0;27
28;Normandie;76;2;26;275;Fontenay;1664;26;1690
28;Normandie;76;1;12;276;Forges-les-Eaux;3750;172;3922
28;Normandie;76;1;10;278;Foucarmont;781;13;794
28;Normandie;76;2;33;279;Foucart;359;10;369
28;Normandie;76;1;23;280;Fréauville;136;1;137
28;Normandie;76;2;25;281;La Frénaye;2091;44;2135
28;Normandie;76;3;05;282;Freneuse;960;9;969
28;Normandie;76;1;23;283;Fresles;237;5;242
28;Normandie;76;1;20;284;Fresnay-le-Long;329;5;334
28;Normandie;76;3;21;285;Fresne-le-Plan;567;8;575
28;Normandie;76;1;23;286;Fresnoy-Folny;678;8;686
28;Normandie;76;3;24;287;Fresquiennes;1046;15;1061
28;Normandie;76;1;08;288;Freulleville;362;3;365
28;Normandie;76;3;24;289;Saint Martin de l'If;1728;24;1752
28;Normandie;76;3;02;290;Frichemesnil;393;10;403
28;Normandie;76;2;11;291;Froberville;1168;25;1193
28;Normandie;76;1;12;292;Fry;142;3;145
28;Normandie;76;3;35;293;Fultot;240;0;240
28;Normandie;76;1;33;294;La Gaillarde;385;8;393
28;Normandie;76;1;12;295;Gaillefontaine;1205;15;1220
28;Normandie;76;2;16;296;Gainneville;2495;30;2525
28;Normandie;76;1;12;297;Gancourt-Saint-Étienne;226;6;232
28;Normandie;76;2;11;298;Ganzeville;468;6;474
28;Normandie;76;2;11;299;Gerponville;388;4;392
28;Normandie;76;2;11;300;Gerville;439;4;443
28;Normandie;76;2;32;302;Goderville;2853;40;2893
28;Normandie;76;2;32;303;Gommerville;726;8;734
28;Normandie;76;2;32;304;Gonfreville-Caillot;385;1;386
28;Normandie;76;2;16;305;Gonfreville-l'Orcher;9042;59;9101
28;Normandie;76;1;20;306;Gonnetot;176;2;178
28;Normandie;76;2;26;307;Gonneville-la-Mallet;1376;19;1395
28;Normandie;76;1;20;308;Gonneville-sur-Scie;522;8;530
28;Normandie;76;3;35;309;Gonzeville;126;2;128
28;Normandie;76;3;24;311;Goupillières;417;5;422
28;Normandie;76;1;12;312;Gournay-en-Bray;6027;93;6120
28;Normandie;76;3;06;313;Gouy;898;14;912
28;Normandie;76;2;32;314;Graimbouville;616;9;625
28;Normandie;76;1;33;315;Grainville-la-Teinturière;1076;18;1094
28;Normandie;76;3;21;316;Grainville-sur-Ry;441;9;450
28;Normandie;76;2;32;317;Grainville-Ymauville;430;12;442
28;Normandie;76;2;25;318;Grand-Camp;755;28;783
28;Normandie;76;3;09;319;Grand-Couronne;9731;181;9912
28;Normandie;76;1;23;320;Grandcourt;317;6;323
28;Normandie;76;1;23;321;Les Grandes-Ventes;1764;26;1790
28;Normandie;76;3;13;322;Le Grand-Quevilly;26034;235;26269
28;Normandie;76;1;23;323;Graval;155;4;159
28;Normandie;76;1;08;324;Grèges;852;15;867
28;Normandie;76;3;35;325;Grémonville;450;5;455
28;Normandie;76;1;20;327;Greuville;372;5;377
28;Normandie;76;3;23;328;Grigneuseville;376;5;381
28;Normandie;76;2;03;329;Gruchet-le-Valasse;3123;39;3162
28;Normandie;76;1;20;330;Gruchet-Saint-Siméon;686;20;706
28;Normandie;76;3;02;331;Grugny;1006;5;1011
28;Normandie;76;1;12;332;Grumesnil;437;7;444
28;Normandie;76;1;10;333;Guerville;471;4;475
28;Normandie;76;1;20;334;Gueures;527;17;544
28;Normandie;76;1;20;335;Gueutteville;89;0;89
28;Normandie;76;1;33;336;Gueutteville-les-Grès;372;5;377
28;Normandie;76;1;12;338;La Hallotière;218;4;222
28;Normandie;76;1;33;339;Le Hanouard;261;4;265
28;Normandie;76;3;35;340;Harcanville;530;7;537
28;Normandie;76;2;15;341;Harfleur;8333;54;8387
28;Normandie;76;2;33;342;Hattenville;712;17;729
28;Normandie;76;1;12;343;Haucourt;187;4;191
28;Normandie;76;1;12;344;Haudricourt;423;8;431
28;Normandie;76;1;12;345;Haussez;281;2;283
28;Normandie;76;1;33;346;Hautot-l'Auvray;315;8;323
28;Normandie;76;3;35;347;Hautot-le-Vatois;351;6;357
28;Normandie;76;3;35;348;Hautot-Saint-Sulpice;688;8;696
28;Normandie;76;1;07;349;Hautot-sur-Mer;1896;70;1966
28;Normandie;76;3;04;350;Hautot-sur-Seine;396;7;403
28;Normandie;76;2;96;351;Le Havre;165830;1828;167658
28;Normandie;76;1;12;352;La Haye;368;3;371
28;Normandie;76;1;33;353;Héberville;103;6;109
28;Normandie;76;3;01;354;Hénouville;1366;14;1380
28;Normandie;76;3;35;355;Héricourt-en-Caux;950;13;963
28;Normandie;76;1;20;356;Hermanville;115;2;117
28;Normandie;76;2;26;357;Hermeville;354;16;370
28;Normandie;76;1;12;358;Le Héron;250;1;251
28;Normandie;76;3;21;359;Héronchelles;147;2;149
28;Normandie;76;1;20;360;Heugleville-sur-Scie;640;9;649
28;Normandie;76;2;26;361;Heuqueville;713;9;722
28;Normandie;76;3;25;362;Heurteauville;293;7;300
28;Normandie;76;1;10;363;Hodeng-au-Bosc;579;9;588
28;Normandie;76;1;12;364;Hodeng-Hodenger;268;5;273
28;Normandie;76;1;33;365;Houdetot;189;0;189
28;Normandie;76;3;24;366;Le Houlme;4149;33;4182
28;Normandie;76;3;24;367;Houppeville;2918;48;2966
28;Normandie;76;2;32;368;Houquetot;335;6;341
28;Normandie;76;3;02;369;La Houssaye-Béranger;534;7;541
28;Normandie;76;3;35;370;Hugleville-en-Caux;429;3;432
28;Normandie;76;1;08;371;Les Ifs;71;0;71
28;Normandie;76;1;12;372;Illois;411;3;414
28;Normandie;76;1;20;373;Imbleville;304;6;310
28;Normandie;76;1;10;374;Incheville;1202;17;1219
28;Normandie;76;1;33;375;Ingouville;275;12;287
28;Normandie;76;3;02;377;Isneauville;3601;63;3664
28;Normandie;76;3;01;378;Jumièges;1693;34;1727
28;Normandie;76;1;20;379;Lamberville;195;2;197
28;Normandie;76;1;20;380;Lammerville;312;8;320
28;Normandie;76;1;12;381;Landes-Vieilles-et-Neuves;129;1;130
28;Normandie;76;2;03;382;Lanquetot;1156;19;1175
28;Normandie;76;1;20;383;Lestanville;95;1;96
28;Normandie;76;2;03;384;Lillebonne;8761;143;8904
28;Normandie;76;3;24;385;Limésy;1483;54;1537
28;Normandie;76;2;11;386;Limpiville;391;6;397
28;Normandie;76;3;35;387;Lindebeuf;388;7;395
28;Normandie;76;2;25;388;Lintot;473;4;477
28;Normandie;76;1;20;389;Lintot-les-Bois;188;7;195
28;Normandie;76;2;11;390;Les Loges;1095;21;1116
28;Normandie;76;3;09;391;La Londe;2351;68;2419
28;Normandie;76;1;23;392;Londinières;1253;20;1273
28;Normandie;76;1;12;393;Longmesnil;48;0;48
28;Normandie;76;1;10;394;Longroy;634;6;640
28;Normandie;76;1;07;395;Longueil;543;9;552
28;Normandie;76;3;21;396;Longuerue;338;2;340
28;Normandie;76;1;20;397;Longueville-sur-Scie;964;16;980
28;Normandie;76;3;25;398;Louvetot;760;6;766
28;Normandie;76;1;23;399;Lucy;191;3;194
28;Normandie;76;1;20;400;Luneray;2164;37;2201
28;Normandie;76;3;25;401;Arelaune-en-Seine;2524;44;2568
28;Normandie;76;3;24;402;Malaunay;6160;47;6207
28;Normandie;76;1;33;403;Malleville-les-Grès;205;3;208
28;Normandie;76;2;26;404;Manéglise;1265;23;1288
28;Normandie;76;1;20;405;Manéhouville;224;1;225
28;Normandie;76;2;11;406;Maniquerville;424;6;430
28;Normandie;76;1;33;407;Manneville-ès-Plains;307;8;315
28;Normandie;76;2;32;408;Manneville-la-Goupil;1051;13;1064
28;Normandie;76;2;26;409;Mannevillette;909;13;922
28;Normandie;76;3;04;410;Maromme;10845;126;10971
28;Normandie;76;1;12;411;Marques;233;1;234
28;Normandie;76;3;21;412;Martainville-Épreville;716;10;726
28;Normandie;76;1;07;413;Martigny;419;6;425
28;Normandie;76;1;08;414;Martin-Église;1605;50;1655
28;Normandie;76;1;23;415;Massy;327;5;332
28;Normandie;76;1;23;416;Mathonville;333;5;338
28;Normandie;76;1;23;417;Maucomble;407;10;417
28;Normandie;76;3;25;418;Maulévrier-Sainte-Gertrude;1017;17;1034
28;Normandie;76;3;01;419;Mauny;159;6;165
28;Normandie;76;1;12;420;Mauquenchy;359;5;364
28;Normandie;76;2;03;421;Mélamare;921;14;935
28;Normandie;76;1;10;422;Melleville;264;6;270
28;Normandie;76;1;12;423;Ménerval;168;2;170
28;Normandie;76;1;23;424;Ménonval;231;2;233
28;Normandie;76;2;32;425;Mentheville;296;5;301
28;Normandie;76;1;12;426;Mésangueville;159;0;159
28;Normandie;76;1;23;427;Mesnières-en-Bray;928;249;1177
28;Normandie;76;1;33;428;Le Mesnil-Durdent;17;3;20
28;Normandie;76;3;21;429;Le Mesnil-Esnard;7925;348;8273
28;Normandie;76;1;23;430;Mesnil-Follemprise;118;3;121
28;Normandie;76;1;12;431;Le Mesnil-Lieubray;96;3;99
28;Normandie;76;1;12;432;Mesnil-Mauger;244;4;248
28;Normandie;76;3;24;433;Mesnil-Panneville;742;7;749
28;Normandie;76;3;21;434;Mesnil-Raoul;1126;7;1133
28;Normandie;76;1;10;435;Le Mesnil-Réaume;795;16;811
28;Normandie;76;3;01;436;Le Mesnil-sous-Jumièges;617;4;621
28;Normandie;76;1;08;437;Meulers;562;14;576
28;Normandie;76;1;10;438;Millebosc;237;5;242
28;Normandie;76;2;03;439;Mirville;351;9;360
28;Normandie;76;1;12;440;Molagnies;207;4;211
28;Normandie;76;1;10;441;Monchaux-Soreng;622;12;634
28;Normandie;76;1;10;442;Monchy-sur-Eu;578;13;591
28;Normandie;76;3;02;443;Mont-Cauvaire;851;16;867
28;Normandie;76;1;23;445;Montérolier;606;7;613
28;Normandie;76;3;24;446;Montigny;1288;18;1306
28;Normandie;76;2;15;447;Montivilliers;15500;219;15719
28;Normandie;76;3;21;448;Montmain;1397;36;1433
28;Normandie;76;1;20;449;Montreuil-en-Caux;497;6;503
28;Normandie;76;1;12;450;Montroty;271;21;292
28;Normandie;76;3;22;451;Mont-Saint-Aignan;19686;415;20101
28;Normandie;76;3;02;452;Montville;4593;49;4642
28;Normandie;76;3;21;453;Morgny-la-Pommeraye;1074;20;1094
28;Normandie;76;1;23;454;Mortemer;86;0;86
28;Normandie;76;1;12;455;Morville-sur-Andelle;302;5;307
28;Normandie;76;3;35;456;Motteville;767;12;779
28;Normandie;76;3;09;457;Moulineaux;922;15;937
28;Normandie;76;1;20;458;Muchedent;128;3;131
28;Normandie;76;1;23;459;Nesle-Hodeng;348;5;353
28;Normandie;76;1;10;460;Nesle-Normandeuse;503;8;511
28;Normandie;76;1;23;461;Neufbosc;403;5;408
28;Normandie;76;1;23;462;Neufchâtel-en-Bray;4646;209;4855
28;Normandie;76;1;12;463;Neuf-Marché;664;21;685
28;Normandie;76;3;21;464;La Neuville-Chant-d'Oisel;2378;38;2416
28;Normandie;76;1;23;465;Neuville-Ferrières;559;9;568
28;Normandie;76;1;33;467;Néville;1329;19;1348
28;Normandie;76;2;03;468;Nointot;1365;33;1398
28;Normandie;76;1;12;469;Nolléval;424;5;429
28;Normandie;76;1;33;470;Normanville;658;25;683
28;Normandie;76;2;25;471;Norville;995;27;1022
28;Normandie;76;1;08;472;Notre-Dame-d'Aliermont;754;5;759
28;Normandie;76;3;25;473;Notre-Dame-de-Bliquetuit;808;11;819
28;Normandie;76;3;24;474;Notre-Dame-de-Bondeville;6966;87;7053
28;Normandie;76;3;21;475;Franqueville-Saint-Pierre;6099;192;6291
28;Normandie;76;2;25;476;Port-Jérôme-sur-Seine;10264;189;10453
28;Normandie;76;2;26;477;Notre-Dame-du-Bec;449;7;456
28;Normandie;76;1;20;478;Notre-Dame-du-Parc;190;1;191
28;Normandie;76;1;12;479;Nullemont;138;2;140
28;Normandie;76;1;33;480;Ocqueville;453;11;464
28;Normandie;76;2;26;481;Octeville-sur-Mer;6070;119;6189
28;Normandie;76;1;07;482;Offranville;3162;211;3373
28;Normandie;76;1;33;483;Oherville;227;2;229
28;Normandie;76;3;31;484;Oissel;12266;75;12341
28;Normandie;76;1;20;485;Omonville;275;43;318
28;Normandie;76;3;09;486;Orival;881;5;886
28;Normandie;76;1;23;487;Osmoy-Saint-Valery;315;6;321
28;Normandie;76;1;33;488;Ouainville;517;12;529
28;Normandie;76;2;32;489;Oudalle;441;11;452
28;Normandie;76;1;33;490;Ourville-en-Caux;1118;15;1133
28;Normandie;76;3;35;491;Ouville-l'Abbaye;659;11;670
28;Normandie;76;1;07;492;Ouville-la-Rivière;459;16;475
28;Normandie;76;1;33;493;Paluel;401;12;413
28;Normandie;76;2;03;494;Parc-d'Anxtot;587;9;596
28;Normandie;76;3;24;495;Pavilly;6164;52;6216
28;Normandie;76;3;13;497;Petit-Couronne;8732;178;8910
28;Normandie;76;3;27;498;Le Petit-Quevilly;21997;286;22283
28;Normandie;76;2;25;499;Petiville;1124;28;1152
28;Normandie;76;1;10;500;Pierrecourt;479;4;483
28;Normandie;76;2;26;501;Pierrefiques;134;7;141
28;Normandie;76;3;21;502;Pierreval;541;10;551
28;Normandie;76;3;24;503;Pissy-Pôville;1275;20;1295
28;Normandie;76;1;33;504;Pleine-Sève;127;2;129
28;Normandie;76;1;12;505;Pommereux;98;2;100
28;Normandie;76;1;23;506;Pommeréval;496;4;500
28;Normandie;76;1;10;507;Ponts-et-Marais;819;15;834
28;Normandie;76;2;26;508;La Poterie-Cap-d'Antifer;453;15;468
28;Normandie;76;3;21;509;Préaux;1846;32;1878
28;Normandie;76;3;35;510;Prétot-Vicquemare;234;2;236
28;Normandie;76;1;23;511;Preuseville;158;1;159
28;Normandie;76;1;23;512;Puisenval;23;0;23
28;Normandie;76;3;01;513;Quevillon;593;15;608
28;Normandie;76;3;06;514;Quévreville-la-Poterie;1029;13;1042
28;Normandie;76;1;07;515;Quiberville;534;14;548
28;Normandie;76;1;23;516;Quièvrecourt;411;18;429
28;Normandie;76;3;02;517;Quincampoix;3102;72;3174
28;Normandie;76;2;03;518;Raffetot;499;9;508
28;Normandie;76;1;20;519;Rainfreville;75;4;79
28;Normandie;76;1;10;520;Réalcamp;595;14;609
28;Normandie;76;3;21;521;Rebets;147;1;148
28;Normandie;76;2;32;522;La Remuée;1274;24;1298
28;Normandie;76;1;10;523;Rétonval;179;2;181
28;Normandie;76;3;35;524;Reuville;140;2;142
28;Normandie;76;1;08;526;Ricarville-du-Val;185;7;192
28;Normandie;76;1;12;527;Richemont;438;3;441
28;Normandie;76;1;10;528;Rieux;605;12;617
28;Normandie;76;2;11;529;Riville;301;6;307
28;Normandie;76;3;35;530;Robertot;223;5;228
28;Normandie;76;3;33;531;Rocquefort;323;8;331
28;Normandie;76;1;23;532;Rocquemont;784;18;802
28;Normandie;76;2;16;533;Rogerville;1668;18;1686
28;Normandie;76;2;26;534;Rolleville;1196;12;1208
28;Normandie;76;1;12;535;Roncherolles-en-Bray;462;8;470
28;Normandie;76;3;06;536;Roncherolles-sur-le-Vivier;1212;22;1234
28;Normandie;76;1;12;537;Ronchois;183;6;189
28;Normandie;76;1;23;538;Rosay;268;5;273
28;Normandie;76;3;97;540;Rouen;114187;1605;115792
28;Normandie;76;3;24;541;Roumare;1536;27;1563
28;Normandie;76;3;35;542;Routes;280;4;284
28;Normandie;76;2;03;543;Rouville;607;11;618
28;Normandie;76;1;12;544;Rouvray-Catillon;224;7;231
28;Normandie;76;1;07;545;Rouxmesnil-Bouteilles;1811;41;1852
28;Normandie;76;1;20;546;Royville;308;7;315
28;Normandie;76;3;21;547;La Rue-Saint-Pierre;773;9;782
28;Normandie;76;3;21;548;Ry;760;16;776
28;Normandie;76;1;20;549;Saâne-Saint-Just;139;6;145
28;Normandie;76;3;04;550;Sahurs;1212;16;1228
28;Normandie;76;2;32;551;Sainneville;852;11;863
28;Normandie;76;2;19;552;Sainte-Adresse;7216;190;7406
28;Normandie;76;1;23;553;Sainte-Agathe-d'Aliermont;298;4;302
28;Normandie;76;3;21;554;Saint-Aignan-sur-Ry;350;3;353
28;Normandie;76;3;21;555;Saint-André-sur-Cailly;821;21;842
28;Normandie;76;2;03;556;Saint-Antoine-la-Forêt;1093;22;1115
28;Normandie;76;3;25;557;Saint-Arnoult;1455;22;1477
28;Normandie;76;3;06;558;Saint-Aubin-Celloville;1180;6;1186
28;Normandie;76;3;25;559;Saint-Aubin-de-Crétot;505;8;513
28;Normandie;76;3;06;560;Saint-Aubin-Épinay;1020;17;1037
28;Normandie;76;3;05;561;Saint-Aubin-lès-Elbeuf;8428;73;8501
28;Normandie;76;1;08;562;Saint-Aubin-le-Cauf;838;22;860
28;Normandie;76;2;32;563;Saint-Aubin-Routot;1935;21;1956
28;Normandie;76;1;33;564;Saint-Aubin-sur-Mer;163;3;166
28;Normandie;76;1;07;565;Saint-Aubin-sur-Scie;1200;101;1301
28;Normandie;76;3;24;566;Sainte-Austreberthe;654;6;660
28;Normandie;76;1;23;567;Sainte-Beuve-en-Rivière;175;5;180
28;Normandie;76;3;35;568;Saint-Clair-sur-les-Monts;611;12;623
28;Normandie;76;1;33;569;Sainte-Colombe;222;1;223
28;Normandie;76;1;20;570;Saint-Crespin;313;4;317
28;Normandie;76;3;21;571;Sainte-Croix-sur-Buchy;688;3;691
28;Normandie;76;1;07;572;Saint-Denis-d'Aclon;123;5;128
28;Normandie;76;3;21;573;Saint-Denis-le-Thiboult;498;14;512
28;Normandie;76;1;20;574;Saint-Denis-sur-Scie;701;4;705
28;Normandie;76;3;98;575;Saint-Étienne-du-Rouvray;28331;231;28562
28;Normandie;76;2;03;576;Saint-Eustache-la-Forêt;1218;16;1234
28;Normandie;76;1;20;577;Sainte-Foy;625;13;638
28;Normandie;76;1;23;578;Sainte-Geneviève;269;5;274
28;Normandie;76;3;02;580;Saint-Georges-sur-Fontaine;912;17;929
28;Normandie;76;3;21;581;Saint-Germain-des-Essourts;383;9;392
28;Normandie;76;1;20;582;Saint-Germain-d'Étables;239;5;244
28;Normandie;76;3;21;583;Saint-Germain-sous-Cailly;331;5;336
28;Normandie;76;1;23;584;Saint-Germain-sur-Eaulne;219;5;224
28;Normandie;76;3;25;585;Saint-Gilles-de-Crétot;400;15;415
28;Normandie;76;2;32;586;Saint-Gilles-de-la-Neuville;644;5;649
28;Normandie;76;2;11;587;Sainte-Hélène-Bondeville;732;9;741
28;Normandie;76;1;23;588;Saint-Hellier;504;12;516
28;Normandie;76;1;20;589;Saint-Honoré;194;5;199
28;Normandie;76;1;08;590;Saint-Jacques-d'Aliermont;341;2;343
28;Normandie;76;3;06;591;Saint-Jacques-sur-Darnétal;3108;48;3156
28;Normandie;76;2;03;592;Saint-Jean-de-Folleville;811;26;837
28;Normandie;76;2;03;593;Saint-Jean-de-la-Neuville;624;11;635
28;Normandie;76;3;24;594;Saint-Jean-du-Cardonnay;1338;26;1364
28;Normandie;76;2;26;595;Saint-Jouin-Bruneval;1837;35;1872
28;Normandie;76;2;32;596;Saint-Laurent-de-Brèvedent;1491;38;1529
28;Normandie;76;3;35;597;Saint-Laurent-en-Caux;763;9;772
28;Normandie;76;1;10;598;Saint-Léger-aux-Bois;485;9;494
28;Normandie;76;3;06;599;Saint-Léger-du-Bourg-Denis;3617;42;3659
28;Normandie;76;2;11;600;Saint-Léonard;1702;34;1736
28;Normandie;76;1;12;601;Saint-Lucien;234;3;237
28;Normandie;76;1;20;602;Saint-Maclou-de-Folleville;619;15;634
28;Normandie;76;2;32;603;Saint-Maclou-la-Brière;462;6;468
28;Normandie;76;1;20;604;Saint-Mards;177;6;183
28;Normandie;76;1;07;605;Sainte-Marguerite-sur-Mer;463;13;476
28;Normandie;76;1;12;606;Morienne;189;25;214
28;Normandie;76;3;01;608;Sainte-Marguerite-sur-Duclair;2027;33;2060
28;Normandie;76;2;26;609;Sainte-Marie-au-Bosc;367;11;378
28;Normandie;76;3;35;610;Sainte-Marie-des-Champs;1576;13;1589
28;Normandie;76;3;35;611;Saint-Martin-aux-Arbres;316;9;325
28;Normandie;76;1;10;612;Saint-Martin-au-Bosc;262;6;268
28;Normandie;76;1;33;613;Saint-Martin-aux-Buneaux;646;12;658
28;Normandie;76;3;01;614;Saint-Martin-de-Boscherville;1536;30;1566
28;Normandie;76;2;26;615;Saint-Martin-du-Bec;637;23;660
28;Normandie;76;2;26;616;Saint-Martin-du-Manoir;1460;33;1493
28;Normandie;76;3;06;617;Saint-Martin-du-Vivier;1675;64;1739
28;Normandie;76;1;08;618;Petit-Caux;9654;208;9862
28;Normandie;76;1;10;619;Saint-Martin-le-Gaillard;284;5;289
28;Normandie;76;1;23;620;Saint-Martin-l'Hortier;272;7;279
28;Normandie;76;1;23;621;Saint-Martin-Osmonville;1183;22;1205
28;Normandie;76;2;25;622;Saint-Maurice-d'Ételan;298;10;308
28;Normandie;76;1;12;623;Saint-Michel-d'Halescourt;116;3;119
28;Normandie;76;1;08;624;Saint-Nicolas-d'Aliermont;3718;60;3778
28;Normandie;76;3;25;626;Saint-Nicolas-de-la-Haie;414;14;428
28;Normandie;76;2;03;627;Saint-Nicolas-de-la-Taille;1649;18;1667
28;Normandie;76;1;20;628;Saint-Ouen-du-Breuil;816;13;829
28;Normandie;76;1;20;629;Saint-Ouen-le-Mauger;278;5;283
28;Normandie;76;1;08;630;Saint-Ouen-sous-Bailly;227;7;234
28;Normandie;76;3;01;631;Saint-Paër;1307;15;1322
28;Normandie;76;1;20;632;Saint-Pierre-Bénouville;379;3;382
28;Normandie;76;3;04;634;Saint-Pierre-de-Manneville;885;15;900
28;Normandie;76;1;23;635;Saint-Pierre-des-Jonquières;74;0;74
28;Normandie;76;3;01;636;Saint-Pierre-de-Varengeville;2290;33;2323
28;Normandie;76;2;11;637;Saint-Pierre-en-Port;826;14;840
28;Normandie;76;1;10;638;Saint-Pierre-en-Val;1087;16;1103
28;Normandie;76;3;05;640;Saint-Pierre-lès-Elbeuf;8251;73;8324
28;Normandie;76;1;33;641;Saint-Pierre-le-Vieux;194;5;199
28;Normandie;76;1;33;642;Saint-Pierre-le-Viger;265;3;268
28;Normandie;76;1;10;644;Saint-Rémy-Boscrocourt;797;16;813
28;Normandie;76;1;10;645;Saint-Riquier-en-Rivière;145;5;150
28;Normandie;76;1;33;646;Saint-Riquier-ès-Plains;614;14;628
28;Normandie;76;2;32;647;Saint-Romain-de-Colbosc;4355;42;4397
28;Normandie;76;1;23;648;Saint-Saëns;2326;24;2350
28;Normandie;76;1;23;649;Saint-Saire;579;11;590
28;Normandie;76;2;32;650;Saint-Sauveur-d'Émalleville;1226;29;1255
28;Normandie;76;1;33;651;Saint-Sylvain;140;3;143
28;Normandie;76;1;08;652;Saint-Vaast-d'Équiqueville;762;5;767
28;Normandie;76;1;33;653;Saint-Vaast-Dieppedalle;372;3;375
28;Normandie;76;1;20;654;Saint-Vaast-du-Val;466;10;476
28;Normandie;76;1;33;655;Saint-Valery-en-Caux;3906;162;4068
28;Normandie;76;1;20;656;Saint-Victor-l'Abbaye;761;6;767
28;Normandie;76;2;32;657;Saint-Vigor-d'Ymonville;1141;23;1164
28;Normandie;76;2;32;658;Saint-Vincent-Cramesnil;695;21;716
28;Normandie;76;2;32;660;Sandouville;795;11;806
28;Normandie;76;1;20;662;Sassetot-le-Malgardé;108;1;109
28;Normandie;76;2;11;663;Sassetot-le-Mauconduit;1002;19;1021
28;Normandie;76;1;33;664;Sasseville;280;5;285
28;Normandie;76;1;08;665;Sauchay;438;5;443
28;Normandie;76;1;12;666;Saumont-la-Poterie;411;16;427
28;Normandie;76;1;07;667;Sauqueville;342;6;348
28;Normandie;76;3;35;668;Saussay;366;7;373
28;Normandie;76;2;32;669;Sausseuzemare-en-Caux;429;7;436
28;Normandie;76;2;11;670;Senneville-sur-Fécamp;888;11;899
28;Normandie;76;1;10;671;Sept-Meules;171;1;172
28;Normandie;76;1;12;672;Serqueux;965;15;980
28;Normandie;76;3;21;673;Servaville-Salmonville;1131;16;1147
28;Normandie;76;3;02;675;Sierville;1111;14;1125
28;Normandie;76;1;12;676;Sigy-en-Bray;494;8;502
28;Normandie;76;1;23;677;Smermesnil;368;8;376
28;Normandie;76;1;23;678;Sommery;837;10;847
28;Normandie;76;1;33;679;Sommesnil;113;1;114
28;Normandie;76;2;11;680;Sorquainville;185;4;189
28;Normandie;76;3;99;681;Sotteville-lès-Rouen;29071;459;29530
28;Normandie;76;3;05;682;Sotteville-sous-le-Val;749;4;753
28;Normandie;76;1;33;683;Sotteville-sur-Mer;399;10;409
28;Normandie;76;2;03;684;Tancarville;1233;22;1255
28;Normandie;76;2;11;685;Thérouldeville;666;8;674
28;Normandie;76;2;11;686;Theuville-aux-Maillots;535;8;543
28;Normandie;76;2;11;688;Thiergeville;399;11;410
28;Normandie;76;2;11;689;Thiétreville;369;38;407
28;Normandie;76;1;20;690;Thil-Manneville;654;19;673
28;Normandie;76;1;12;691;Le Thil-Riberpré;236;1;237
28;Normandie;76;1;33;692;Thiouville;285;5;290
28;Normandie;76;2;26;693;Le Tilleul;686;7;693
28;Normandie;76;1;20;694;Tocqueville-en-Caux;139;3;142
28;Normandie;76;2;32;695;Tocqueville-les-Murs;280;5;285
28;Normandie;76;1;20;697;Torcy-le-Grand;792;24;816
28;Normandie;76;1;20;698;Torcy-le-Petit;499;8;507
28;Normandie;76;3;35;699;Le Torp-Mesnil;459;4;463
28;Normandie;76;1;20;700;Tôtes;1576;30;1606
28;Normandie;76;3;35;702;Touffreville-la-Corbeline;835;16;851
28;Normandie;76;1;10;703;Touffreville-sur-Eu;215;8;223
28;Normandie;76;3;05;705;Tourville-la-Rivière;2562;19;2581
28;Normandie;76;2;11;706;Tourville-les-Ifs;722;8;730
28;Normandie;76;1;07;707;Tourville-sur-Arques;1200;35;1235
28;Normandie;76;2;11;708;Toussaint;699;11;710
28;Normandie;76;3;01;709;Le Trait;4831;45;4876
28;Normandie;76;2;33;710;Trémauville;103;2;105
28;Normandie;76;1;10;711;Le Tréport;4441;92;4533
28;Normandie;76;2;03;712;La Trinité-du-Mont;850;27;877
28;Normandie;76;2;32;714;Les Trois-Pierres;786;14;800
28;Normandie;76;2;25;715;Trouville;625;8;633
28;Normandie;76;2;26;716;Turretot;1505;19;1524
28;Normandie;76;3;04;717;Val-de-la-Haye;718;3;721
28;Normandie;76;3;35;718;Valliquerville;1423;38;1461
28;Normandie;76;2;11;719;Valmont;863;15;878
28;Normandie;76;1;07;720;Varengeville-sur-Mer;952;31;983
28;Normandie;76;1;20;721;Varneville-Bretteville;327;9;336
28;Normandie;76;1;20;723;Vassonville;429;7;436
28;Normandie;76;1;23;724;Vatierville;131;2;133
28;Normandie;76;2;32;725;Vattetot-sous-Beaumont;578;5;583
28;Normandie;76;2;11;726;Vattetot-sur-Mer;323;6;329
28;Normandie;76;3;25;727;Vatteville-la-Rue;1146;26;1172
28;Normandie;76;3;24;728;La Vaupalière;1171;21;1192
28;Normandie;76;1;33;730;Veauville-lès-Quelles;131;5;136
28;Normandie;76;1;20;731;Vénestanville;209;2;211
28;Normandie;76;1;33;732;Butot-Vénesville;240;4;244
28;Normandie;76;1;23;733;Ventes-Saint-Rémy;224;3;227
28;Normandie;76;2;26;734;Vergetot;445;12;457
28;Normandie;76;1;33;735;Veules-les-Roses;523;13;536
28;Normandie;76;1;33;736;Veulettes-sur-Mer;275;6;281
28;Normandie;76;3;35;737;Vibeuf;607;11;618
28;Normandie;76;3;21;738;Vieux-Manoir;767;11;778
28;Normandie;76;1;12;739;Vieux-Rouen-sur-Bresle;563;6;569
28;Normandie;76;3;21;740;La Vieux-Rue;578;10;588
28;Normandie;76;2;26;741;Villainville;282;12;294
28;Normandie;76;3;01;743;Villers-Écalles;1753;19;1772
28;Normandie;76;1;10;744;Villers-sous-Foucarmont;184;2;186
28;Normandie;76;1;10;745;Villy-sur-Yères;205;2;207
28;Normandie;76;2;11;746;Vinnemerville;228;2;230
28;Normandie;76;2;32;747;Virville;348;3;351
28;Normandie;76;1;33;748;Vittefleur;654;7;661
28;Normandie;76;1;23;749;Wanchy-Capval;335;8;343
28;Normandie;76;3;01;750;Yainville;1037;13;1050
28;Normandie;76;2;33;751;Yébleron;1274;15;1289
28;Normandie;76;3;35;752;Yerville;2515;20;2535
28;Normandie;76;3;06;753;Ymare;1182;22;1204
28;Normandie;76;2;11;754;Yport;718;13;731
28;Normandie;76;2;11;755;Ypreville-Biville;565;8;573
28;Normandie;76;3;21;756;Yquebeuf;240;1;241
28;Normandie;76;3;35;757;Yvecrique;636;13;649
28;Normandie;76;3;35;758;Yvetot;11280;205;11485
28;Normandie;76;3;01;759;Yville-sur-Seine;437;8;445
11;Île-de-France;77;4;07;001;Achères-la-Forêt;1151;29;1180
11;Île-de-France;77;1;05;002;Amillis;819;4;823
11;Île-de-France;77;4;07;003;Amponville;342;7;349
11;Île-de-France;77;2;14;004;Andrezel;299;1;300
11;Île-de-France;77;1;03;005;Annet-sur-Marne;3305;47;3352
11;Île-de-France;77;4;07;006;Arbonne-la-Forêt;978;20;998
11;Île-de-France;77;2;14;007;Argentières;355;6;361
11;Île-de-France;77;1;06;008;Armentières-en-Brie;1213;24;1237
11;Île-de-France;77;4;15;009;Arville;129;2;131
11;Île-de-France;77;3;14;010;Aubepierre-Ozouer-le-Repos;941;10;951
11;Île-de-France;77;4;15;011;Aufferville;491;7;498
11;Île-de-France;77;3;18;012;Augers-en-Brie;292;7;299
11;Île-de-France;77;1;05;013;Aulnoy;361;9;370
11;Île-de-France;77;4;07;014;Avon;13545;218;13763
11;Île-de-France;77;3;18;015;Baby;100;2;102
11;Île-de-France;77;4;15;016;Bagneaux-sur-Loing;1607;14;1621
11;Île-de-France;77;5;21;018;Bailly-Romainvilliers;7288;80;7368
11;Île-de-France;77;3;18;019;Balloy;335;3;338
11;Île-de-France;77;3;18;020;Bannost-Villegagnon;649;12;661
11;Île-de-France;77;3;13;021;Barbey;154;3;157
11;Île-de-France;77;4;07;022;Barbizon;1245;40;1285
11;Île-de-France;77;1;03;023;Barcy;359;7;366
11;Île-de-France;77;1;06;024;Bassevelle;393;1;394
11;Île-de-France;77;3;18;025;Bazoches-lès-Bray;872;8;880
11;Île-de-France;77;3;18;026;Beauchery-Saint-Martin;354;15;369
11;Île-de-France;77;4;15;027;Beaumont-du-Gâtinais;1175;16;1191
11;Île-de-France;77;2;14;029;Beauvoir;185;3;188
11;Île-de-France;77;3;05;030;Bellot;773;5;778
11;Île-de-France;77;3;08;031;Bernay-Vilbert;946;11;957
11;Île-de-France;77;3;18;032;Beton-Bazoches;924;17;941
11;Île-de-France;77;3;18;033;Bezalles;230;8;238
11;Île-de-France;77;2;14;034;Blandy;782;7;789
11;Île-de-France;77;3;15;035;Blennes;546;7;553
11;Île-de-France;77;3;18;036;Boisdon;134;3;137
11;Île-de-France;77;4;14;037;Bois-le-Roi;5933;147;6080
11;Île-de-France;77;2;20;038;Boissettes;413;7;420
11;Île-de-France;77;2;20;039;Boissise-la-Bertrand;1169;11;1180
11;Île-de-France;77;2;19;040;Boissise-le-Roi;3712;42;3754
11;Île-de-France;77;4;07;041;Boissy-aux-Cailles;278;7;285
11;Île-de-France;77;1;05;042;Boissy-le-Châtel;3249;41;3290
11;Île-de-France;77;3;05;043;Boitron;334;7;341
11;Île-de-France;77;2;14;044;Bombon;952;9;961
11;Île-de-France;77;4;15;045;Bougligny;721;11;732
11;Île-de-France;77;4;07;046;Boulancourt;329;10;339
11;Île-de-France;77;1;21;047;Bouleurs;1698;13;1711
11;Île-de-France;77;4;07;048;Bourron-Marlotte;2768;86;2854
11;Île-de-France;77;1;21;049;Boutigny;837;13;850
11;Île-de-France;77;4;15;050;Bransles;528;11;539
11;Île-de-France;77;3;18;051;Bray-sur-Seine;2337;18;2355
11;Île-de-France;77;3;14;052;Bréau;361;5;366
11;Île-de-France;77;5;04;053;Brie-Comte-Robert;19161;286;19447
11;Île-de-France;77;3;13;054;La Brosse-Montceaux;721;14;735
11;Île-de-France;77;5;23;055;Brou-sur-Chantereine;4890;10;4900
11;Île-de-France;77;4;07;056;Burcy;147;6;153
11;Île-de-France;77;1;06;057;Bussières;539;3;542
11;Île-de-France;77;5;22;058;Bussy-Saint-Georges;26551;356;26907
11;Île-de-France;77;5;22;059;Bussy-Saint-Martin;676;14;690
11;Île-de-France;77;4;07;060;Buthiers;730;16;746
11;Île-de-France;77;3;13;061;Cannes-Écluse;2575;26;2601
11;Île-de-France;77;5;09;062;Carnetin;456;10;466
11;Île-de-France;77;1;05;063;La Celle-sur-Morin;1251;15;1266
11;Île-de-France;77;4;07;065;Cély;1247;24;1271
11;Île-de-France;77;3;18;066;Cerneux;310;3;313
11;Île-de-France;77;2;20;067;Cesson;10937;132;11069
11;Île-de-France;77;3;18;068;Cessoy-en-Montois;215;4;219
11;Île-de-France;77;4;07;069;Chailly-en-Bière;2083;32;2115
11;Île-de-France;77;1;05;070;Chailly-en-Brie;1520;131;1651
11;Île-de-France;77;4;15;071;Chaintreaux;842;15;857
11;Île-de-France;77;3;18;072;Chalautre-la-Grande;678;10;688
11;Île-de-France;77;3;18;073;Chalautre-la-Petite;553;17;570
11;Île-de-France;77;5;09;075;Chalifert;1384;10;1394
11;Île-de-France;77;3;18;076;Chalmaison;757;54;811
11;Île-de-France;77;1;03;077;Chambry;1032;11;1043
11;Île-de-France;77;1;06;078;Chamigny;1365;52;1417
11;Île-de-France;77;4;13;079;Champagne-sur-Seine;6354;150;6504
11;Île-de-France;77;3;18;080;Champcenest;197;2;199
11;Île-de-France;77;2;14;081;Champdeuil;731;8;739
11;Île-de-France;77;2;14;082;Champeaux;812;12;824
11;Île-de-France;77;5;01;083;Champs-sur-Marne;25230;142;25372
11;Île-de-France;77;1;06;084;Changis-sur-Marne;1372;12;1384
11;Île-de-France;77;5;09;085;Chanteloup-en-Brie;4017;51;4068
11;Île-de-France;77;3;14;086;La Chapelle-Gauthier;1428;6;1434
11;Île-de-France;77;3;08;087;La Chapelle-Iger;177;2;179
11;Île-de-France;77;4;07;088;La Chapelle-la-Reine;2367;29;2396
11;Île-de-France;77;3;14;089;La Chapelle-Rablais;908;7;915
11;Île-de-France;77;3;18;090;La Chapelle-Saint-Sulpice;240;4;244
11;Île-de-France;77;3;08;091;Les Chapelles-Bourbon;494;3;497
11;Île-de-France;77;3;05;093;La Chapelle-Moutils;434;2;436
11;Île-de-France;77;1;03;094;Charmentray;300;1;301
11;Île-de-France;77;1;03;095;Charny;1539;17;1556
11;Île-de-France;77;4;14;096;Chartrettes;2542;56;2598
11;Île-de-France;77;3;05;097;Chartronges;299;2;301
11;Île-de-France;77;3;14;098;Châteaubleau;360;5;365
11;Île-de-France;77;4;15;099;Château-Landon;3020;54;3074
11;Île-de-France;77;2;14;100;Le Châtelet-en-Brie;4282;67;4349
11;Île-de-France;77;3;18;101;Châtenay-sur-Seine;1060;16;1076
11;Île-de-France;77;4;15;102;Châtenoy;161;1;162
11;Île-de-France;77;2;14;103;Châtillon-la-Borde;220;2;222
11;Île-de-France;77;3;08;104;Châtres;704;7;711
11;Île-de-France;77;1;05;106;Chauffry;1024;18;1042
11;Île-de-France;77;2;08;107;Chaumes-en-Brie;3387;27;3414
11;Île-de-France;77;5;02;108;Chelles;54372;319;54691
11;Île-de-France;77;3;18;109;Chenoise-Cucharmoy;1653;26;1679
11;Île-de-France;77;4;15;110;Chenou;305;7;312
11;Île-de-France;77;5;21;111;Chessy;6724;56;6780
11;Île-de-France;77;4;15;112;Chevrainvilliers;255;4;259
11;Île-de-France;77;1;05;113;Chevru;1068;11;1079
11;Île-de-France;77;5;16;114;Chevry-Cossigny;3920;42;3962
11;Île-de-France;77;3;15;115;Chevry-en-Sereine;511;17;528
11;Île-de-France;77;3;05;116;Choisy-en-Brie;1314;15;1329
11;Île-de-France;77;1;06;117;Citry;958;12;970
11;Île-de-France;77;1;03;118;Claye-Souilly;12316;119;12435
11;Île-de-France;77;3;14;119;Clos-Fontaine;244;3;247
11;Île-de-France;77;1;06;120;Cocherel;631;5;636
11;Île-de-France;77;5;22;121;Collégien;3339;42;3381
11;Île-de-France;77;2;04;122;Combs-la-Ville;21657;144;21801
11;Île-de-France;77;1;12;123;Compans;816;2;818
11;Île-de-France;77;5;09;124;Conches-sur-Gondoire;1746;28;1774
11;Île-de-France;77;1;21;125;Condé-Sainte-Libiaire;1429;17;1446
11;Île-de-France;77;1;06;126;Congis-sur-Thérouanne;1769;182;1951
11;Île-de-France;77;2;08;127;Coubert;1885;13;1898
11;Île-de-France;77;1;21;128;Couilly-Pont-aux-Dames;2096;29;2125
11;Île-de-France;77;1;06;129;Coulombs-en-Valois;566;8;574
11;Île-de-France;77;1;21;130;Coulommes;517;4;521
11;Île-de-France;77;1;05;131;Coulommiers;14953;214;15167
11;Île-de-France;77;5;21;132;Coupvray;2867;28;2895
11;Île-de-France;77;3;13;133;Courcelles-en-Bassée;196;3;199
11;Île-de-France;77;3;18;134;Courchamp;150;3;153
11;Île-de-France;77;3;08;135;Courpalay;1272;15;1287
11;Île-de-France;77;2;08;136;Courquetaine;189;7;196
11;Île-de-France;77;3;18;137;Courtacon;240;10;250
11;Île-de-France;77;3;14;138;Courtomer;548;5;553
11;Île-de-France;77;5;23;139;Courtry;6643;53;6696
11;Île-de-France;77;3;18;140;Coutençon;271;3;274
11;Île-de-France;77;1;21;141;Coutevroult;1196;9;1205
11;Île-de-France;77;1;21;142;Crécy-la-Chapelle;4774;69;4843
11;Île-de-France;77;1;03;143;Crégy-lès-Meaux;5288;40;5328
11;Île-de-France;77;3;08;144;Crèvecœur-en-Brie;440;1;441
11;Île-de-France;77;2;14;145;Crisenoy;616;12;628
11;Île-de-France;77;5;01;146;Croissy-Beaubourg;2009;20;2029
11;Île-de-France;77;3;14;147;La Croix-en-Brie;664;7;671
11;Île-de-France;77;1;06;148;Crouy-sur-Ourcq;1820;23;1843
11;Île-de-France;77;1;03;150;Cuisy;460;5;465
11;Île-de-France;77;1;05;151;Dagny;270;4;274
11;Île-de-France;77;2;19;152;Dammarie-les-Lys;22318;153;22471
11;Île-de-France;77;1;12;153;Dammartin-en-Goële;10830;92;10922
11;Île-de-France;77;1;08;154;Dammartin-sur-Tigeaux;1168;15;1183
11;Île-de-France;77;5;09;155;Dampmart;3517;39;3556
11;Île-de-France;77;4;15;156;Darvault;903;12;915
11;Île-de-France;77;1;06;157;Dhuisy;317;5;322
11;Île-de-France;77;3;15;158;Diant;199;2;201
11;Île-de-France;77;3;18;159;Donnemarie-Dontilly;2760;49;2809
11;Île-de-France;77;4;15;161;Dormelles;797;18;815
11;Île-de-France;77;3;05;162;Doue;1094;9;1103
11;Île-de-France;77;1;06;163;Douy-la-Ramée;374;6;380
11;Île-de-France;77;2;14;164;Échouboulains;558;5;563
11;Île-de-France;77;2;14;165;Les Écrennes;602;5;607
11;Île-de-France;77;3;18;167;Égligny;320;5;325
11;Île-de-France;77;4;15;168;Égreville;2151;36;2187
11;Île-de-France;77;5;17;169;Émerainville;7667;32;7699
11;Île-de-France;77;5;21;171;Esbly;6464;45;6509
11;Île-de-France;77;3;13;172;Esmans;891;10;901
11;Île-de-France;77;1;06;173;Étrépilly;825;8;833
11;Île-de-France;77;3;18;174;Everly;578;12;590
11;Île-de-France;77;2;08;175;Évry-Grégy-sur-Yerre;3070;31;3101
11;Île-de-France;77;1;08;176;Faremoutiers;2991;27;3018
11;Île-de-France;77;3;16;177;Favières;1186;6;1192
11;Île-de-France;77;4;15;178;Faÿ-lès-Nemours;497;10;507
11;Île-de-France;77;2;14;179;Féricy;601;15;616
11;Île-de-France;77;5;16;180;Férolles-Attilly;1263;27;1290
11;Île-de-France;77;5;16;181;Ferrières-en-Brie;3796;36;3832
11;Île-de-France;77;3;05;182;La Ferté-Gaucher;4877;33;4910
11;Île-de-France;77;1;06;183;La Ferté-sous-Jouarre;9672;80;9752
11;Île-de-France;77;4;15;184;Flagy;610;11;621
11;Île-de-France;77;4;07;185;Fleury-en-Bière;654;17;671
11;Île-de-France;77;4;07;186;Fontainebleau;15903;465;16368
11;Île-de-France;77;3;18;187;Fontaine-Fourches;581;3;584
11;Île-de-France;77;2;14;188;Fontaine-le-Port;992;18;1010
11;Île-de-France;77;3;14;190;Fontains;263;6;269
11;Île-de-France;77;3;14;191;Fontenailles;1052;13;1065
11;Île-de-France;77;3;08;192;Fontenay-Trésigny;5756;58;5814
11;Île-de-France;77;1;03;193;Forfry;241;1;242
11;Île-de-France;77;3;13;194;Forges;421;17;438
11;Île-de-France;77;2;14;195;Fouju;583;10;593
11;Île-de-France;77;1;03;196;Fresnes-sur-Marne;964;7;971
11;Île-de-France;77;3;18;197;Frétoy;166;3;169
11;Île-de-France;77;4;07;198;Fromont;241;9;250
11;Île-de-France;77;1;06;199;Fublaines;1402;11;1413
11;Île-de-France;77;4;15;200;Garentreville;122;2;124
11;Île-de-France;77;3;14;201;Gastins;688;3;691
11;Île-de-France;77;4;15;202;La Genevraye;809;6;815
11;Île-de-France;77;1;06;203;Germigny-l'Évêque;1336;21;1357
11;Île-de-France;77;1;06;204;Germigny-sous-Coulombs;209;3;212
11;Île-de-France;77;1;03;205;Gesvres-le-Chapitre;147;1;148
11;Île-de-France;77;1;05;206;Giremoutiers;183;4;187
11;Île-de-France;77;4;15;207;Gironville;152;5;157
11;Île-de-France;77;3;18;208;Gouaix;1361;27;1388
11;Île-de-France;77;5;09;209;Gouvernes;1188;23;1211
11;Île-de-France;77;3;13;210;La Grande-Paroisse;2886;36;2922
11;Île-de-France;77;3;14;211;Grandpuits-Bailly-Carrois;1015;5;1020
11;Île-de-France;77;3;18;212;Gravon;163;3;166
11;Île-de-France;77;1;03;214;Gressy;807;13;820
11;Île-de-France;77;5;16;215;Gretz-Armainvilliers;8459;66;8525
11;Île-de-France;77;4;15;216;Grez-sur-Loing;1421;34;1455
11;Île-de-France;77;2;08;217;Grisy-Suisnes;2521;30;2551
11;Île-de-France;77;3;18;218;Grisy-sur-Seine;107;1;108
11;Île-de-France;77;1;08;219;Guérard;2641;32;2673
11;Île-de-France;77;4;07;220;Guercheville;265;4;269
11;Île-de-France;77;5;09;221;Guermantes;1136;24;1160
11;Île-de-France;77;2;14;222;Guignes;4344;29;4373
11;Île-de-France;77;3;18;223;Gurcy-le-Châtel;564;6;570
11;Île-de-France;77;1;05;224;Hautefeuille;253;4;257
11;Île-de-France;77;1;21;225;La Haute-Maison;327;6;333
11;Île-de-France;77;4;07;226;Héricy;2518;97;2615
11;Île-de-France;77;3;18;227;Hermé;615;17;632
11;Île-de-France;77;3;05;228;Hondevilliers;257;2;259
11;Île-de-France;77;3;08;229;La Houssaye-en-Brie;1646;18;1664
11;Île-de-France;77;4;15;230;Ichy;160;1;161
11;Île-de-France;77;1;06;231;Isles-les-Meldeuses;819;2;821
11;Île-de-France;77;1;03;232;Isles-lès-Villenoy;1145;17;1162
11;Île-de-France;77;1;03;233;Iverny;596;6;602
11;Île-de-France;77;5;09;234;Jablines;702;7;709
11;Île-de-France;77;1;06;235;Jaignes;317;5;322
11;Île-de-France;77;3;18;236;Jaulnes;345;4;349
11;Île-de-France;77;5;22;237;Jossigny;640;9;649
11;Île-de-France;77;1;06;238;Jouarre;4345;39;4384
11;Île-de-France;77;3;18;239;Jouy-le-Châtel;1504;20;1524
11;Île-de-France;77;3;05;240;Jouy-sur-Morin;2212;26;2238
11;Île-de-France;77;1;12;241;Juilly;2018;14;2032
11;Île-de-France;77;3;18;242;Jutigny;532;8;540
11;Île-de-France;77;5;09;243;Lagny-sur-Marne;21139;193;21332
11;Île-de-France;77;4;15;244;Larchant;697;12;709
11;Île-de-France;77;3;13;245;Laval-en-Brie;403;4;407
11;Île-de-France;77;3;18;246;Léchelle;583;16;599
11;Île-de-France;77;3;05;247;Lescherolles;441;8;449
11;Île-de-France;77;5;09;248;Lesches;776;8;784
11;Île-de-France;77;5;16;249;Lésigny;7125;117;7242
11;Île-de-France;77;3;05;250;Leudon-en-Brie;163;3;166
11;Île-de-France;77;2;04;251;Lieusaint;13804;87;13891
11;Île-de-France;77;2;08;252;Limoges-Fourches;564;6;570
11;Île-de-France;77;2;08;253;Lissy;315;1;316
11;Île-de-France;77;3;08;254;Liverdy-en-Brie;1295;23;1318
11;Île-de-France;77;2;11;255;Livry-sur-Seine;2207;30;2237
11;Île-de-France;77;3;18;256;Lizines;187;1;188
11;Île-de-France;77;1;06;257;Lizy-sur-Ourcq;3529;18;3547
11;Île-de-France;77;5;01;258;Lognes;14388;53;14441
11;Île-de-France;77;1;12;259;Longperrier;2303;10;2313
11;Île-de-France;77;3;18;260;Longueville;1778;26;1804
11;Île-de-France;77;4;15;261;Lorrez-le-Bocage-Préaux;1208;22;1230
11;Île-de-France;77;3;18;262;Louan-Villegruis-Fontaine;497;18;515
11;Île-de-France;77;3;18;263;Luisetaines;232;7;239
11;Île-de-France;77;3;08;264;Lumigny-Nesles-Ormeaux;1512;20;1532
11;Île-de-France;77;1;06;265;Luzancy;1092;52;1144
11;Île-de-France;77;2;14;266;Machault;785;12;797
11;Île-de-France;77;4;15;267;La Madeleine-sur-Loing;355;4;359
11;Île-de-France;77;5;21;268;Magny-le-Hongre;9082;148;9230
11;Île-de-France;77;2;11;269;Maincy;1819;53;1872
11;Île-de-France;77;1;05;270;Maisoncelles-en-Brie;954;12;966
11;Île-de-France;77;4;15;271;Maisoncelles-en-Gâtinais;137;1;138
11;Île-de-France;77;3;18;272;Maison-Rouge;861;8;869
11;Île-de-France;77;1;12;273;Marchémoret;594;3;597
11;Île-de-France;77;1;06;274;Marcilly;449;2;451
11;Île-de-France;77;3;18;275;Les Marêts;150;3;153
11;Île-de-France;77;1;03;276;Mareuil-lès-Meaux;3306;43;3349
11;Île-de-France;77;3;08;277;Marles-en-Brie;1798;21;1819
11;Île-de-France;77;1;05;278;Marolles-en-Brie;415;6;421
11;Île-de-France;77;3;13;279;Marolles-sur-Seine;1832;34;1866
11;Île-de-France;77;1;06;280;Mary-sur-Marne;1095;10;1105
11;Île-de-France;77;1;05;281;Mauperthuis;472;4;476
11;Île-de-France;77;1;12;282;Mauregard;365;4;369
11;Île-de-France;77;1;06;283;May-en-Multien;923;11;934
11;Île-de-France;77;1;10;284;Meaux;55709;482;56191
11;Île-de-France;77;2;20;285;Le Mée-sur-Seine;20677;140;20817
11;Île-de-France;77;3;18;286;Meigneux;231;6;237
11;Île-de-France;77;3;05;287;Meilleray;499;1;500
11;Île-de-France;77;2;11;288;Melun;41609;258;41867
11;Île-de-France;77;3;18;289;Melz-sur-Seine;351;3;354
11;Île-de-France;77;1;06;290;Méry-sur-Marne;684;57;741
11;Île-de-France;77;1;12;291;Le Mesnil-Amelot;1041;4;1045
11;Île-de-France;77;1;03;292;Messy;1210;10;1220
11;Île-de-France;77;3;13;293;Misy-sur-Yonne;894;17;911
11;Île-de-France;77;1;12;294;Mitry-Mory;20620;93;20713
11;Île-de-France;77;2;14;295;Moisenay;1379;14;1393
11;Île-de-France;77;2;04;296;Moissy-Cramayel;17982;135;18117
11;Île-de-France;77;4;15;297;Mondreville;327;5;332
11;Île-de-France;77;3;18;298;Mons-en-Montois;445;10;455
11;Île-de-France;77;1;06;300;Montceaux-lès-Meaux;601;12;613
11;Île-de-France;77;3;18;301;Montceaux-lès-Provins;322;1;323
11;Île-de-France;77;4;15;302;Montcourt-Fromonville;1943;33;1976
11;Île-de-France;77;3;05;303;Montdauphin;236;3;239
11;Île-de-France;77;3;05;304;Montenils;25;0;25
11;Île-de-France;77;3;13;305;Montereau-Fault-Yonne;21888;185;22073
11;Île-de-France;77;2;11;306;Montereau-sur-le-Jard;497;5;502
11;Île-de-France;77;5;09;307;Montévrain;14017;103;14120
11;Île-de-France;77;1;12;308;Montgé-en-Goële;728;6;734
11;Île-de-France;77;1;03;309;Monthyon;1751;10;1761
11;Île-de-France;77;3;18;310;Montigny-le-Guesdier;305;6;311
11;Île-de-France;77;3;18;311;Montigny-Lencoup;1405;18;1423
11;Île-de-France;77;4;15;312;Montigny-sur-Loing;2640;75;2715
11;Île-de-France;77;3;15;313;Montmachoux;259;2;261
11;Île-de-France;77;3;05;314;Montolivet;239;2;241
11;Île-de-France;77;5;21;315;Montry;3740;30;3770
11;Île-de-France;77;4;13;316;Moret-Loing-et-Orvanne;12507;338;12845
11;Île-de-France;77;3;14;317;Mormant;5104;37;5141
11;Île-de-France;77;3;08;318;Mortcerf;1423;21;1444
11;Île-de-France;77;3;18;319;Mortery;142;4;146
11;Île-de-France;77;1;05;320;Mouroux;5972;59;6031
11;Île-de-France;77;3;18;321;Mousseaux-lès-Bray;667;4;671
11;Île-de-France;77;1;12;322;Moussy-le-Neuf;3212;27;3239
11;Île-de-France;77;1;12;323;Moussy-le-Vieux;1476;9;1485
11;Île-de-France;77;3;18;325;Mouy-sur-Seine;360;5;365
11;Île-de-France;77;2;19;326;Nandy;6262;73;6335
11;Île-de-France;77;3;14;327;Nangis;8904;86;8990
11;Île-de-France;77;4;07;328;Nanteau-sur-Essonne;419;7;426
11;Île-de-France;77;4;15;329;Nanteau-sur-Lunain;687;3;690
11;Île-de-France;77;1;06;330;Nanteuil-lès-Meaux;6549;76;6625
11;Île-de-France;77;1;06;331;Nanteuil-sur-Marne;428;6;434
11;Île-de-France;77;1;12;332;Nantouillet;293;1;294
11;Île-de-France;77;4;15;333;Nemours;12966;143;13109
11;Île-de-France;77;1;03;335;Chauconin-Neufmontiers;3595;28;3623
11;Île-de-France;77;3;08;336;Neufmoutiers-en-Brie;1195;11;1206
11;Île-de-France;77;5;01;337;Noisiel;15750;103;15853
11;Île-de-France;77;3;15;338;Noisy-Rudignon;595;8;603
11;Île-de-France;77;4;07;339;Noisy-sur-École;1829;61;1890
11;Île-de-France;77;4;15;340;Nonville;606;12;618
11;Île-de-France;77;3;18;341;Noyen-sur-Seine;382;10;392
11;Île-de-France;77;4;15;342;Obsonville;109;0;109
11;Île-de-France;77;1;06;343;Ocquerre;386;19;405
11;Île-de-France;77;1;03;344;Oissery;2448;23;2471
11;Île-de-France;77;3;05;345;Orly-sur-Morin;660;9;669
11;Île-de-France;77;3;18;347;Les Ormes-sur-Voulzie;855;10;865
11;Île-de-France;77;4;15;348;Ormesson;237;3;240
11;Île-de-France;77;1;12;349;Othis;6737;70;6807
11;Île-de-France;77;5;16;350;Ozoir-la-Ferrière;20712;209;20921
11;Île-de-France;77;2;08;352;Ozouer-le-Voulgis;1951;20;1971
11;Île-de-France;77;4;15;353;Paley;444;5;449
11;Île-de-France;77;2;14;354;Pamfou;951;9;960
11;Île-de-France;77;3;18;355;Paroy;167;0;167
11;Île-de-France;77;3;18;356;Passy-sur-Seine;45;1;46
11;Île-de-France;77;3;08;357;Pécy;845;10;855
11;Île-de-France;77;1;03;358;Penchard;1340;13;1353
11;Île-de-France;77;4;07;359;Perthes;2007;33;2040
11;Île-de-France;77;1;05;360;Pézarches;392;4;396
11;Île-de-France;77;1;06;361;Pierre-Levée;461;7;468
11;Île-de-France;77;1;23;363;Le Pin;1569;12;1581
11;Île-de-France;77;1;03;364;Le Plessis-aux-Bois;257;2;259
11;Île-de-France;77;3;08;365;Le Plessis-Feu-Aussoux;624;5;629
11;Île-de-France;77;1;03;366;Le Plessis-l'Évêque;289;1;290
11;Île-de-France;77;1;06;367;Le Plessis-Placy;279;4;283
11;Île-de-France;77;3;18;368;Poigny;508;13;521
11;Île-de-France;77;1;06;369;Poincy;759;11;770
11;Île-de-France;77;4;15;370;Poligny;783;12;795
11;Île-de-France;77;1;08;371;Pommeuse;2990;27;3017
11;Île-de-France;77;5;09;372;Pomponne;4168;37;4205
11;Île-de-France;77;5;17;373;Pontault-Combault;37579;225;37804
11;Île-de-France;77;5;16;374;Pontcarré;2154;19;2173
11;Île-de-France;77;1;03;376;Précy-sur-Marne;797;2;799
11;Île-de-France;77;3;08;377;Presles-en-Brie;2310;29;2339
11;Île-de-France;77;2;19;378;Pringy;3254;30;3284
11;Île-de-France;77;3;18;379;Provins;12115;279;12394
11;Île-de-France;77;1;06;380;Puisieux;321;6;327
11;Île-de-France;77;3;14;381;Quiers;661;5;666
11;Île-de-France;77;1;21;382;Quincy-Voisins;5443;54;5497
11;Île-de-France;77;3;14;383;Rampillon;828;10;838
11;Île-de-France;77;2;04;384;Réau;1954;3;1957
11;Île-de-France;77;3;05;385;Rebais;2298;23;2321
11;Île-de-France;77;4;07;386;Recloses;607;22;629
11;Île-de-France;77;4;15;387;Remauville;468;9;477
11;Île-de-France;77;1;06;388;Reuil-en-Brie;822;7;829
11;Île-de-France;77;2;11;389;La Rochette;3820;91;3911
11;Île-de-France;77;5;17;390;Roissy-en-Brie;22643;104;22747
11;Île-de-France;77;3;18;391;Rouilly;491;11;502
11;Île-de-France;77;1;12;392;Rouvres;916;12;928
11;Île-de-France;77;3;08;393;Rozay-en-Brie;2826;37;2863
11;Île-de-France;77;2;11;394;Rubelles;3095;31;3126
11;Île-de-France;77;4;07;395;Rumont;120;4;124
11;Île-de-France;77;3;18;396;Rupéreux;100;0;100
11;Île-de-France;77;1;06;397;Saâcy-sur-Marne;1859;21;1880
11;Île-de-France;77;3;05;398;Sablonnières;722;8;730
11;Île-de-France;77;1;05;400;Saint-Augustin;1774;25;1799
11;Île-de-France;77;1;06;401;Sainte-Aulde;671;7;678
11;Île-de-France;77;3;05;402;Saint-Barthélemy;339;5;344
11;Île-de-France;77;3;18;403;Saint-Brice;808;13;821
11;Île-de-France;77;3;18;404;Sainte-Colombe;1808;37;1845
11;Île-de-France;77;3;05;405;Saint-Cyr-sur-Morin;1955;43;1998
11;Île-de-France;77;3;05;406;Saint-Denis-lès-Rebais;1005;20;1025
11;Île-de-France;77;2;19;407;Saint-Fargeau-Ponthierry;14315;114;14429
11;Île-de-France;77;1;21;408;Saint-Fiacre;425;2;427
11;Île-de-France;77;3;13;409;Saint-Germain-Laval;2769;82;2851
11;Île-de-France;77;2;11;410;Saint-Germain-Laxis;746;33;779
11;Île-de-France;77;3;05;411;Saint-Germain-sous-Doue;560;12;572
11;Île-de-France;77;4;07;412;Saint-Germain-sur-École;386;5;391
11;Île-de-France;77;5;21;413;Saint-Germain-sur-Morin;3849;46;3895
11;Île-de-France;77;3;18;414;Saint-Hilliers;489;7;496
11;Île-de-France;77;1;06;415;Saint-Jean-les-Deux-Jumeaux;1281;17;1298
11;Île-de-France;77;3;14;416;Saint-Just-en-Brie;247;5;252
11;Île-de-France;77;3;05;417;Saint-Léger;254;1;255
11;Île-de-France;77;3;18;418;Saint-Loup-de-Naud;871;12;883
11;Île-de-France;77;4;13;419;Saint-Mammès;3404;118;3522
11;Île-de-France;77;1;12;420;Saint-Mard;3846;26;3872
11;Île-de-France;77;3;05;421;Saint-Mars-Vieux-Maisons;256;7;263
11;Île-de-France;77;3;05;423;Saint-Martin-des-Champs;658;9;667
11;Île-de-France;77;3;18;424;Saint-Martin-du-Boschet;274;4;278
11;Île-de-France;77;4;07;425;Saint-Martin-en-Bière;730;21;751
11;Île-de-France;77;2;14;426;Saint-Méry;332;9;341
11;Île-de-France;77;1;03;427;Saint-Mesmes;608;5;613
11;Île-de-France;77;3;14;428;Saint-Ouen-en-Brie;834;9;843
11;Île-de-France;77;3;05;429;Saint-Ouen-sur-Morin;533;7;540
11;Île-de-France;77;1;12;430;Saint-Pathus;6238;53;6291
11;Île-de-France;77;4;15;431;Saint-Pierre-lès-Nemours;5408;95;5503
11;Île-de-France;77;3;05;432;Saint-Rémy-la-Vanne;987;10;997
11;Île-de-France;77;1;05;433;Beautheil-Saints;1992;34;2026
11;Île-de-France;77;3;18;434;Saint-Sauveur-lès-Bray;366;5;371
11;Île-de-France;77;4;07;435;Saint-Sauveur-sur-École;1102;32;1134
11;Île-de-France;77;3;05;436;Saint-Siméon;905;5;910
11;Île-de-France;77;1;03;437;Saint-Soupplets;3574;31;3605
11;Île-de-France;77;5;09;438;Saint-Thibault-des-Vignes;6304;74;6378
11;Île-de-France;77;3;13;439;Salins;1170;13;1183
11;Île-de-France;77;1;06;440;Sammeron;1138;12;1150
11;Île-de-France;77;4;07;441;Samois-sur-Seine;2024;48;2072
11;Île-de-France;77;4;07;442;Samoreau;2441;62;2503
11;Île-de-France;77;1;21;443;Sancy;390;8;398
11;Île-de-France;77;3;18;444;Sancy-lès-Provins;324;6;330
11;Île-de-France;77;2;20;445;Savigny-le-Temple;30169;235;30404
11;Île-de-France;77;3;18;446;Savins;598;9;607
11;Île-de-France;77;2;19;447;Seine-Port;1835;48;1883
11;Île-de-France;77;1;06;448;Sept-Sorts;547;9;556
11;Île-de-France;77;5;21;449;Serris;9699;90;9789
11;Île-de-France;77;5;16;450;Servon;3308;51;3359
11;Île-de-France;77;1;06;451;Signy-Signets;584;6;590
11;Île-de-France;77;3;18;452;Sigy;66;0;66
11;Île-de-France;77;2;14;453;Sivry-Courtry;1136;14;1150
11;Île-de-France;77;3;18;454;Sognolles-en-Montois;367;5;372
11;Île-de-France;77;2;08;455;Soignolles-en-Brie;2038;31;2069
11;Île-de-France;77;3;18;456;Soisy-Bouy;823;19;842
11;Île-de-France;77;2;08;457;Solers;1212;23;1235
11;Île-de-France;77;4;15;458;Souppes-sur-Loing;5253;99;5352
11;Île-de-France;77;3;18;459;Sourdun;1519;393;1912
11;Île-de-France;77;1;06;460;Tancrou;338;4;342
11;Île-de-France;77;3;18;461;Thénisy;299;6;305
11;Île-de-France;77;1;12;462;Thieux;893;2;895
11;Île-de-France;77;4;13;463;Thomery;3419;112;3531
11;Île-de-France;77;5;09;464;Thorigny-sur-Marne;10427;106;10533
11;Île-de-France;77;3;15;465;Thoury-Férottes;646;9;655
11;Île-de-France;77;1;21;466;Tigeaux;378;3;381
11;Île-de-France;77;3;18;467;La Tombe;203;0;203
11;Île-de-France;77;5;22;468;Torcy;22500;104;22604
11;Île-de-France;77;1;05;469;Touquin;1224;12;1236
11;Île-de-France;77;5;16;470;Tournan-en-Brie;8429;104;8533
11;Île-de-France;77;4;07;471;Tousson;349;8;357
11;Île-de-France;77;3;05;472;La Trétoire;492;7;499
11;Île-de-France;77;4;15;473;Treuzy-Levelay;404;7;411
11;Île-de-France;77;1;03;474;Trilbardou;666;5;671
11;Île-de-France;77;1;06;475;Trilport;5020;31;5051
11;Île-de-France;77;1;06;476;Trocy-en-Multien;230;2;232
11;Île-de-France;77;4;07;477;Ury;855;30;885
11;Île-de-France;77;1;06;478;Ussy-sur-Marne;1085;7;1092
11;Île-de-France;77;5;23;479;Vaires-sur-Marne;13340;110;13450
11;Île-de-France;77;2;14;480;Valence-en-Brie;1056;9;1065
11;Île-de-France;77;3;14;481;Vanvillé;188;2;190
11;Île-de-France;77;3;13;482;Varennes-sur-Seine;3660;72;3732
11;Île-de-France;77;1;03;483;Varreddes;2077;17;2094
11;Île-de-France;77;1;21;484;Vaucourtois;284;6;290
11;Île-de-France;77;4;07;485;Le Vaudoué;730;13;743
11;Île-de-France;77;3;08;486;Vaudoy-en-Brie;893;16;909
11;Île-de-France;77;2;11;487;Vaux-le-Pénil;11102;152;11254
11;Île-de-France;77;4;15;489;Vaux-sur-Lunain;237;2;239
11;Île-de-France;77;1;06;490;Vendrest;689;9;698
11;Île-de-France;77;3;05;492;Verdelot;641;4;645
11;Île-de-France;77;3;14;493;Verneuil-l'Étang;3186;22;3208
11;Île-de-France;77;4;13;494;Vernou-la-Celle-sur-Seine;2630;37;2667
11;Île-de-France;77;2;20;495;Vert-Saint-Denis;8564;85;8649
11;Île-de-France;77;3;14;496;Vieux-Champagne;189;4;193
11;Île-de-France;77;1;03;498;Vignely;313;5;318
11;Île-de-France;77;4;15;500;Villebéon;463;11;474
11;Île-de-France;77;4;13;501;Villecerf;720;14;734
11;Île-de-France;77;4;15;504;Villemaréchal;1096;23;1119
11;Île-de-France;77;1;21;505;Villemareuil;381;5;386
11;Île-de-France;77;4;15;506;Villemer;789;10;799
11;Île-de-France;77;3;18;507;Villenauxe-la-Petite;424;7;431
11;Île-de-France;77;5;16;508;Villeneuve-le-Comte;1862;37;1899
11;Île-de-France;77;3;18;509;Villeneuve-les-Bordes;615;6;621
11;Île-de-France;77;5;16;510;Villeneuve-Saint-Denis;1193;5;1198
11;Île-de-France;77;1;12;511;Villeneuve-sous-Dammartin;645;0;645
11;Île-de-France;77;3;05;512;Villeneuve-sur-Bellot;1128;12;1140
11;Île-de-France;77;1;03;513;Villenoy;4982;31;5013
11;Île-de-France;77;1;23;514;Villeparisis;26700;97;26797
11;Île-de-France;77;1;03;515;Villeroy;701;5;706
11;Île-de-France;77;4;13;516;Ville-Saint-Jacques;845;10;855
11;Île-de-France;77;1;23;517;Villevaudé;2135;13;2148
11;Île-de-France;77;2;07;518;Villiers-en-Bière;234;6;240
11;Île-de-France;77;3;18;519;Villiers-Saint-Georges;1168;26;1194
11;Île-de-France;77;4;07;520;Villiers-sous-Grez;659;19;678
11;Île-de-France;77;1;21;521;Villiers-sur-Morin;1928;44;1972
11;Île-de-France;77;3;18;522;Villiers-sur-Seine;297;5;302
11;Île-de-France;77;3;18;523;Villuis;258;3;261
11;Île-de-France;77;3;18;524;Vimpelles;522;6;528
11;Île-de-France;77;1;12;525;Vinantes;382;1;383
11;Île-de-France;77;1;06;526;Vincy-Manœuvre;276;5;281
11;Île-de-France;77;3;08;527;Voinsles;583;17;600
11;Île-de-France;77;2;11;528;Voisenon;1168;16;1184
11;Île-de-France;77;1;21;529;Voulangis;1490;30;1520
11;Île-de-France;77;3;18;530;Voulton;310;5;315
11;Île-de-France;77;3;15;531;Voulx;1645;23;1668
11;Île-de-France;77;3;18;532;Vulaines-lès-Provins;65;0;65
11;Île-de-France;77;4;07;533;Vulaines-sur-Seine;2743;60;2803
11;Île-de-France;77;2;14;534;Yèbles;949;1;950
11;Île-de-France;78;2;14;003;Ablis;3509;48;3557
11;Île-de-France;78;3;13;005;Achères;21660;152;21812
11;Île-de-France;78;1;02;006;Adainville;654;16;670
11;Île-de-France;78;3;16;007;Aigremont;1085;37;1122
11;Île-de-France;78;2;14;009;Allainville;286;6;292
11;Île-de-France;78;3;19;010;Les Alluets-le-Roi;1215;38;1253
11;Île-de-France;78;3;01;013;Andelu;482;4;486
11;Île-de-France;78;3;05;015;Andrésy;13236;149;13385
11;Île-de-France;78;1;02;020;Arnouville-lès-Mantes;940;14;954
11;Île-de-France;78;1;01;029;Aubergenville;12082;82;12164
11;Île-de-France;78;2;14;030;Auffargis;1970;47;2017
11;Île-de-France;78;1;02;031;Auffreville-Brasseuil;650;10;660
11;Île-de-France;78;1;01;033;Aulnay-sur-Mauldre;1143;24;1167
11;Île-de-France;78;2;01;034;Auteuil;976;19;995
11;Île-de-France;78;2;01;036;Autouillet;612;7;619
11;Île-de-France;78;4;04;043;Bailly;3692;137;3829
11;Île-de-France;78;1;02;048;Bazainville;1460;41;1501
11;Île-de-France;78;3;01;049;Bazemont;1682;46;1728
11;Île-de-France;78;2;01;050;Bazoches-sur-Guyonne;650;10;660
11;Île-de-France;78;2;01;053;Béhoust;488;13;501
11;Île-de-France;78;1;02;057;Bennecourt;1882;21;1903
11;Île-de-France;78;2;12;062;Beynes;7585;112;7697
11;Île-de-France;78;1;02;068;Blaru;892;27;919
11;Île-de-France;78;1;02;070;Boinville-en-Mantois;287;5;292
11;Île-de-France;78;2;14;071;Boinville-le-Gaillard;607;10;617
11;Île-de-France;78;1;02;072;Boinvilliers;250;2;252
11;Île-de-France;78;4;15;073;Bois-d'Arcy;15028;156;15184
11;Île-de-France;78;1;02;076;Boissets;280;4;284
11;Île-de-France;78;2;14;077;La Boissière-École;756;57;813
11;Île-de-France;78;1;02;082;Boissy-Mauvoisin;625;11;636
11;Île-de-France;78;2;01;084;Boissy-sans-Avoir;640;13;653
11;Île-de-France;78;2;14;087;Bonnelles;2095;49;2144
11;Île-de-France;78;1;02;089;Bonnières-sur-Seine;4882;42;4924
11;Île-de-France;78;1;01;090;Bouafle;2204;25;2229
11;Île-de-France;78;4;04;092;Bougival;8983;144;9127
11;Île-de-France;78;1;02;096;Bourdonné;502;14;516
11;Île-de-France;78;1;02;104;Breuil-Bois-Robert;754;13;767
11;Île-de-France;78;1;02;107;Bréval;1901;28;1929
11;Île-de-France;78;2;14;108;Les Bréviaires;1305;29;1334
11;Île-de-France;78;1;07;113;Brueil-en-Vexin;698;14;712
11;Île-de-France;78;4;21;117;Buc;5972;125;6097
11;Île-de-France;78;1;08;118;Buchelay;3315;19;3334
11;Île-de-France;78;2;14;120;Bullion;1915;63;1978
11;Île-de-France;78;3;13;123;Carrières-sous-Poissy;17417;125;17542
11;Île-de-France;78;3;06;124;Carrières-sur-Seine;15115;220;15335
11;Île-de-France;78;2;14;125;La Celle-les-Bordes;831;31;862
11;Île-de-France;78;4;04;126;La Celle-Saint-Cloud;20496;393;20889
11;Île-de-France;78;2;14;128;Cernay-la-Ville;1546;38;1584
11;Île-de-France;78;3;16;133;Chambourcy;5646;150;5796
11;Île-de-France;78;3;05;138;Chanteloup-les-Vignes;10730;65;10795
11;Île-de-France;78;1;11;140;Chapet;1336;25;1361
11;Île-de-France;78;4;09;143;Châteaufort;1467;39;1506
11;Île-de-France;78;3;03;146;Chatou;29709;481;30190
11;Île-de-France;78;1;02;147;Chaufour-lès-Bonnières;478;7;485
11;Île-de-France;78;3;15;152;Chavenay;1743;74;1817
11;Île-de-France;78;4;04;158;Le Chesnay-Rocquencourt;31057;650;31707
11;Île-de-France;78;2;09;160;Chevreuse;5572;136;5708
11;Île-de-France;78;2;09;162;Choisel;540;26;566
11;Île-de-France;78;1;02;163;Civry-la-Forêt;344;10;354
11;Île-de-France;78;2;14;164;Clairefontaine-en-Yvelines;829;65;894
11;Île-de-France;78;4;12;165;Les Clayes-sous-Bois;17378;246;17624
11;Île-de-France;78;2;09;168;Coignières;4375;33;4408
11;Île-de-France;78;1;02;171;Condé-sur-Vesgre;1255;27;1282
11;Île-de-France;78;3;05;172;Conflans-Sainte-Honorine;35957;415;36372
11;Île-de-France;78;1;02;185;Courgent;366;11;377
11;Île-de-France;78;1;02;188;Cravent;410;6;416
11;Île-de-France;78;3;19;189;Crespières;1700;64;1764
11;Île-de-France;78;3;03;190;Croissy-sur-Seine;10324;300;10624
11;Île-de-France;78;1;02;192;Dammartin-en-Serve;1381;15;1396
11;Île-de-France;78;2;09;193;Dampierre-en-Yvelines;1012;17;1029
11;Île-de-France;78;1;02;194;Dannemarie;217;3;220
11;Île-de-France;78;3;19;196;Davron;286;14;300
11;Île-de-France;78;1;07;202;Drocourt;561;8;569
11;Île-de-France;78;1;11;206;Ecquevilly;4124;44;4168
11;Île-de-France;78;2;18;208;Élancourt;25857;260;26117
11;Île-de-France;78;2;14;209;Émancé;890;13;903
11;Île-de-France;78;1;07;217;Épône;6625;91;6716
11;Île-de-France;78;2;14;220;Les Essarts-le-Roi;6737;140;6877
11;Île-de-France;78;3;16;224;L'Étang-la-Ville;4430;183;4613
11;Île-de-France;78;1;11;227;Évecquemont;782;5;787
11;Île-de-France;78;1;07;230;La Falaise;617;8;625
11;Île-de-France;78;1;02;231;Favrieux;154;6;160
11;Île-de-France;78;3;19;233;Feucherolles;3001;89;3090
11;Île-de-France;78;1;02;234;Flacourt;186;0;186
11;Île-de-France;78;2;01;236;Flexanville;579;9;588
11;Île-de-France;78;1;02;237;Flins-Neuve-Église;155;2;157
11;Île-de-France;78;1;01;238;Flins-sur-Seine;2439;30;2469
11;Île-de-France;78;1;07;239;Follainville-Dennemont;2167;29;2196
11;Île-de-France;78;4;15;242;Fontenay-le-Fleury;13518;164;13682
11;Île-de-France;78;1;02;245;Fontenay-Mauvoisin;401;13;414
11;Île-de-France;78;1;07;246;Fontenay-Saint-Père;950;18;968
11;Île-de-France;78;1;02;255;Freneuse;4262;58;4320
11;Île-de-France;78;1;11;261;Gaillon-sur-Montcient;670;12;682
11;Île-de-France;78;2;01;262;Galluis;1246;17;1263
11;Île-de-France;78;2;01;263;Gambais;2469;64;2533
11;Île-de-France;78;2;14;264;Gambaiseuil;60;2;62
11;Île-de-France;78;2;01;265;Garancières;2447;45;2492
11;Île-de-France;78;1;07;267;Gargenville;7878;55;7933
11;Île-de-France;78;2;14;269;Gazeran;1295;30;1325
11;Île-de-France;78;1;02;276;Gommecourt;656;8;664
11;Île-de-France;78;2;01;278;Goupillières;530;12;542
11;Île-de-France;78;1;02;281;Goussonville;628;10;638
11;Île-de-France;78;1;02;283;Grandchamp;293;10;303
11;Île-de-France;78;1;02;285;Gressey;542;15;557
11;Île-de-France;78;2;01;289;Grosrouvre;892;39;931
11;Île-de-France;78;1;07;290;Guernes;1075;14;1089
11;Île-de-France;78;1;02;291;Guerville;2157;38;2195
11;Île-de-France;78;1;07;296;Guitrancourt;626;11;637
11;Île-de-France;78;4;10;297;Guyancourt;29269;491;29760
11;Île-de-France;78;1;11;299;Hardricourt;2488;20;2508
11;Île-de-France;78;1;02;300;Hargeville;444;10;454
11;Île-de-France;78;1;02;302;La Hauteville;164;5;169
11;Île-de-France;78;3;01;305;Herbeville;242;4;246
11;Île-de-France;78;2;14;307;Hermeray;942;25;967
11;Île-de-France;78;1;02;310;Houdan;3690;40;3730
11;Île-de-France;78;3;06;311;Houilles;33250;319;33569
11;Île-de-France;78;1;07;314;Issou;3913;46;3959
11;Île-de-France;78;1;07;317;Jambville;787;13;800
11;Île-de-France;78;1;02;320;Notre-Dame-de-la-Mer;704;15;719
11;Île-de-France;78;2;01;321;Jouars-Pontchartrain;5803;119;5922
11;Île-de-France;78;4;21;322;Jouy-en-Josas;7983;166;8149
11;Île-de-France;78;1;02;324;Jouy-Mauvoisin;559;3;562
11;Île-de-France;78;1;02;325;Jumeauville;607;6;613
11;Île-de-France;78;1;07;327;Juziers;3912;40;3952
11;Île-de-France;78;1;07;329;Lainville-en-Vexin;786;15;801
11;Île-de-France;78;2;09;334;Lévis-Saint-Nom;1604;33;1637
11;Île-de-France;78;1;07;335;Limay;17112;104;17216
11;Île-de-France;78;1;02;337;Limetz-Villez;1972;33;2005
11;Île-de-France;78;4;21;343;Les Loges-en-Josas;1661;66;1727
11;Île-de-France;78;1;02;344;Lommoye;652;9;661
11;Île-de-France;78;1;02;346;Longnes;1529;23;1552
11;Île-de-France;78;2;14;349;Longvilliers;505;12;517
11;Île-de-France;78;3;04;350;Louveciennes;7342;163;7505
11;Île-de-France;78;1;08;354;Magnanville;6138;131;6269
11;Île-de-France;78;2;09;356;Magny-les-Hameaux;9417;152;9569
11;Île-de-France;78;3;17;358;Maisons-Laffitte;23204;496;23700
11;Île-de-France;78;1;08;361;Mantes-la-Jolie;43945;169;44114
11;Île-de-France;78;1;08;362;Mantes-la-Ville;20844;171;21015
11;Île-de-France;78;2;01;364;Marcq;768;9;777
11;Île-de-France;78;2;01;366;Mareil-le-Guyon;397;13;410
11;Île-de-France;78;3;16;367;Mareil-Marly;3669;166;3835
11;Île-de-France;78;3;01;368;Mareil-sur-Mauldre;1705;35;1740
11;Île-de-France;78;3;03;372;Marly-le-Roi;16352;505;16857
11;Île-de-France;78;3;01;380;Maule;5949;233;6182
11;Île-de-France;78;1;02;381;Maulette;1033;15;1048
11;Île-de-France;78;3;05;382;Maurecourt;4384;51;4435
11;Île-de-France;78;2;09;383;Maurepas;18046;234;18280
11;Île-de-France;78;3;19;384;Médan;1332;43;1375
11;Île-de-France;78;1;02;385;Ménerville;214;3;217
11;Île-de-France;78;2;01;389;Méré;1658;49;1707
11;Île-de-France;78;1;02;391;Méricourt;380;7;387
11;Île-de-France;78;3;17;396;Le Mesnil-le-Roi;6304;110;6414
11;Île-de-France;78;2;09;397;Le Mesnil-Saint-Denis;6831;117;6948
11;Île-de-France;78;2;01;398;Les Mesnuls;876;23;899
11;Île-de-France;78;1;11;401;Meulan-en-Yvelines;9080;82;9162
11;Île-de-France;78;1;07;402;Mézières-sur-Seine;3776;42;3818
11;Île-de-France;78;1;11;403;Mézy-sur-Seine;2292;34;2326
11;Île-de-France;78;2;01;404;Millemont;280;4;284
11;Île-de-France;78;2;09;406;Milon-la-Chapelle;283;12;295
11;Île-de-France;78;2;14;407;Mittainville;632;15;647
11;Île-de-France;78;1;02;410;Moisson;959;15;974
11;Île-de-France;78;1;02;413;Mondreville;407;3;410
11;Île-de-France;78;3;01;415;Montainville;502;21;523
11;Île-de-France;78;1;07;416;Montalet-le-Bois;318;5;323
11;Île-de-France;78;1;02;417;Montchauvet;306;6;312
11;Île-de-France;78;3;06;418;Montesson;14811;265;15076
11;Île-de-France;78;2;01;420;Montfort-l'Amaury;2903;77;2980
11;Île-de-France;78;4;10;423;Montigny-le-Bretonneux;31854;481;32335
11;Île-de-France;78;3;19;431;Morainvilliers;3069;83;3152
11;Île-de-France;78;1;02;437;Mousseaux-sur-Seine;677;9;686
11;Île-de-France;78;1;02;439;Mulcent;108;1;109
11;Île-de-France;78;1;11;440;Les Mureaux;33543;162;33705
11;Île-de-France;78;2;01;442;Neauphle-le-Château;3384;55;3439
11;Île-de-France;78;2;01;443;Neauphle-le-Vieux;910;19;929
11;Île-de-France;78;1;02;444;Neauphlette;839;16;855
11;Île-de-France;78;1;01;451;Nézel;1054;15;1069
11;Île-de-France;78;4;19;455;Noisy-le-Roi;7692;285;7977
11;Île-de-France;78;1;07;460;Oinville-sur-Montcient;1078;17;1095
11;Île-de-France;78;2;14;464;Orcemont;1007;17;1024
11;Île-de-France;78;1;02;465;Orgerus;2467;69;2536
11;Île-de-France;78;3;19;466;Orgeval;6849;204;7053
11;Île-de-France;78;2;14;470;Orphin;882;19;901
11;Île-de-France;78;2;14;472;Orsonville;328;7;335
11;Île-de-France;78;1;02;474;Orvilliers;938;8;946
11;Île-de-France;78;1;02;475;Osmoy;400;9;409
11;Île-de-France;78;2;14;478;Paray-Douaville;224;7;231
11;Île-de-France;78;3;16;481;Le Pecq;15792;289;16081
11;Île-de-France;78;1;02;484;Perdreauville;652;17;669
11;Île-de-France;78;2;14;486;Le Perray-en-Yvelines;6571;100;6671
11;Île-de-France;78;4;12;490;Plaisir;30897;346;31243
11;Île-de-France;78;2;14;497;Poigny-la-Forêt;909;41;950
11;Île-de-France;78;3;13;498;Poissy;39731;318;40049
11;Île-de-France;78;2;14;499;Ponthévrard;685;21;706
11;Île-de-France;78;1;07;501;Porcheville;3155;58;3213
11;Île-de-France;78;3;03;502;Le Port-Marly;5454;51;5505
11;Île-de-France;78;1;02;505;Prunay-le-Temple;412;17;429
11;Île-de-France;78;2;14;506;Prunay-en-Yvelines;861;7;868
11;Île-de-France;78;2;01;513;La Queue-les-Yvelines;2346;33;2379
11;Île-de-France;78;2;14;516;Raizeux;991;13;1004
11;Île-de-France;78;2;14;517;Rambouillet;27043;491;27534
11;Île-de-France;78;4;15;518;Rennemoulin;112;4;116
11;Île-de-France;78;1;02;520;Richebourg;1565;50;1615
11;Île-de-France;78;2;14;522;Rochefort-en-Yvelines;894;38;932
11;Île-de-France;78;1;02;528;Rolleboise;367;3;370
11;Île-de-France;78;1;02;530;Rosay;377;6;383
11;Île-de-France;78;1;08;531;Rosny-sur-Seine;6906;47;6953
11;Île-de-France;78;1;07;536;Sailly;348;10;358
11;Île-de-France;78;2;14;537;Saint-Arnoult-en-Yvelines;5791;134;5925
11;Île-de-France;78;4;15;545;Saint-Cyr-l'École;20611;633;21244
11;Île-de-France;78;2;09;548;Saint-Forget;450;12;462
11;Île-de-France;78;2;01;550;Saint-Germain-de-la-Grange;1847;37;1884
11;Île-de-France;78;3;16;551;Saint-Germain-en-Laye;44410;1761;46171
11;Île-de-France;78;2;14;557;Saint-Hilarion;966;18;984
11;Île-de-France;78;1;02;558;Saint-Illiers-la-Ville;378;6;384
11;Île-de-France;78;1;02;559;Saint-Illiers-le-Bois;425;5;430
11;Île-de-France;78;2;09;561;Saint-Lambert;444;35;479
11;Île-de-France;78;2;14;562;Saint-Léger-en-Yvelines;1402;32;1434
11;Île-de-France;78;2;14;564;Saint-Martin-de-Bréthencourt;680;8;688
11;Île-de-France;78;1;02;565;Saint-Martin-des-Champs;303;9;312
11;Île-de-France;78;1;07;567;Saint-Martin-la-Garenne;929;11;940
11;Île-de-France;78;2;14;569;Sainte-Mesme;912;18;930
11;Île-de-France;78;3;19;571;Saint-Nom-la-Bretèche;4892;208;5100
11;Île-de-France;78;2;09;575;Saint-Rémy-lès-Chevreuse;7750;158;7908
11;Île-de-France;78;2;01;576;Saint-Rémy-l'Honoré;1647;24;1671
11;Île-de-France;78;3;17;586;Sartrouville;51746;412;52158
11;Île-de-France;78;2;01;588;Saulx-Marchais;961;28;989
11;Île-de-France;78;2;09;590;Senlisse;503;11;514
11;Île-de-France;78;1;02;591;Septeuil;2310;41;2351
11;Île-de-France;78;1;02;597;Soindres;698;7;705
11;Île-de-France;78;2;14;601;Sonchamp;1580;59;1639
11;Île-de-France;78;1;02;605;Tacoignières;1092;16;1108
11;Île-de-France;78;1;02;606;Le Tartre-Gaudran;36;1;37
11;Île-de-France;78;1;02;608;Le Tertre-Saint-Denis;121;1;122
11;Île-de-France;78;1;11;609;Tessancourt-sur-Aubette;1024;10;1034
11;Île-de-France;78;2;12;615;Thiverval-Grignon;1198;22;1220
11;Île-de-France;78;2;01;616;Thoiry;1428;28;1456
11;Île-de-France;78;1;02;618;Tilly;509;14;523
11;Île-de-France;78;4;09;620;Toussus-le-Noble;1164;38;1202
11;Île-de-France;78;4;18;621;Trappes;33419;108;33527
11;Île-de-France;78;2;01;623;Le Tremblay-sur-Mauldre;956;150;1106
11;Île-de-France;78;3;19;624;Triel-sur-Seine;12360;196;12556
11;Île-de-France;78;1;11;638;Vaux-sur-Seine;5020;68;5088
11;Île-de-France;78;4;21;640;Vélizy-Villacoublay;22836;184;23020
11;Île-de-France;78;3;19;642;Verneuil-sur-Seine;15959;324;16283
11;Île-de-France;78;3;19;643;Vernouillet;10266;192;10458
11;Île-de-France;78;2;18;644;La Verrière;6222;74;6296
11;Île-de-France;78;4;99;646;Versailles;83583;1891;85474
11;Île-de-France;78;1;02;647;Vert;851;13;864
11;Île-de-France;78;3;03;650;Le Vésinet;15619;489;16108
11;Île-de-France;78;2;01;653;Vicq;366;9;375
11;Île-de-France;78;2;14;655;Vieille-Église-en-Yvelines;622;26;648
11;Île-de-France;78;1;02;668;La Villeneuve-en-Chevrie;658;19;677
11;Île-de-France;78;3;19;672;Villennes-sur-Seine;5476;172;5648
11;Île-de-France;78;4;15;674;Villepreux;11044;195;11239
11;Île-de-France;78;1;02;677;Villette;526;18;544
11;Île-de-France;78;2;01;681;Villiers-le-Mahieu;840;16;856
11;Île-de-France;78;2;01;683;Villiers-Saint-Frédéric;2895;160;3055
11;Île-de-France;78;4;21;686;Viroflay;16744;345;17089
11;Île-de-France;78;2;09;688;Voisins-le-Bretonneux;10722;396;11118
75;Nouvelle-Aquitaine;79;1;04;001;L'Absie;1062;16;1078
75;Nouvelle-Aquitaine;79;3;13;002;Adilly;310;9;319
75;Nouvelle-Aquitaine;79;2;14;003;Aiffres;5359;164;5523
75;Nouvelle-Aquitaine;79;3;17;005;Airvault;3279;49;3328
75;Nouvelle-Aquitaine;79;3;06;007;Allonne;652;21;673
75;Nouvelle-Aquitaine;79;3;13;008;Amailloux;822;13;835
75;Nouvelle-Aquitaine;79;2;05;009;Amuré;434;9;443
75;Nouvelle-Aquitaine;79;2;05;010;Arçais;609;6;615
75;Nouvelle-Aquitaine;79;3;01;012;Ardin;1245;31;1276
75;Nouvelle-Aquitaine;79;1;07;013;Argentonnay;3197;86;3283
75;Nouvelle-Aquitaine;79;1;17;014;Loretz-d'Argenton;2609;48;2657
75;Nouvelle-Aquitaine;79;2;09;015;Asnières-en-Poitou;192;5;197
75;Nouvelle-Aquitaine;79;3;17;016;Assais-les-Jumeaux;770;10;780
75;Nouvelle-Aquitaine;79;2;08;018;Aubigné;171;4;175
75;Nouvelle-Aquitaine;79;3;06;019;Aubigny;163;1;164
75;Nouvelle-Aquitaine;79;2;15;020;Augé;886;19;905
75;Nouvelle-Aquitaine;79;3;17;022;Availles-Thouarsais;193;2;195
75;Nouvelle-Aquitaine;79;2;03;023;Avon;61;1;62
75;Nouvelle-Aquitaine;79;2;15;024;Azay-le-Brûlé;1995;94;2089
75;Nouvelle-Aquitaine;79;3;06;025;Azay-sur-Thouet;1113;29;1142
75;Nouvelle-Aquitaine;79;3;06;029;Beaulieu-sous-Parthenay;668;18;686
75;Nouvelle-Aquitaine;79;2;03;030;Beaussais-Vitré;968;55;1023
75;Nouvelle-Aquitaine;79;2;09;031;Beauvoir-sur-Niort;1776;33;1809
75;Nouvelle-Aquitaine;79;3;01;032;Béceleuf;780;14;794
75;Nouvelle-Aquitaine;79;2;05;034;Bessines;1774;54;1828
75;Nouvelle-Aquitaine;79;1;02;038;Boismé;1186;20;1206
75;Nouvelle-Aquitaine;79;3;06;040;La Boissière-en-Gâtine;233;2;235
75;Nouvelle-Aquitaine;79;2;03;042;Bougon;176;6;182
75;Nouvelle-Aquitaine;79;2;09;046;Le Bourdet;568;12;580
75;Nouvelle-Aquitaine;79;3;17;047;Boussais;452;9;461
75;Nouvelle-Aquitaine;79;2;15;048;La Crèche;5782;135;5917
75;Nouvelle-Aquitaine;79;1;02;049;Bressuire;19862;984;20846
75;Nouvelle-Aquitaine;79;1;04;050;Bretignolles;591;16;607
75;Nouvelle-Aquitaine;79;2;09;055;Brieuil-sur-Chizé;124;3;127
75;Nouvelle-Aquitaine;79;1;17;056;Brion-près-Thouet;740;11;751
75;Nouvelle-Aquitaine;79;2;09;057;Brioux-sur-Boutonne;1440;53;1493
75;Nouvelle-Aquitaine;79;2;14;058;Brûlain;775;17;792
75;Nouvelle-Aquitaine;79;3;01;059;Le Busseau;733;9;742
75;Nouvelle-Aquitaine;79;2;08;060;Caunay;177;3;180
75;Nouvelle-Aquitaine;79;2;03;061;Celles-sur-Belle;3881;79;3960
75;Nouvelle-Aquitaine;79;1;04;062;Cerizay;4802;72;4874
75;Nouvelle-Aquitaine;79;1;17;063;Val en Vignes;2035;119;2154
75;Nouvelle-Aquitaine;79;2;08;064;Fontivillié;823;19;842
75;Nouvelle-Aquitaine;79;3;01;066;Champdeniers;1753;38;1791
75;Nouvelle-Aquitaine;79;1;04;069;Chanteloup;1003;26;1029
75;Nouvelle-Aquitaine;79;3;01;070;La Chapelle-Bâton;406;10;416
75;Nouvelle-Aquitaine;79;3;13;071;La Chapelle-Bertrand;467;14;481
75;Nouvelle-Aquitaine;79;2;08;074;La Chapelle-Pouilloux;176;6;182
75;Nouvelle-Aquitaine;79;1;04;076;La Chapelle-Saint-Laurent;2049;26;2075
75;Nouvelle-Aquitaine;79;3;01;077;Beugnon-Thireuil;733;10;743
75;Nouvelle-Aquitaine;79;2;09;078;Plaine-d'Argenson;974;22;996
75;Nouvelle-Aquitaine;79;1;07;079;Mauléon;8623;221;8844
75;Nouvelle-Aquitaine;79;3;13;080;Châtillon-sur-Thouet;2671;53;2724
75;Nouvelle-Aquitaine;79;2;14;081;Chauray;7155;207;7362
75;Nouvelle-Aquitaine;79;2;08;083;Chef-Boutonne;2407;107;2514
75;Nouvelle-Aquitaine;79;2;03;084;Chenay;447;6;453
75;Nouvelle-Aquitaine;79;2;09;085;Chérigné;133;5;138
75;Nouvelle-Aquitaine;79;2;01;086;Cherveux;1929;46;1975
75;Nouvelle-Aquitaine;79;2;03;087;Chey;554;9;563
75;Nouvelle-Aquitaine;79;1;02;088;Chiché;1688;44;1732
75;Nouvelle-Aquitaine;79;3;17;089;Le Chillou;161;2;163
75;Nouvelle-Aquitaine;79;2;09;090;Chizé;843;21;864
75;Nouvelle-Aquitaine;79;1;04;091;Cirières;946;24;970
75;Nouvelle-Aquitaine;79;3;06;092;Clavé;361;4;365
75;Nouvelle-Aquitaine;79;1;04;094;Clessé;943;17;960
75;Nouvelle-Aquitaine;79;2;08;095;Clussais-la-Pommeraie;584;12;596
75;Nouvelle-Aquitaine;79;1;04;096;Combrand;1139;34;1173
75;Nouvelle-Aquitaine;79;2;05;100;Coulon;2266;53;2319
75;Nouvelle-Aquitaine;79;3;01;101;Coulonges-sur-l'Autize;2349;52;2401
75;Nouvelle-Aquitaine;79;1;17;102;Coulonges-Thouarsais;437;9;446
75;Nouvelle-Aquitaine;79;1;04;103;Courlay;2416;48;2464
75;Nouvelle-Aquitaine;79;3;01;104;Cours;563;13;576
75;Nouvelle-Aquitaine;79;3;06;105;Les Châteliers;465;13;478
75;Nouvelle-Aquitaine;79;2;08;106;Couture-d'Argenson;405;2;407
75;Nouvelle-Aquitaine;79;3;06;108;Doux;230;1;231
75;Nouvelle-Aquitaine;79;2;14;109;Échiré;3532;100;3632
75;Nouvelle-Aquitaine;79;2;09;111;Ensigné;289;4;293
75;Nouvelle-Aquitaine;79;2;05;112;Épannes;857;22;879
75;Nouvelle-Aquitaine;79;2;15;114;Exireuil;1571;30;1601
75;Nouvelle-Aquitaine;79;2;03;115;Exoudun;558;10;568
75;Nouvelle-Aquitaine;79;1;02;116;Faye-l'Abbesse;1119;17;1136
75;Nouvelle-Aquitaine;79;3;01;117;Faye-sur-Ardin;656;8;664
75;Nouvelle-Aquitaine;79;3;13;118;Fénery;283;6;289
75;Nouvelle-Aquitaine;79;3;01;119;Fenioux;633;13;646
75;Nouvelle-Aquitaine;79;3;06;120;La Ferrière-en-Parthenay;757;13;770
75;Nouvelle-Aquitaine;79;3;06;121;Fomperron;399;10;409
75;Nouvelle-Aquitaine;79;2;08;122;Fontenille-Saint-Martin-d'Entraigues;533;8;541
75;Nouvelle-Aquitaine;79;1;04;123;La Forêt-sur-Sèvre;2284;48;2332
75;Nouvelle-Aquitaine;79;3;06;124;Les Forges;109;5;114
75;Nouvelle-Aquitaine;79;2;05;125;Fors;1824;54;1878
75;Nouvelle-Aquitaine;79;2;09;126;Les Fosses;435;10;445
75;Nouvelle-Aquitaine;79;2;09;127;La Foye-Monjault;847;16;863
75;Nouvelle-Aquitaine;79;2;15;128;François;953;30;983
75;Nouvelle-Aquitaine;79;2;03;129;Fressines;1751;31;1782
75;Nouvelle-Aquitaine;79;2;05;130;Frontenay-Rohan-Rohan;2924;74;2998
75;Nouvelle-Aquitaine;79;1;02;131;Geay;322;7;329
75;Nouvelle-Aquitaine;79;1;07;132;Genneton;313;5;318
75;Nouvelle-Aquitaine;79;2;01;133;Germond-Rouvre;1194;24;1218
75;Nouvelle-Aquitaine;79;1;17;134;Glénay;570;14;584
75;Nouvelle-Aquitaine;79;3;06;135;Gourgé;937;15;952
75;Nouvelle-Aquitaine;79;2;08;136;Alloinay;907;17;924
75;Nouvelle-Aquitaine;79;2;05;137;Granzay-Gript;902;18;920
75;Nouvelle-Aquitaine;79;3;06;139;Les Groseillers;55;2;57
75;Nouvelle-Aquitaine;79;2;08;140;Valdelaume;818;10;828
75;Nouvelle-Aquitaine;79;3;17;141;Irais;207;4;211
75;Nouvelle-Aquitaine;79;2;09;142;Juillé;100;2;102
75;Nouvelle-Aquitaine;79;2;14;144;Juscorps;377;6;383
75;Nouvelle-Aquitaine;79;3;13;145;Lageon;367;5;372
75;Nouvelle-Aquitaine;79;1;04;147;Largeasse;731;9;740
75;Nouvelle-Aquitaine;79;2;03;148;Lezay;1977;27;2004
75;Nouvelle-Aquitaine;79;3;06;149;Lhoumois;137;2;139
75;Nouvelle-Aquitaine;79;2;08;150;Limalonges;831;14;845
75;Nouvelle-Aquitaine;79;2;08;152;Lorigné;303;5;308
75;Nouvelle-Aquitaine;79;2;08;153;Loubigné;156;3;159
75;Nouvelle-Aquitaine;79;2;08;154;Loubillé;386;7;393
75;Nouvelle-Aquitaine;79;3;17;156;Louin;685;28;713
75;Nouvelle-Aquitaine;79;1;16;157;Louzy;1300;39;1339
75;Nouvelle-Aquitaine;79;2;09;158;Luché-sur-Brioux;127;3;130
75;Nouvelle-Aquitaine;79;1;17;159;Luché-Thouarsais;528;4;532
75;Nouvelle-Aquitaine;79;2;09;160;Lusseray;167;3;170
75;Nouvelle-Aquitaine;79;1;17;161;Luzay;637;11;648
75;Nouvelle-Aquitaine;79;2;05;162;Magné;2689;63;2752
75;Nouvelle-Aquitaine;79;2;08;163;Mairé-Levescault;510;10;520
75;Nouvelle-Aquitaine;79;2;08;164;Maisonnay;258;0;258
75;Nouvelle-Aquitaine;79;3;17;165;Maisontiers;137;5;142
75;Nouvelle-Aquitaine;79;2;09;166;Marigny;885;21;906
75;Nouvelle-Aquitaine;79;1;17;167;Marnes;225;7;232
75;Nouvelle-Aquitaine;79;2;09;170;Mauzé-sur-le-Mignon;2893;53;2946
75;Nouvelle-Aquitaine;79;3;06;172;Mazières-en-Gâtine;1029;22;1051
75;Nouvelle-Aquitaine;79;2;08;174;Melle;6018;301;6319
75;Nouvelle-Aquitaine;79;2;08;175;Melleran;483;11;494
75;Nouvelle-Aquitaine;79;3;06;176;Ménigoute;862;23;885
75;Nouvelle-Aquitaine;79;2;03;177;Messé;193;4;197
75;Nouvelle-Aquitaine;79;1;04;179;Moncoutant-sur-Sèvre;5070;181;5251
75;Nouvelle-Aquitaine;79;2;08;180;Montalembert;311;3;314
75;Nouvelle-Aquitaine;79;1;04;183;Montravers;369;10;379
75;Nouvelle-Aquitaine;79;2;03;184;La Mothe-Saint-Héray;1665;23;1688
75;Nouvelle-Aquitaine;79;2;03;185;Aigondigné;4683;149;4832
75;Nouvelle-Aquitaine;79;2;15;189;Nanteuil;1701;31;1732
75;Nouvelle-Aquitaine;79;1;04;190;Neuvy-Bouin;481;2;483
75;Nouvelle-Aquitaine;79;2;99;191;Niort;58966;1879;60845
75;Nouvelle-Aquitaine;79;1;07;195;Nueil-les-Aubiers;5541;117;5658
75;Nouvelle-Aquitaine;79;1;17;196;Plaine-et-Vallées;2367;49;2416
75;Nouvelle-Aquitaine;79;3;06;197;Oroux;95;4;99
75;Nouvelle-Aquitaine;79;2;09;198;Paizay-le-Chapt;258;3;261
75;Nouvelle-Aquitaine;79;3;01;200;Pamplie;267;3;270
75;Nouvelle-Aquitaine;79;2;03;201;Pamproux;1683;18;1701
75;Nouvelle-Aquitaine;79;3;13;202;Parthenay;10108;386;10494
75;Nouvelle-Aquitaine;79;1;17;203;Pas-de-Jeu;359;8;367
75;Nouvelle-Aquitaine;79;2;09;204;Périgné;998;38;1036
75;Nouvelle-Aquitaine;79;2;08;205;Pers;74;3;77
75;Nouvelle-Aquitaine;79;1;07;207;La Petite-Boissière;633;18;651
75;Nouvelle-Aquitaine;79;3;06;208;La Peyratte;1119;29;1148
75;Nouvelle-Aquitaine;79;1;17;209;Pierrefitte;332;8;340
75;Nouvelle-Aquitaine;79;1;04;210;Le Pin;1044;23;1067
75;Nouvelle-Aquitaine;79;2;08;212;Pliboux;208;3;211
75;Nouvelle-Aquitaine;79;3;13;213;Pompaire;2013;47;2060
75;Nouvelle-Aquitaine;79;3;06;215;Pougne-Hérisson;367;7;374
75;Nouvelle-Aquitaine;79;2;14;216;Prahecq;2242;40;2282
75;Nouvelle-Aquitaine;79;2;03;217;Prailles-La Couarde;951;22;973
75;Nouvelle-Aquitaine;79;3;06;218;Pressigny;192;6;198
75;Nouvelle-Aquitaine;79;2;09;220;Prin-Deyrançon;600;11;611
75;Nouvelle-Aquitaine;79;3;01;223;Puihardy;62;2;64
75;Nouvelle-Aquitaine;79;3;06;225;Reffannes;380;6;386
75;Nouvelle-Aquitaine;79;3;06;226;Le Retail;273;5;278
75;Nouvelle-Aquitaine;79;2;09;229;La Rochénard;538;14;552
75;Nouvelle-Aquitaine;79;2;03;230;Rom;844;10;854
75;Nouvelle-Aquitaine;79;2;15;231;Romans;710;15;725
75;Nouvelle-Aquitaine;79;1;07;235;Saint-Amand-sur-Sèvre;1408;41;1449
75;Nouvelle-Aquitaine;79;1;04;236;Saint-André-sur-Sèvre;647;15;662
75;Nouvelle-Aquitaine;79;1;07;238;Saint-Aubin-du-Plain;547;15;562
75;Nouvelle-Aquitaine;79;3;06;239;Saint-Aubin-le-Cloud;1688;136;1824
75;Nouvelle-Aquitaine;79;3;01;241;Saint-Christophe-sur-Roc;571;11;582
75;Nouvelle-Aquitaine;79;1;07;242;Voulmentin;1123;20;1143
75;Nouvelle-Aquitaine;79;2;03;243;Saint-Coutant;282;0;282
75;Nouvelle-Aquitaine;79;1;17;244;Saint-Cyr-la-Lande;371;4;375
75;Nouvelle-Aquitaine;79;2;15;246;Sainte-Eanne;604;13;617
75;Nouvelle-Aquitaine;79;2;14;249;Saint-Gelais;2150;62;2212
75;Nouvelle-Aquitaine;79;1;17;250;Sainte-Gemme;405;4;409
75;Nouvelle-Aquitaine;79;2;08;251;Marcillé;737;29;766
75;Nouvelle-Aquitaine;79;1;17;252;Saint-Généroux;342;12;354
75;Nouvelle-Aquitaine;79;3;06;253;Saint-Georges-de-Noisné;692;13;705
75;Nouvelle-Aquitaine;79;2;09;254;Saint-Georges-de-Rex;445;8;453
75;Nouvelle-Aquitaine;79;3;13;255;Saint-Germain-de-Longue-Chaume;402;3;405
75;Nouvelle-Aquitaine;79;3;06;256;Saint-Germier;242;5;247
75;Nouvelle-Aquitaine;79;2;09;257;Saint-Hilaire-la-Palud;1523;22;1545
75;Nouvelle-Aquitaine;79;1;16;258;Saint-Jacques-de-Thouars;427;14;441
75;Nouvelle-Aquitaine;79;1;16;259;Saint-Jean-de-Thouars;1355;31;1386
75;Nouvelle-Aquitaine;79;3;01;263;Saint-Laurs;610;10;620
75;Nouvelle-Aquitaine;79;1;17;265;Saint-Léger-de-Montbrun;1260;23;1283
75;Nouvelle-Aquitaine;79;3;06;267;Saint-Lin;320;4;324
75;Nouvelle-Aquitaine;79;3;17;268;Saint-Loup-Lamairé;996;38;1034
75;Nouvelle-Aquitaine;79;3;01;269;Saint-Maixent-de-Beugné;419;5;424
75;Nouvelle-Aquitaine;79;2;15;270;Saint-Maixent-l'École;7243;134;7377
75;Nouvelle-Aquitaine;79;3;06;271;Saint-Marc-la-Lande;373;2;375
75;Nouvelle-Aquitaine;79;2;14;273;Saint-Martin-de-Bernegoue;802;23;825
75;Nouvelle-Aquitaine;79;1;17;274;Saint-Martin-de-Mâcon;301;4;305
75;Nouvelle-Aquitaine;79;2;15;276;Saint-Martin-de-Saint-Maixent;1072;32;1104
75;Nouvelle-Aquitaine;79;1;17;277;Saint-Martin-de-Sanzay;1069;17;1086
75;Nouvelle-Aquitaine;79;3;06;278;Saint-Martin-du-Fouilloux;243;3;246
75;Nouvelle-Aquitaine;79;1;07;280;Saint Maurice Étusson;881;15;896
75;Nouvelle-Aquitaine;79;2;01;281;Saint-Maxire;1308;36;1344
75;Nouvelle-Aquitaine;79;2;15;283;Sainte-Néomaye;1331;31;1362
75;Nouvelle-Aquitaine;79;3;01;284;Sainte-Ouenne;777;10;787
75;Nouvelle-Aquitaine;79;3;06;285;Saint-Pardoux-Soutiers;1855;41;1896
75;Nouvelle-Aquitaine;79;1;04;286;Saint-Paul-en-Gâtine;459;13;472
75;Nouvelle-Aquitaine;79;1;07;289;Saint-Pierre-des-Échaubrognes;1428;28;1456
75;Nouvelle-Aquitaine;79;3;01;290;Saint-Pompain;948;25;973
75;Nouvelle-Aquitaine;79;2;01;293;Saint-Rémy;1115;33;1148
75;Nouvelle-Aquitaine;79;2;14;294;Saint-Romans-des-Champs;167;5;172
75;Nouvelle-Aquitaine;79;2;08;295;Saint-Romans-lès-Melle;711;18;729
75;Nouvelle-Aquitaine;79;2;03;297;Sainte-Soline;350;7;357
75;Nouvelle-Aquitaine;79;2;05;298;Saint-Symphorien;1975;56;2031
75;Nouvelle-Aquitaine;79;1;17;299;Saint-Varent;2397;47;2444
75;Nouvelle-Aquitaine;79;1;16;300;Sainte-Verge;1385;30;1415
75;Nouvelle-Aquitaine;79;2;08;301;Saint-Vincent-la-Châtre;620;19;639
75;Nouvelle-Aquitaine;79;2;15;302;Saivres;1355;33;1388
75;Nouvelle-Aquitaine;79;2;03;303;Salles;326;7;333
75;Nouvelle-Aquitaine;79;2;05;304;Sansais;765;50;815
75;Nouvelle-Aquitaine;79;3;06;306;Saurais;189;2;191
75;Nouvelle-Aquitaine;79;2;08;307;Sauzé-Vaussais;1505;26;1531
75;Nouvelle-Aquitaine;79;2;01;308;Sciecq;646;9;655
75;Nouvelle-Aquitaine;79;3;01;309;Scillé;347;7;354
75;Nouvelle-Aquitaine;79;2;09;310;Secondigné-sur-Belle;498;13;511
75;Nouvelle-Aquitaine;79;3;06;311;Secondigny;1790;80;1870
75;Nouvelle-Aquitaine;79;2;09;312;Séligné;117;3;120
75;Nouvelle-Aquitaine;79;2;03;313;Sepvret;632;15;647
75;Nouvelle-Aquitaine;79;2;03;316;Soudan;431;14;445
75;Nouvelle-Aquitaine;79;2;15;319;Souvigné;862;28;890
75;Nouvelle-Aquitaine;79;3;01;320;Surin;659;12;671
75;Nouvelle-Aquitaine;79;3;13;322;Le Tallud;1989;59;2048
75;Nouvelle-Aquitaine;79;3;06;326;Thénezay;1408;27;1435
75;Nouvelle-Aquitaine;79;1;16;329;Thouars;13917;308;14225
75;Nouvelle-Aquitaine;79;1;17;331;Tourtenay;127;6;133
75;Nouvelle-Aquitaine;79;1;04;332;Trayes;122;4;126
75;Nouvelle-Aquitaine;79;2;09;334;Val-du-Mignon;1077;21;1098
75;Nouvelle-Aquitaine;79;2;05;335;Vallans;790;20;810
75;Nouvelle-Aquitaine;79;2;03;336;Vançais;229;2;231
75;Nouvelle-Aquitaine;79;2;05;337;Le Vanneau-Irleau;864;24;888
75;Nouvelle-Aquitaine;79;2;03;338;Vanzay;258;0;258
75;Nouvelle-Aquitaine;79;3;06;339;Vasles;1676;29;1705
75;Nouvelle-Aquitaine;79;3;06;340;Vausseroux;322;6;328
75;Nouvelle-Aquitaine;79;3;06;341;Vautebis;118;3;121
75;Nouvelle-Aquitaine;79;3;06;342;Vernoux-en-Gâtine;573;13;586
75;Nouvelle-Aquitaine;79;2;09;343;Vernoux-sur-Boutonne;209;2;211
75;Nouvelle-Aquitaine;79;3;06;345;Verruyes;896;23;919
75;Nouvelle-Aquitaine;79;2;09;346;Le Vert;125;5;130
75;Nouvelle-Aquitaine;79;3;13;347;Viennay;1107;21;1128
75;Nouvelle-Aquitaine;79;2;09;348;Villefollet;216;3;219
75;Nouvelle-Aquitaine;79;2;08;349;Villemain;146;2;148
75;Nouvelle-Aquitaine;79;2;09;350;Villiers-en-Bois;118;3;121
75;Nouvelle-Aquitaine;79;2;01;351;Villiers-en-Plaine;1798;31;1829
75;Nouvelle-Aquitaine;79;2;09;352;Villiers-sur-Chizé;155;6;161
75;Nouvelle-Aquitaine;79;3;06;354;Vouhé;359;10;369
75;Nouvelle-Aquitaine;79;2;14;355;Vouillé;3369;99;3468
75;Nouvelle-Aquitaine;79;3;01;357;Xaintray;237;2;239
32;Hauts-de-France;80;1;98;001;Abbeville;22895;423;23318
32;Hauts-de-France;80;4;18;002;Ablaincourt-Pressoir;267;3;270
32;Hauts-de-France;80;4;05;003;Acheux-en-Amiénois;573;11;584
32;Hauts-de-France;80;1;02;004;Acheux-en-Vimeu;502;3;505
32;Hauts-de-France;80;2;14;005;Agenville;81;2;83
32;Hauts-de-France;80;1;01;006;Agenvillers;263;4;267
32;Hauts-de-France;80;1;17;008;Aigneville;899;14;913
32;Hauts-de-France;80;1;23;009;Ailly-le-Haut-Clocher;1002;24;1026
32;Hauts-de-France;80;3;03;010;Ailly-sur-Noye;2778;39;2817
32;Hauts-de-France;80;2;04;011;Ailly-sur-Somme;2914;26;2940
32;Hauts-de-France;80;2;04;013;Airaines;2331;30;2361
32;Hauts-de-France;80;4;20;014;Aizecourt-le-Bas;57;0;57
32;Hauts-de-France;80;4;20;015;Aizecourt-le-Haut;65;2;67
32;Hauts-de-France;80;4;05;016;Albert;9814;169;9983
32;Hauts-de-France;80;4;20;017;Allaines;430;5;435
32;Hauts-de-France;80;1;16;018;Allenay;249;5;254
32;Hauts-de-France;80;1;17;019;Allery;792;14;806
32;Hauts-de-France;80;2;07;020;Allonville;774;18;792
32;Hauts-de-France;80;2;99;021;Amiens;134167;2641;136808
32;Hauts-de-France;80;2;21;022;Andainville;267;3;270
32;Hauts-de-France;80;3;22;023;Andechy;283;4;287
32;Hauts-de-France;80;2;04;024;Argœuves;546;6;552
32;Hauts-de-France;80;1;23;025;Argoules;329;3;332
32;Hauts-de-France;80;2;21;026;Arguel;30;1;31
32;Hauts-de-France;80;3;22;027;Armancourt;30;0;30
32;Hauts-de-France;80;4;05;028;Arquèves;153;1;154
32;Hauts-de-France;80;1;02;029;Arrest;828;23;851
32;Hauts-de-France;80;1;23;030;Arry;220;8;228
32;Hauts-de-France;80;3;19;031;Arvillers;773;9;782
32;Hauts-de-France;80;3;22;032;Assainvillers;114;2;116
32;Hauts-de-France;80;4;18;033;Assevillers;307;3;310
32;Hauts-de-France;80;4;18;034;Athies;596;7;603
32;Hauts-de-France;80;3;19;035;Aubercourt;77;0;77
32;Hauts-de-France;80;2;08;036;Aubigny;544;4;548
32;Hauts-de-France;80;3;03;037;Aubvillers;159;1;160
32;Hauts-de-France;80;4;05;038;Auchonvillers;136;1;137
32;Hauts-de-France;80;1;16;039;Ault;1383;16;1399
32;Hauts-de-France;80;2;21;040;Aumâtre;172;5;177
32;Hauts-de-France;80;2;21;041;Aumont;147;3;150
32;Hauts-de-France;80;2;14;042;Autheux;123;1;124
32;Hauts-de-France;80;4;05;043;Authie;265;11;276
32;Hauts-de-France;80;2;14;044;Authieule;406;6;412
32;Hauts-de-France;80;4;05;045;Authuille;161;2;163
32;Hauts-de-France;80;2;04;046;Avelesges;54;0;54
32;Hauts-de-France;80;4;05;047;Aveluy;528;5;533
32;Hauts-de-France;80;2;21;048;Avesnes-Chaussoy;64;3;67
32;Hauts-de-France;80;3;22;049;Ayencourt;155;6;161
32;Hauts-de-France;80;2;03;050;Bacouel-sur-Selle;477;10;487
32;Hauts-de-France;80;1;17;051;Bailleul;253;3;256
32;Hauts-de-France;80;2;13;052;Baizieux;222;3;225
32;Hauts-de-France;80;3;22;053;Balâtre;69;1;70
32;Hauts-de-France;80;4;20;054;Barleux;232;5;237
32;Hauts-de-France;80;2;14;055;Barly;164;1;165
32;Hauts-de-France;80;2;13;056;Bavelincourt;93;1;94
32;Hauts-de-France;80;4;05;057;Bayencourt;76;3;79
32;Hauts-de-France;80;4;19;058;Bayonvillers;330;4;334
32;Hauts-de-France;80;4;05;059;Bazentin;77;1;78
32;Hauts-de-France;80;2;14;060;Béalcourt;105;0;105
32;Hauts-de-France;80;2;21;061;Beaucamps-le-Jeune;183;3;186
32;Hauts-de-France;80;2;21;062;Beaucamps-le-Vieux;1452;18;1470
32;Hauts-de-France;80;1;17;063;Beauchamps;973;15;988
32;Hauts-de-France;80;3;19;064;Beaucourt-en-Santerre;168;3;171
32;Hauts-de-France;80;4;05;065;Beaucourt-sur-l'Ancre;88;3;91
32;Hauts-de-France;80;2;13;066;Beaucourt-sur-l'Hallue;272;6;278
32;Hauts-de-France;80;4;19;067;Beaufort-en-Santerre;191;2;193
32;Hauts-de-France;80;2;14;068;Beaumetz;220;1;221
32;Hauts-de-France;80;4;05;069;Beaumont-Hamel;204;0;204
32;Hauts-de-France;80;2;14;070;Beauquesne;1337;53;1390
32;Hauts-de-France;80;2;14;071;Beauval;2007;21;2028
32;Hauts-de-France;80;4;05;073;Bécordel-Bécourt;155;2;157
32;Hauts-de-France;80;3;22;074;Becquigny;129;1;130
32;Hauts-de-France;80;1;02;076;Béhen;524;3;527
32;Hauts-de-France;80;2;13;077;Béhencourt;317;3;320
32;Hauts-de-France;80;1;01;078;Bellancourt;517;11;528
32;Hauts-de-France;80;2;03;079;Belleuse;310;4;314
32;Hauts-de-France;80;4;18;080;Belloy-en-Santerre;148;5;153
32;Hauts-de-France;80;2;21;081;Belloy-Saint-Léonard;89;2;91
32;Hauts-de-France;80;2;04;082;Belloy-sur-Somme;735;9;744
32;Hauts-de-France;80;2;21;083;Bergicourt;138;4;142
32;Hauts-de-France;80;2;21;084;Bermesnil;209;4;213
32;Hauts-de-France;80;2;14;085;Bernâtre;37;2;39
32;Hauts-de-France;80;2;14;086;Bernaville;1054;15;1069
32;Hauts-de-France;80;1;23;087;Bernay-en-Ponthieu;240;6;246
32;Hauts-de-France;80;4;20;088;Bernes;355;2;357
32;Hauts-de-France;80;2;14;089;Berneuil;263;1;264
32;Hauts-de-France;80;4;18;090;Berny-en-Santerre;151;3;154
32;Hauts-de-France;80;2;07;092;Bertangles;747;7;754
32;Hauts-de-France;80;2;15;093;Berteaucourt-les-Dames;1074;10;1084
32;Hauts-de-France;80;3;19;094;Berteaucourt-lès-Thennes;458;7;465
32;Hauts-de-France;80;4;05;095;Bertrancourt;213;3;216
32;Hauts-de-France;80;1;16;096;Béthencourt-sur-Mer;927;17;944
32;Hauts-de-France;80;4;18;097;Béthencourt-sur-Somme;128;3;131
32;Hauts-de-France;80;2;21;098;Bettembos;107;3;110
32;Hauts-de-France;80;1;17;099;Bettencourt-Rivière;222;5;227
32;Hauts-de-France;80;2;15;100;Bettencourt-Saint-Ouen;619;4;623
32;Hauts-de-France;80;3;22;101;Beuvraignes;863;6;869
32;Hauts-de-France;80;4;20;102;Biaches;384;8;392
32;Hauts-de-France;80;3;22;103;Biarre;63;0;63
32;Hauts-de-France;80;1;17;104;Biencourt;137;3;140
32;Hauts-de-France;80;4;18;105;Billancourt;171;2;173
32;Hauts-de-France;80;2;21;106;Blangy-sous-Poix;173;3;176
32;Hauts-de-France;80;2;09;107;Blangy-Tronville;629;11;640
32;Hauts-de-France;80;2;14;108;Boisbergues;71;0;71
32;Hauts-de-France;80;1;23;109;Le Boisle;333;4;337
32;Hauts-de-France;80;1;02;110;Boismont;474;16;490
32;Hauts-de-France;80;2;13;112;Bonnay;241;1;242
32;Hauts-de-France;80;2;14;113;Bonneville;337;7;344
32;Hauts-de-France;80;2;03;114;Bosquel;341;6;347
32;Hauts-de-France;80;4;20;115;Bouchavesnes-Bergen;284;1;285
32;Hauts-de-France;80;4;19;116;Bouchoir;262;3;265
32;Hauts-de-France;80;2;15;117;Bouchon;159;5;164
32;Hauts-de-France;80;1;23;118;Boufflers;118;1;119
32;Hauts-de-France;80;2;04;119;Bougainville;409;8;417
32;Hauts-de-France;80;1;17;120;Bouillancourt-en-Séry;533;11;544
32;Hauts-de-France;80;3;22;121;Bouillancourt-la-Bataille;152;3;155
32;Hauts-de-France;80;2;14;122;Bouquemaison;490;3;493
32;Hauts-de-France;80;2;04;123;Bourdon;373;8;381
32;Hauts-de-France;80;1;16;124;Bourseville;708;14;722
32;Hauts-de-France;80;3;22;125;Boussicourt;86;0;86
32;Hauts-de-France;80;1;17;126;Bouttencourt;928;13;941
32;Hauts-de-France;80;1;17;127;Bouvaincourt-sur-Bresle;833;9;842
32;Hauts-de-France;80;4;20;128;Bouvincourt-en-Vermandois;144;3;147
32;Hauts-de-France;80;4;05;129;Bouzincourt;539;13;552
32;Hauts-de-France;80;2;04;130;Bovelles;422;6;428
32;Hauts-de-France;80;2;10;131;Boves;3335;51;3386
32;Hauts-de-France;80;3;19;132;Braches;216;3;219
32;Hauts-de-France;80;1;23;133;Brailly-Cornehotte;230;3;233
32;Hauts-de-France;80;2;03;134;Brassy;81;2;83
32;Hauts-de-France;80;1;02;135;Bray-lès-Mareuil;244;6;250
32;Hauts-de-France;80;4;05;136;Bray-sur-Somme;1247;11;1258
32;Hauts-de-France;80;2;04;137;Breilly;758;4;762
32;Hauts-de-France;80;2;13;138;Bresle;123;1;124
32;Hauts-de-France;80;4;18;139;Breuil;44;0;44
32;Hauts-de-France;80;2;14;140;Brévillers;110;2;112
32;Hauts-de-France;80;4;20;141;Brie;324;1;325
32;Hauts-de-France;80;2;04;142;Briquemesnil-Floxicourt;335;4;339
32;Hauts-de-France;80;2;21;143;Brocourt;103;1;104
32;Hauts-de-France;80;4;18;144;Brouchy;491;6;497
32;Hauts-de-France;80;1;23;145;Brucamps;139;1;140
32;Hauts-de-France;80;1;16;146;Brutelles;204;6;210
32;Hauts-de-France;80;1;23;147;Buigny-l'Abbé;333;7;340
32;Hauts-de-France;80;1;17;148;Buigny-lès-Gamaches;397;6;403
32;Hauts-de-France;80;1;01;149;Buigny-Saint-Maclou;527;11;538
32;Hauts-de-France;80;4;20;150;Buire-Courcelles;217;7;224
32;Hauts-de-France;80;4;05;151;Buire-sur-l'Ancre;304;4;308
32;Hauts-de-France;80;3;22;152;Bus-la-Mésière;147;1;148
32;Hauts-de-France;80;4;05;153;Bus-lès-Artois;133;0;133
32;Hauts-de-France;80;4;20;154;Bussu;214;7;221
32;Hauts-de-France;80;1;23;155;Bussus-Bussuel;297;5;302
32;Hauts-de-France;80;2;08;156;Bussy-lès-Daours;408;3;411
32;Hauts-de-France;80;2;21;157;Bussy-lès-Poix;94;5;99
32;Hauts-de-France;80;4;18;158;Buverchy;52;0;52
32;Hauts-de-France;80;2;09;159;Cachy;279;6;285
32;Hauts-de-France;80;2;10;160;Cagny;1208;20;1228
32;Hauts-de-France;80;1;02;161;Cahon;208;7;215
32;Hauts-de-France;80;4;19;162;Caix;701;14;715
32;Hauts-de-France;80;1;02;163;Cambron;774;12;786
32;Hauts-de-France;80;2;08;164;Camon;4441;53;4494
32;Hauts-de-France;80;2;04;165;Camps-en-Amiénois;187;3;190
32;Hauts-de-France;80;2;15;166;Canaples;703;4;707
32;Hauts-de-France;80;1;01;167;Canchy;334;11;345
32;Hauts-de-France;80;2;14;168;Candas;1086;17;1103
32;Hauts-de-France;80;2;21;169;Cannessières;64;0;64
32;Hauts-de-France;80;3;22;170;Cantigny;110;1;111
32;Hauts-de-France;80;1;01;171;Caours;598;21;619
32;Hauts-de-France;80;4;05;172;Cappy;548;5;553
32;Hauts-de-France;80;2;07;173;Cardonnette;530;7;537
32;Hauts-de-France;80;3;22;174;Le Cardonnois;76;3;79
32;Hauts-de-France;80;3;22;176;Carrépuis;267;4;271
32;Hauts-de-France;80;4;20;177;Cartigny;704;22;726
32;Hauts-de-France;80;2;21;179;Caulières;222;4;226
32;Hauts-de-France;80;2;04;180;Cavillon;100;2;102
32;Hauts-de-France;80;3;19;181;Cayeux-en-Santerre;122;0;122
32;Hauts-de-France;80;1;16;182;Cayeux-sur-Mer;2411;32;2443
32;Hauts-de-France;80;2;21;183;Cerisy-Buleux;267;5;272
32;Hauts-de-France;80;2;13;184;Cerisy;535;5;540
32;Hauts-de-France;80;3;22;185;Champien;285;10;295
32;Hauts-de-France;80;4;18;186;Chaulnes;1997;27;2024
32;Hauts-de-France;80;2;04;187;La Chaussée-Tirancourt;664;10;674
32;Hauts-de-France;80;3;03;188;Chaussoy-Epagny;589;7;596
32;Hauts-de-France;80;4;19;189;La Chavatte;72;1;73
32;Hauts-de-France;80;1;17;190;Chépy;1231;18;1249
32;Hauts-de-France;80;4;19;191;Chilly;170;5;175
32;Hauts-de-France;80;2;13;192;Chipilly;166;2;168
32;Hauts-de-France;80;3;03;193;Chirmont;145;3;148
32;Hauts-de-France;80;4;18;194;Chuignes;142;1;143
32;Hauts-de-France;80;4;05;195;Chuignolles;148;2;150
32;Hauts-de-France;80;1;17;196;Citerne;247;8;255
32;Hauts-de-France;80;4;18;197;Cizancourt;29;0;29
32;Hauts-de-France;80;2;04;198;Clairy-Saulchoix;379;3;382
32;Hauts-de-France;80;4;20;199;Cléry-sur-Somme;523;10;533
32;Hauts-de-France;80;1;23;200;Cocquerel;219;2;221
32;Hauts-de-France;80;4;05;201;Coigneux;49;2;51
32;Hauts-de-France;80;2;07;202;Coisy;378;3;381
32;Hauts-de-France;80;4;05;203;Colincamps;87;2;89
32;Hauts-de-France;80;4;20;204;Combles;739;11;750
32;Hauts-de-France;80;1;15;205;Condé-Folie;900;11;911
32;Hauts-de-France;80;4;05;206;Contalmaison;118;2;120
32;Hauts-de-France;80;2;13;207;Contay;346;4;350
32;Hauts-de-France;80;2;14;208;Conteville;222;3;225
32;Hauts-de-France;80;2;03;210;Contre;144;7;151
32;Hauts-de-France;80;2;03;211;Conty;1815;50;1865
32;Hauts-de-France;80;2;13;212;Corbie;6276;80;6356
32;Hauts-de-France;80;3;03;213;Cottenchy;573;171;744
32;Hauts-de-France;80;3;03;214;Coullemelle;314;1;315
32;Hauts-de-France;80;1;23;215;Coulonvillers;216;8;224
32;Hauts-de-France;80;4;05;216;Courcelette;154;2;156
32;Hauts-de-France;80;4;05;217;Courcelles-au-Bois;72;0;72
32;Hauts-de-France;80;2;21;218;Courcelles-sous-Moyencourt;147;3;150
32;Hauts-de-France;80;2;03;219;Courcelles-sous-Thoix;67;1;68
32;Hauts-de-France;80;3;22;220;Courtemanche;99;3;102
32;Hauts-de-France;80;1;23;221;Cramont;303;5;308
32;Hauts-de-France;80;1;23;222;Crécy-en-Ponthieu;1366;26;1392
32;Hauts-de-France;80;3;22;223;Crémery;137;0;137
32;Hauts-de-France;80;3;22;224;Cressy-Omencourt;124;1;125
32;Hauts-de-France;80;2;04;225;Creuse;193;4;197
32;Hauts-de-France;80;4;18;226;Croix-Moligneaux;269;5;274
32;Hauts-de-France;80;2;21;227;Croixrault;449;10;459
32;Hauts-de-France;80;1;23;228;Le Crotoy;1979;35;2014
32;Hauts-de-France;80;2;04;229;Crouy-Saint-Pierre;351;3;354
32;Hauts-de-France;80;4;18;230;Curchy;303;8;311
32;Hauts-de-France;80;4;05;231;Curlu;173;2;175
32;Hauts-de-France;80;3;22;232;Damery;233;5;238
32;Hauts-de-France;80;3;22;233;Dancourt-Popincourt;154;3;157
32;Hauts-de-France;80;2;08;234;Daours;773;15;788
32;Hauts-de-France;80;1;17;235;Dargnies;1184;19;1203
32;Hauts-de-France;80;3;22;236;Davenescourt;566;5;571
32;Hauts-de-France;80;3;19;237;Démuin;525;10;535
32;Hauts-de-France;80;4;05;238;Dernancourt;549;12;561
32;Hauts-de-France;80;4;20;239;Devise;55;2;57
32;Hauts-de-France;80;4;20;240;Doingt;1388;43;1431
32;Hauts-de-France;80;2;15;241;Domart-en-Ponthieu;1059;11;1070
32;Hauts-de-France;80;3;19;242;Domart-sur-la-Luce;407;9;416
32;Hauts-de-France;80;2;14;243;Domesmont;43;0;43
32;Hauts-de-France;80;1;23;244;Dominois;173;3;176
32;Hauts-de-France;80;2;14;245;Domléger-Longvillers;303;3;306
32;Hauts-de-France;80;3;03;246;Dommartin;346;5;351
32;Hauts-de-France;80;4;18;247;Dompierre-Becquincourt;718;6;724
32;Hauts-de-France;80;1;23;248;Dompierre-sur-Authie;427;7;434
32;Hauts-de-France;80;1;23;249;Domqueur;310;9;319
32;Hauts-de-France;80;1;01;250;Domvast;348;4;352
32;Hauts-de-France;80;1;17;251;Doudelainville;359;8;367
32;Hauts-de-France;80;4;18;252;Douilly;251;1;252
32;Hauts-de-France;80;2;14;253;Doullens;5870;172;6042
32;Hauts-de-France;80;2;04;256;Dreuil-lès-Amiens;1620;9;1629
32;Hauts-de-France;80;4;20;258;Driencourt;85;3;88
32;Hauts-de-France;80;2;21;259;Dromesnil;86;1;87
32;Hauts-de-France;80;1;01;260;Drucat;931;24;955
32;Hauts-de-France;80;2;11;261;Dury;1452;58;1510
32;Hauts-de-France;80;1;02;262;Eaucourt-sur-Somme;376;13;389
32;Hauts-de-France;80;3;22;263;L'Échelle-Saint-Aurin;48;2;50
32;Hauts-de-France;80;4;05;264;Éclusier-Vaux;85;33;118
32;Hauts-de-France;80;1;17;265;Embreville;563;7;570
32;Hauts-de-France;80;4;05;266;Englebelmer;311;0;311
32;Hauts-de-France;80;4;18;267;Ennemain;269;5;274
32;Hauts-de-France;80;1;02;268;Épagne-Épagnette;525;14;539
32;Hauts-de-France;80;2;21;269;Épaumesnil;112;2;114
32;Hauts-de-France;80;2;14;270;Épécamps;6;0;6
32;Hauts-de-France;80;4;20;271;Épehy;1125;15;1140
32;Hauts-de-France;80;4;18;272;Épénancourt;124;2;126
32;Hauts-de-France;80;2;21;273;Éplessier;347;5;352
32;Hauts-de-France;80;4;18;274;Eppeville;1766;25;1791
32;Hauts-de-France;80;4;20;275;Équancourt;297;2;299
32;Hauts-de-France;80;2;21;276;Équennes-Éramecourt;287;7;294
32;Hauts-de-France;80;3;22;278;Erches;189;2;191
32;Hauts-de-France;80;3;22;279;Ercheu;761;10;771
32;Hauts-de-France;80;1;02;280;Ercourt;122;2;124
32;Hauts-de-France;80;1;23;281;Ergnies;173;2;175
32;Hauts-de-France;80;1;17;282;Érondelle;513;4;517
32;Hauts-de-France;80;3;03;283;Esclainvillers;164;0;164
32;Hauts-de-France;80;4;18;284;Esmery-Hallon;730;33;763
32;Hauts-de-France;80;2;03;285;Essertaux;261;3;264
32;Hauts-de-France;80;1;02;287;Estrébœuf;239;4;243
32;Hauts-de-France;80;4;18;288;Estrées-Deniécourt;344;1;345
32;Hauts-de-France;80;1;23;290;Estrées-lès-Crécy;391;6;397
32;Hauts-de-France;80;2;03;291;Estrées-sur-Noye;268;3;271
32;Hauts-de-France;80;3;22;292;Étalon;133;6;139
32;Hauts-de-France;80;3;22;293;Ételfay;354;3;357
32;Hauts-de-France;80;4;20;294;Éterpigny;162;3;165
32;Hauts-de-France;80;4;05;295;Étinehem-Méricourt;593;10;603
32;Hauts-de-France;80;2;15;296;L'Étoile;1175;11;1186
32;Hauts-de-France;80;2;21;297;Étréjust;40;1;41
32;Hauts-de-France;80;4;20;298;Étricourt-Manancourt;528;3;531
32;Hauts-de-France;80;3;03;299;La Faloise;238;1;239
32;Hauts-de-France;80;4;18;300;Falvy;159;0;159
32;Hauts-de-France;80;2;21;301;Famechon;278;2;280
32;Hauts-de-France;80;3;22;302;Faverolles;171;3;174
32;Hauts-de-France;80;1;23;303;Favières;457;6;463
32;Hauts-de-France;80;4;18;304;Fay;98;2;100
32;Hauts-de-France;80;2;04;305;Ferrières;472;11;483
32;Hauts-de-France;80;3;22;306;Fescamps;130;5;135
32;Hauts-de-France;80;4;20;307;Feuillères;156;2;158
32;Hauts-de-France;80;1;17;308;Feuquières-en-Vimeu;2466;43;2509
32;Hauts-de-France;80;2;14;310;Fienvillers;678;3;681
32;Hauts-de-France;80;3;22;311;Fignières;150;4;154
32;Hauts-de-France;80;4;20;312;Fins;280;1;281
32;Hauts-de-France;80;4;20;313;Flaucourt;291;5;296
32;Hauts-de-France;80;4;20;314;Flers;201;3;204
32;Hauts-de-France;80;3;03;315;Flers-sur-Noye;507;10;517
32;Hauts-de-France;80;2;15;316;Flesselles;1993;24;2017
32;Hauts-de-France;80;2;03;317;Fleury;209;3;212
32;Hauts-de-France;80;2;15;318;Flixecourt;3249;75;3324
32;Hauts-de-France;80;2;04;319;Fluy;333;5;338
32;Hauts-de-France;80;4;19;320;Folies;157;1;158
32;Hauts-de-France;80;3;03;321;Folleville;141;2;143
32;Hauts-de-France;80;3;22;322;Fonches-Fonchette;171;0;171
32;Hauts-de-France;80;2;21;324;Fontaine-le-Sec;140;4;144
32;Hauts-de-France;80;4;18;325;Fontaine-lès-Cappy;52;1;53
32;Hauts-de-France;80;3;22;326;Fontaine-sous-Montdidier;105;2;107
32;Hauts-de-France;80;1;23;327;Fontaine-sur-Maye;158;4;162
32;Hauts-de-France;80;1;17;328;Fontaine-sur-Somme;518;7;525
32;Hauts-de-France;80;4;05;329;Forceville;174;2;176
32;Hauts-de-France;80;2;21;330;Forceville-en-Vimeu;237;5;242
32;Hauts-de-France;80;1;01;331;Forest-l'Abbaye;311;13;324
32;Hauts-de-France;80;1;01;332;Forest-Montiers;395;8;403
32;Hauts-de-France;80;1;23;333;Fort-Mahon-Plage;1297;14;1311
32;Hauts-de-France;80;2;03;334;Fossemanant;98;3;101
32;Hauts-de-France;80;4;18;335;Foucaucourt-en-Santerre;240;3;243
32;Hauts-de-France;80;2;21;336;Foucaucourt-Hors-Nesle;80;3;83
32;Hauts-de-France;80;3;03;337;Fouencamps;201;3;204
32;Hauts-de-France;80;2;13;338;Fouilloy;1815;17;1832
32;Hauts-de-France;80;4;19;339;Fouquescourt;152;4;156
32;Hauts-de-France;80;2;21;340;Fourcigny;200;2;202
32;Hauts-de-France;80;2;04;341;Fourdrinoy;393;7;400
32;Hauts-de-France;80;4;18;342;Framerville-Rainecourt;455;8;463
32;Hauts-de-France;80;2;21;343;Framicourt;167;2;169
32;Hauts-de-France;80;1;23;344;Francières;178;8;186
32;Hauts-de-France;80;1;02;345;Franleu;519;4;523
32;Hauts-de-France;80;2;15;346;Franqueville;164;1;165
32;Hauts-de-France;80;4;19;347;Fransart;159;2;161
32;Hauts-de-France;80;2;15;348;Fransu;183;4;187
32;Hauts-de-France;80;3;03;349;Fransures;132;2;134
32;Hauts-de-France;80;2;13;350;Franvillers;522;4;526
32;Hauts-de-France;80;2;13;351;Fréchencourt;259;2;261
32;Hauts-de-France;80;2;03;352;Frémontiers;160;1;161
32;Hauts-de-France;80;4;18;353;Fresnes-Mazancourt;157;1;158
32;Hauts-de-France;80;2;21;354;Fresnes-Tilloloy;204;3;207
32;Hauts-de-France;80;2;21;355;Fresneville;101;2;103
32;Hauts-de-France;80;2;21;356;Fresnoy-Andainville;92;9;101
32;Hauts-de-France;80;2;04;357;Fresnoy-au-Val;230;6;236
32;Hauts-de-France;80;3;19;358;Fresnoy-en-Chaussée;138;2;140
32;Hauts-de-France;80;3;22;359;Fresnoy-lès-Roye;284;9;293
32;Hauts-de-France;80;1;16;360;Fressenneville;2168;39;2207
32;Hauts-de-France;80;2;21;361;Frettecuisse;73;4;77
32;Hauts-de-France;80;1;17;362;Frettemeule;300;7;307
32;Hauts-de-France;80;1;16;364;Friaucourt;697;12;709
32;Hauts-de-France;80;2;21;365;Fricamps;183;3;186
32;Hauts-de-France;80;4;05;366;Fricourt;492;4;496
32;Hauts-de-France;80;4;05;367;Frise;178;5;183
32;Hauts-de-France;80;1;16;368;Friville-Escarbotin;4492;97;4589
32;Hauts-de-France;80;2;14;369;Frohen-sur-Authie;237;7;244
32;Hauts-de-France;80;1;23;371;Froyelles;94;4;98
32;Hauts-de-France;80;1;17;372;Frucourt;122;3;125
32;Hauts-de-France;80;1;17;373;Gamaches;2461;79;2540
32;Hauts-de-France;80;1;01;374;Gapennes;278;3;281
32;Hauts-de-France;80;2;21;375;Gauville;339;7;346
32;Hauts-de-France;80;2;09;376;Gentelles;646;6;652
32;Hauts-de-France;80;2;14;377;Gézaincourt;399;5;404
32;Hauts-de-France;80;4;20;378;Ginchy;68;1;69
32;Hauts-de-France;80;2;09;379;Glisy;838;1;839
32;Hauts-de-France;80;1;23;380;Gorenflos;238;5;243
32;Hauts-de-France;80;2;14;381;Gorges;38;1;39
32;Hauts-de-France;80;3;22;383;Goyencourt;93;0;93
32;Hauts-de-France;80;4;05;384;Grandcourt;177;1;178
32;Hauts-de-France;80;1;01;385;Grand-Laviers;465;15;480
32;Hauts-de-France;80;3;22;386;Gratibus;178;3;181
32;Hauts-de-France;80;2;03;387;Grattepanche;323;5;328
32;Hauts-de-France;80;1;02;388;Grébault-Mesnil;210;2;212
32;Hauts-de-France;80;3;03;390;Grivesnes;411;3;414
32;Hauts-de-France;80;3;22;391;Grivillers;90;0;90
32;Hauts-de-France;80;2;14;392;Grouches-Luchuel;572;14;586
32;Hauts-de-France;80;3;22;393;Gruny;311;6;317
32;Hauts-de-France;80;3;22;395;Guerbigny;275;5;280
32;Hauts-de-France;80;1;23;396;Gueschart;371;3;374
32;Hauts-de-France;80;4;20;397;Gueudecourt;92;4;96
32;Hauts-de-France;80;2;04;399;Guignemicourt;403;3;406
32;Hauts-de-France;80;4;19;400;Guillaucourt;400;5;405
32;Hauts-de-France;80;4;20;401;Guillemont;126;1;127
32;Hauts-de-France;80;2;21;402;Guizancourt;138;1;139
32;Hauts-de-France;80;3;03;403;Guyencourt-sur-Noye;176;1;177
32;Hauts-de-France;80;4;20;404;Guyencourt-Saulcourt;142;3;145
32;Hauts-de-France;80;3;19;405;Hailles;421;3;424
32;Hauts-de-France;80;1;17;406;Hallencourt;1295;15;1310
32;Hauts-de-France;80;3;03;407;Hallivillers;139;6;145
32;Hauts-de-France;80;2;15;408;Halloy-lès-Pernois;330;1;331
32;Hauts-de-France;80;4;19;409;Hallu;148;4;152
32;Hauts-de-France;80;4;18;410;Ham;4510;85;4595
32;Hauts-de-France;80;2;13;411;Le Hamel;488;6;494
32;Hauts-de-France;80;2;13;412;Hamelet;638;6;644
32;Hauts-de-France;80;4;20;413;Hancourt;89;1;90
32;Hauts-de-France;80;3;19;414;Hangard;122;3;125
32;Hauts-de-France;80;3;19;415;Hangest-en-Santerre;1010;8;1018
32;Hauts-de-France;80;2;04;416;Hangest-sur-Somme;768;9;777
32;Hauts-de-France;80;4;19;417;Harbonnières;1642;12;1654
32;Hauts-de-France;80;4;20;418;Hardecourt-aux-Bois;85;0;85
32;Hauts-de-France;80;4;05;420;Harponville;175;1;176
32;Hauts-de-France;80;3;22;421;Hattencourt;296;4;300
32;Hauts-de-France;80;1;01;422;Hautvillers-Ouville;574;10;584
32;Hauts-de-France;80;2;15;423;Havernas;377;5;382
32;Hauts-de-France;80;2;11;424;Hébécourt;540;18;558
32;Hauts-de-France;80;4;05;425;Hédauville;111;1;112
32;Hauts-de-France;80;2;13;426;Heilly;436;8;444
32;Hauts-de-France;80;2;14;427;Hem-Hardinval;379;7;386
32;Hauts-de-France;80;4;20;428;Hem-Monacu;132;2;134
32;Hauts-de-France;80;2;13;429;Hénencourt;193;1;194
32;Hauts-de-France;80;4;20;430;Herbécourt;191;7;198
32;Hauts-de-France;80;4;05;431;Hérissart;717;9;726
32;Hauts-de-France;80;4;18;432;Herleville;193;1;194
32;Hauts-de-France;80;3;22;433;Herly;43;0;43
32;Hauts-de-France;80;4;20;434;Hervilly;192;4;196
32;Hauts-de-France;80;4;20;435;Hesbécourt;57;0;57
32;Hauts-de-France;80;2;21;436;Hescamps;525;13;538
32;Hauts-de-France;80;2;21;437;Heucourt-Croquoison;109;4;113
32;Hauts-de-France;80;4;20;438;Heudicourt;508;6;514
32;Hauts-de-France;80;2;14;439;Heuzecourt;163;1;164
32;Hauts-de-France;80;2;14;440;Hiermont;152;3;155
32;Hauts-de-France;80;4;18;442;Hombleux;1158;11;1169
32;Hauts-de-France;80;2;21;443;Hornoy-le-Bourg;1679;26;1705
32;Hauts-de-France;80;1;02;444;Huchenneville;668;14;682
32;Hauts-de-France;80;2;14;445;Humbercourt;266;3;269
32;Hauts-de-France;80;1;17;446;Huppy;745;18;763
32;Hauts-de-France;80;3;19;449;Ignaucourt;65;2;67
32;Hauts-de-France;80;2;21;450;Inval-Boiron;113;2;115
32;Hauts-de-France;80;4;05;451;Irles;126;0;126
32;Hauts-de-France;80;3;03;452;Jumel;526;3;529
32;Hauts-de-France;80;3;22;453;Laboissière-en-Santerre;140;0;140
32;Hauts-de-France;80;2;21;455;Lachapelle;92;2;94
32;Hauts-de-France;80;2;21;456;Lafresguimont-Saint-Martin;555;10;565
32;Hauts-de-France;80;2;13;458;Lahoussoye;450;10;460
32;Hauts-de-France;80;2;04;459;Laleu;104;0;104
32;Hauts-de-France;80;2;21;460;Lamaronde;66;1;67
32;Hauts-de-France;80;2;08;461;Lamotte-Brebière;212;4;216
32;Hauts-de-France;80;1;01;462;Lamotte-Buleux;348;11;359
32;Hauts-de-France;80;2;13;463;Lamotte-Warfusée;706;10;716
32;Hauts-de-France;80;1;16;464;Lanchères;920;14;934
32;Hauts-de-France;80;4;18;465;Languevoisin-Quiquery;194;4;198
32;Hauts-de-France;80;2;15;466;Lanches-Saint-Hilaire;132;3;135
32;Hauts-de-France;80;3;22;467;Laucourt;190;1;191
32;Hauts-de-France;80;4;05;468;Laviéville;169;3;172
32;Hauts-de-France;80;3;03;469;Lawarde-Mauger-l'Hortoy;160;1;161
32;Hauts-de-France;80;4;05;470;Léalvillers;163;2;165
32;Hauts-de-France;80;4;20;472;Lesbœufs;168;5;173
32;Hauts-de-France;80;3;22;473;Liancourt-Fosse;292;2;294
32;Hauts-de-France;80;4;18;474;Licourt;401;3;404
32;Hauts-de-France;80;4;20;475;Liéramont;215;7;222
32;Hauts-de-France;80;1;17;476;Liercourt;359;4;363
32;Hauts-de-France;80;1;23;477;Ligescourt;221;3;224
32;Hauts-de-France;80;3;22;478;Lignières;145;2;147
32;Hauts-de-France;80;2;21;479;Lignières-Châtelain;343;5;348
32;Hauts-de-France;80;2;21;480;Lignières-en-Vimeu;113;2;115
32;Hauts-de-France;80;4;18;481;Lihons;456;5;461
32;Hauts-de-France;80;1;17;482;Limeux;140;2;142
32;Hauts-de-France;80;2;21;484;Liomer;387;5;392
32;Hauts-de-France;80;2;03;485;Ô-de-Selle;1168;10;1178
32;Hauts-de-France;80;1;23;486;Long;618;7;625
32;Hauts-de-France;80;4;20;487;Longavesnes;77;2;79
32;Hauts-de-France;80;1;17;488;Longpré-les-Corps-Saints;1550;28;1578
32;Hauts-de-France;80;2;09;489;Longueau;5815;44;5859
32;Hauts-de-France;80;4;20;490;Longueval;272;9;281
32;Hauts-de-France;80;2;14;491;Longuevillette;75;1;76
32;Hauts-de-France;80;4;05;493;Louvencourt;297;5;302
32;Hauts-de-France;80;3;03;494;Louvrechy;199;3;202
32;Hauts-de-France;80;2;14;495;Lucheux;515;4;519
32;Hauts-de-France;80;1;23;496;Machiel;152;1;153
32;Hauts-de-France;80;1;23;497;Machy;118;5;123
32;Hauts-de-France;80;4;05;498;Mailly-Maillet;643;5;648
32;Hauts-de-France;80;3;03;499;Mailly-Raineval;302;6;308
32;Hauts-de-France;80;1;17;500;Maisnières;513;8;521
32;Hauts-de-France;80;1;23;501;Maison-Ponthieu;284;4;288
32;Hauts-de-France;80;1;23;502;Maison-Roland;100;2;102
32;Hauts-de-France;80;2;14;503;Maizicourt;186;2;188
32;Hauts-de-France;80;3;22;504;Malpart;76;0;76
32;Hauts-de-France;80;4;05;505;Carnoy-Mametz;293;4;297
32;Hauts-de-France;80;2;13;507;Marcelcave;1275;19;1294
32;Hauts-de-France;80;3;22;508;Marché-Allouarde;49;0;49
32;Hauts-de-France;80;4;18;509;Marchélepot-Misery;592;6;598
32;Hauts-de-France;80;3;22;511;Marestmontiers;110;1;111
32;Hauts-de-France;80;1;02;512;Mareuil-Caubert;832;10;842
32;Hauts-de-France;80;4;05;513;Maricourt;178;3;181
32;Hauts-de-France;80;4;05;514;Marieux;132;1;133
32;Hauts-de-France;80;2;21;515;Marlers;146;2;148
32;Hauts-de-France;80;4;20;516;Marquaix;191;1;192
32;Hauts-de-France;80;3;22;517;Marquivillers;194;3;197
32;Hauts-de-France;80;1;17;518;Martainneville;427;3;430
32;Hauts-de-France;80;4;18;519;Matigny;495;7;502
32;Hauts-de-France;80;4;19;520;Maucourt;188;3;191
32;Hauts-de-France;80;4;20;521;Maurepas;215;0;215
32;Hauts-de-France;80;2;21;522;Le Mazis;107;2;109
32;Hauts-de-France;80;4;05;523;Méaulte;1262;22;1284
32;Hauts-de-France;80;4;19;524;Méharicourt;576;7;583
32;Hauts-de-France;80;2;21;525;Meigneux;179;3;182
32;Hauts-de-France;80;2;14;526;Le Meillard;153;3;156
32;Hauts-de-France;80;1;16;527;Méneslies;302;8;310
32;Hauts-de-France;80;2;21;528;Méréaucourt;9;0;9
32;Hauts-de-France;80;1;17;529;Mérélessart;192;4;196
32;Hauts-de-France;80;2;13;530;Méricourt-l'Abbé;604;4;608
32;Hauts-de-France;80;2;21;531;Méricourt-en-Vimeu;102;0;102
32;Hauts-de-France;80;1;16;533;Mers-les-Bains;2573;59;2632
32;Hauts-de-France;80;2;04;535;Le Mesge;153;5;158
32;Hauts-de-France;80;4;20;536;Mesnil-Bruntel;287;3;290
32;Hauts-de-France;80;1;23;537;Mesnil-Domqueur;88;0;88
32;Hauts-de-France;80;4;20;538;Mesnil-en-Arrouaise;117;2;119
32;Hauts-de-France;80;4;05;540;Mesnil-Martinsart;234;4;238
32;Hauts-de-France;80;3;22;541;Mesnil-Saint-Georges;200;3;203
32;Hauts-de-France;80;4;18;542;Mesnil-Saint-Nicaise;556;6;562
32;Hauts-de-France;80;2;04;543;Métigny;117;3;120
32;Hauts-de-France;80;2;14;544;Mézerolles;183;3;186
32;Hauts-de-France;80;3;19;545;Mézières-en-Santerre;540;7;547
32;Hauts-de-France;80;1;02;546;Miannay;594;11;605
32;Hauts-de-France;80;4;05;547;Millencourt;206;4;210
32;Hauts-de-France;80;1;01;548;Millencourt-en-Ponthieu;352;2;354
32;Hauts-de-France;80;4;05;549;Miraumont;649;15;664
32;Hauts-de-France;80;2;13;550;Mirvaux;127;4;131
32;Hauts-de-France;80;4;20;552;Moislains;1129;22;1151
32;Hauts-de-France;80;2;13;553;Molliens-au-Bois;333;9;342
32;Hauts-de-France;80;2;04;554;Molliens-Dreuil;961;12;973
32;Hauts-de-France;80;4;18;555;Monchy-Lagache;593;19;612
32;Hauts-de-France;80;1;02;556;Mons-Boubert;561;13;574
32;Hauts-de-France;80;4;20;557;Estrées-Mons;588;11;599
32;Hauts-de-France;80;2;03;558;Monsures;219;3;222
32;Hauts-de-France;80;2;04;559;Montagne-Fayel;142;3;145
32;Hauts-de-France;80;4;05;560;Montauban-de-Picardie;214;1;215
32;Hauts-de-France;80;3;22;561;Montdidier;6051;101;6152
32;Hauts-de-France;80;2;13;562;Montigny-sur-l'Hallue;206;2;208
32;Hauts-de-France;80;2;14;563;Montigny-les-Jongleurs;98;1;99
32;Hauts-de-France;80;2;07;565;Montonvillers;83;2;85
32;Hauts-de-France;80;2;14;566;Fieffes-Montrelet;340;7;347
32;Hauts-de-France;80;4;18;568;Morchain;345;4;349
32;Hauts-de-France;80;2;13;569;Morcourt;328;3;331
32;Hauts-de-France;80;3;19;570;Moreuil;3996;26;4022
32;Hauts-de-France;80;3;19;571;Morisel;486;10;496
32;Hauts-de-France;80;4;05;572;Morlancourt;369;2;371
32;Hauts-de-France;80;2;21;573;Morvillers-Saint-Saturnin;389;9;398
32;Hauts-de-France;80;1;23;574;Mouflers;95;1;96
32;Hauts-de-France;80;2;21;575;Mouflières;78;8;86
32;Hauts-de-France;80;4;18;576;Moyencourt;323;0;323
32;Hauts-de-France;80;2;21;577;Moyencourt-lès-Poix;177;2;179
32;Hauts-de-France;80;1;02;578;Moyenneville;718;10;728
32;Hauts-de-France;80;4;18;579;Muille-Villette;831;10;841
32;Hauts-de-France;80;1;23;580;Nampont;255;2;257
32;Hauts-de-France;80;2;03;582;Namps-Maisnil;1010;14;1024
32;Hauts-de-France;80;2;03;583;Nampty;289;7;296
32;Hauts-de-France;80;2;13;584;Naours;1072;10;1082
32;Hauts-de-France;80;4;18;585;Nesle;2314;30;2344
32;Hauts-de-France;80;2;21;586;Nesle-l'Hôpital;162;0;162
32;Hauts-de-France;80;2;21;587;Neslette;83;3;86
32;Hauts-de-France;80;1;01;588;Neufmoulin;359;8;367
32;Hauts-de-France;80;1;23;589;Neuilly-le-Dien;100;0;100
32;Hauts-de-France;80;1;01;590;Neuilly-l'Hôpital;322;12;334
32;Hauts-de-France;80;2;21;591;Neuville-au-Bois;149;2;151
32;Hauts-de-France;80;2;21;592;Neuville-Coppegueule;509;7;516
32;Hauts-de-France;80;4;05;593;La Neuville-lès-Bray;253;3;256
32;Hauts-de-France;80;3;19;595;La Neuville-Sire-Bernard;311;1;312
32;Hauts-de-France;80;2;14;596;Neuvillette;218;9;227
32;Hauts-de-France;80;1;16;597;Nibas;844;20;864
32;Hauts-de-France;80;1;01;598;Nouvion;1231;38;1269
32;Hauts-de-France;80;1;23;599;Noyelles-en-Chaussée;242;2;244
32;Hauts-de-France;80;1;01;600;Noyelles-sur-Mer;663;9;672
32;Hauts-de-France;80;4;20;601;Nurlu;365;4;369
32;Hauts-de-France;80;2;14;602;Occoches;130;3;133
32;Hauts-de-France;80;1;16;603;Ochancourt;329;4;333
32;Hauts-de-France;80;2;21;604;Offignies;83;3;86
32;Hauts-de-France;80;4;18;605;Offoy;204;2;206
32;Hauts-de-France;80;2;21;606;Oisemont;1137;46;1183
32;Hauts-de-France;80;2;04;607;Oissy;209;5;214
32;Hauts-de-France;80;1;23;609;Oneux;424;6;430
32;Hauts-de-France;80;2;03;611;Oresmaux;942;14;956
32;Hauts-de-France;80;1;16;613;Oust-Marest;618;16;634
32;Hauts-de-France;80;2;14;614;Outrebois;315;6;321
32;Hauts-de-France;80;4;05;615;Ovillers-la-Boisselle;433;3;436
32;Hauts-de-France;80;4;18;616;Pargny;196;1;197
32;Hauts-de-France;80;4;19;617;Parvillers-le-Quesnoy;233;3;236
32;Hauts-de-France;80;1;16;618;Pendé;1049;14;1063
32;Hauts-de-France;80;2;15;619;Pernois;724;8;732
32;Hauts-de-France;80;4;20;620;Péronne;7444;184;7628
32;Hauts-de-France;80;4;18;621;Hypercourt;715;11;726
32;Hauts-de-France;80;2;04;622;Picquigny;1297;14;1311
32;Hauts-de-France;80;3;22;623;Piennes-Onvillers;373;7;380
32;Hauts-de-France;80;2;13;624;Pierregot;285;5;290
32;Hauts-de-France;80;3;22;625;Trois-Rivières;1505;17;1522
32;Hauts-de-France;80;2;04;626;Pissy;291;2;293
32;Hauts-de-France;80;2;03;627;Plachy-Buyon;816;20;836
32;Hauts-de-France;80;3;19;628;Le Plessier-Rozainvillers;788;3;791
32;Hauts-de-France;80;4;20;629;Pœuilly;107;2;109
32;Hauts-de-France;80;2;21;630;Poix-de-Picardie;2332;38;2370
32;Hauts-de-France;80;1;23;631;Ponches-Estruval;98;3;101
32;Hauts-de-France;80;2;12;632;Pont-de-Metz;2375;36;2411
32;Hauts-de-France;80;1;01;633;Ponthoile;606;9;615
32;Hauts-de-France;80;2;13;634;Pont-Noyelles;814;17;831
32;Hauts-de-France;80;1;23;635;Pont-Remy;1460;18;1478
32;Hauts-de-France;80;1;01;637;Port-le-Grand;286;4;290
32;Hauts-de-France;80;4;18;638;Potte;110;6;116
32;Hauts-de-France;80;2;07;639;Poulainville;1290;22;1312
32;Hauts-de-France;80;4;05;640;Pozières;265;0;265
32;Hauts-de-France;80;2;14;642;Prouville;328;2;330
32;Hauts-de-France;80;2;03;643;Prouzel;562;6;568
32;Hauts-de-France;80;4;18;644;Proyart;739;4;743
32;Hauts-de-France;80;4;05;645;Puchevillers;556;3;559
32;Hauts-de-France;80;4;18;646;Punchy;83;1;84
32;Hauts-de-France;80;4;18;647;Puzeaux;289;3;292
32;Hauts-de-France;80;4;05;648;Pys;123;0;123
32;Hauts-de-France;80;1;23;649;Quend;1272;27;1299
32;Hauts-de-France;80;2;07;650;Querrieu;629;16;645
32;Hauts-de-France;80;2;21;651;Le Quesne;263;3;266
32;Hauts-de-France;80;3;19;652;Le Quesnel;778;9;787
32;Hauts-de-France;80;1;02;654;Quesnoy-le-Montant;535;18;553
32;Hauts-de-France;80;2;04;655;Quesnoy-sur-Airaines;421;7;428
32;Hauts-de-France;80;2;04;656;Quevauvillers;1103;8;1111
32;Hauts-de-France;80;3;03;657;Quiry-le-Sec;317;2;319
32;Hauts-de-France;80;4;18;658;Quivières;143;3;146
32;Hauts-de-France;80;4;05;659;Raincheval;271;6;277
32;Hauts-de-France;80;2;07;661;Rainneville;1035;12;1047
32;Hauts-de-France;80;1;17;662;Ramburelles;276;7;283
32;Hauts-de-France;80;2;21;663;Rambures;352;7;359
32;Hauts-de-France;80;4;20;664;Rancourt;191;3;194
32;Hauts-de-France;80;1;23;665;Regnière-Écluse;122;3;125
32;Hauts-de-France;80;2;14;666;Remaisnil;31;0;31
32;Hauts-de-France;80;3;22;667;Remaugies;133;2;135
32;Hauts-de-France;80;2;03;668;Remiencourt;170;3;173
32;Hauts-de-France;80;4;18;669;Rethonvillers;343;6;349
32;Hauts-de-France;80;2;04;670;Revelles;493;8;501
32;Hauts-de-France;80;2;15;671;Ribeaucourt;231;7;238
32;Hauts-de-France;80;2;13;672;Ribemont-sur-Ancre;633;11;644
32;Hauts-de-France;80;2;04;673;Riencourt;178;2;180
32;Hauts-de-France;80;2;08;674;Rivery;3623;33;3656
32;Hauts-de-France;80;3;03;675;Rogy;132;4;136
32;Hauts-de-France;80;3;22;676;Roiglise;153;7;160
32;Hauts-de-France;80;4;20;677;Roisel;1575;18;1593
32;Hauts-de-France;80;3;22;678;Rollot;768;19;787
32;Hauts-de-France;80;4;20;679;Ronssoy;586;5;591
32;Hauts-de-France;80;4;19;680;Rosières-en-Santerre;3005;26;3031
32;Hauts-de-France;80;3;03;681;Rouvrel;310;8;318
32;Hauts-de-France;80;4;19;682;Rouvroy-en-Santerre;213;6;219
32;Hauts-de-France;80;4;18;683;Rouy-le-Grand;102;0;102
32;Hauts-de-France;80;4;18;684;Rouy-le-Petit;108;4;112
32;Hauts-de-France;80;3;22;685;Roye;5703;55;5758
32;Hauts-de-France;80;2;13;686;Rubempré;729;9;738
32;Hauts-de-France;80;3;22;687;Rubescourt;133;2;135
32;Hauts-de-France;80;1;23;688;Rue;3115;90;3205
32;Hauts-de-France;80;2;11;690;Rumigny;644;8;652
32;Hauts-de-France;80;1;02;691;Saigneville;347;12;359
32;Hauts-de-France;80;1;01;692;Sailly-Flibeaucourt;1024;17;1041
32;Hauts-de-France;80;2;13;693;Sailly-Laurette;329;1;330
32;Hauts-de-France;80;2;13;694;Sailly-le-Sec;350;5;355
32;Hauts-de-France;80;4;20;695;Sailly-Saillisel;484;6;490
32;Hauts-de-France;80;2;11;696;Sains-en-Amiénois;1213;32;1245
32;Hauts-de-France;80;2;14;697;Saint-Acheul;34;0;34
32;Hauts-de-France;80;2;04;698;Saint-Aubin-Montenoy;218;4;222
32;Hauts-de-France;80;2;21;699;Saint-Aubin-Rivière;113;2;115
32;Hauts-de-France;80;1;16;700;Saint-Blimont;878;16;894
32;Hauts-de-France;80;4;18;701;Saint-Christ-Briost;429;10;439
32;Hauts-de-France;80;2;11;702;Saint-Fuscien;1355;28;1383
32;Hauts-de-France;80;2;21;703;Saint-Germain-sur-Bresle;210;5;215
32;Hauts-de-France;80;2;07;704;Saint-Gratien;383;5;388
32;Hauts-de-France;80;4;05;705;Saint-Léger-lès-Authie;79;1;80
32;Hauts-de-France;80;2;15;706;Saint-Léger-lès-Domart;1840;15;1855
32;Hauts-de-France;80;2;21;707;Saint-Léger-sur-Bresle;77;3;80
32;Hauts-de-France;80;3;22;708;Saint-Mard;156;1;157
32;Hauts-de-France;80;2;21;709;Saint-Maulvis;272;7;279
32;Hauts-de-France;80;1;17;710;Saint-Maxent;395;6;401
32;Hauts-de-France;80;2;15;711;Saint-Ouen;1788;14;1802
32;Hauts-de-France;80;1;23;713;Saint-Quentin-en-Tourmont;281;5;286
32;Hauts-de-France;80;1;16;714;Saint-Quentin-la-Motte-Croix-au-Bailly;1275;33;1308
32;Hauts-de-France;80;1;23;716;Saint-Riquier;1260;31;1291
32;Hauts-de-France;80;2;03;717;Saint-Sauflieu;987;6;993
32;Hauts-de-France;80;2;04;718;Saint-Sauveur;1321;16;1337
32;Hauts-de-France;80;2;21;719;Sainte-Segrée;51;5;56
32;Hauts-de-France;80;1;02;721;Saint-Valery-sur-Somme;2435;39;2474
32;Hauts-de-France;80;2;15;722;Saint-Vaast-en-Chaussée;485;7;492
32;Hauts-de-France;80;2;04;723;Saisseval;244;4;248
32;Hauts-de-France;80;2;12;724;Saleux;2787;29;2816
32;Hauts-de-France;80;2;12;725;Salouël;4011;55;4066
32;Hauts-de-France;80;4;18;726;Sancourt;265;4;269
32;Hauts-de-France;80;2;21;728;Saulchoy-sous-Poix;76;0;76
32;Hauts-de-France;80;3;03;729;Sauvillers-Mongival;182;0;182
32;Hauts-de-France;80;2;04;730;Saveuse;1067;9;1076
32;Hauts-de-France;80;2;21;732;Senarpont;627;15;642
32;Hauts-de-France;80;4;05;733;Senlis-le-Sec;313;3;316
32;Hauts-de-France;80;2;03;734;Sentelie;208;3;211
32;Hauts-de-France;80;2;04;735;Seux;167;2;169
32;Hauts-de-France;80;1;17;736;Sorel-en-Vimeu;217;5;222
32;Hauts-de-France;80;4;20;737;Sorel;161;1;162
32;Hauts-de-France;80;2;04;738;Soues;126;3;129
32;Hauts-de-France;80;3;03;740;Sourdon;349;2;351
32;Hauts-de-France;80;4;18;741;Soyécourt;191;4;195
32;Hauts-de-France;80;2;15;742;Surcamps;69;2;71
32;Hauts-de-France;80;4;05;743;Suzanne;193;4;197
32;Hauts-de-France;80;2;04;744;Tailly;56;2;58
32;Hauts-de-France;80;2;13;746;Talmas;1074;22;1096
32;Hauts-de-France;80;4;20;747;Templeux-la-Fosse;135;3;138
32;Hauts-de-France;80;4;20;748;Templeux-le-Guérard;192;3;195
32;Hauts-de-France;80;2;14;749;Terramesnil;321;4;325
32;Hauts-de-France;80;4;18;750;Tertry;145;1;146
32;Hauts-de-France;80;3;19;751;Thennes;582;6;588
32;Hauts-de-France;80;2;03;752;Thézy-Glimont;675;8;683
32;Hauts-de-France;80;4;05;753;Thiepval;124;2;126
32;Hauts-de-France;80;2;21;754;Thieulloy-l'Abbaye;394;9;403
32;Hauts-de-France;80;2;21;755;Thieulloy-la-Ville;145;1;146
32;Hauts-de-France;80;4;05;756;Thièvres;64;0;64
32;Hauts-de-France;80;2;03;757;Thoix;144;2;146
32;Hauts-de-France;80;3;03;758;Thory;208;1;209
32;Hauts-de-France;80;3;22;759;Tilloloy;346;9;355
32;Hauts-de-France;80;1;17;760;Tilloy-Floriville;370;9;379
32;Hauts-de-France;80;4;20;762;Tincourt-Boucly;343;4;347
32;Hauts-de-France;80;1;01;763;Le Titre;352;8;360
32;Hauts-de-France;80;1;02;764;Tœufles;299;7;306
32;Hauts-de-France;80;1;02;765;Tours-en-Vimeu;806;10;816
32;Hauts-de-France;80;4;05;766;Toutencourt;434;5;439
32;Hauts-de-France;80;2;21;767;Le Translay;248;5;253
32;Hauts-de-France;80;2;13;769;Treux;224;0;224
32;Hauts-de-France;80;1;16;770;Tully;540;9;549
32;Hauts-de-France;80;4;18;771;Ugny-l'Équipée;30;0;30
32;Hauts-de-France;80;2;13;773;Vadencourt;106;0;106
32;Hauts-de-France;80;2;13;774;Vaire-sous-Corbie;290;3;293
32;Hauts-de-France;80;1;16;775;Valines;626;5;631
32;Hauts-de-France;80;4;05;776;Varennes;218;1;219
32;Hauts-de-France;80;4;05;777;Vauchelles-lès-Authie;138;1;139
32;Hauts-de-France;80;2;15;778;Vauchelles-lès-Domart;125;4;129
32;Hauts-de-France;80;1;01;779;Vauchelles-les-Quesnoy;835;25;860
32;Hauts-de-France;80;1;16;780;Vaudricourt;411;5;416
32;Hauts-de-France;80;4;18;781;Vauvillers;220;5;225
32;Hauts-de-France;80;2;15;782;Vaux-en-Amiénois;424;7;431
32;Hauts-de-France;80;1;17;783;Vaux-Marquenneville;82;1;83
32;Hauts-de-France;80;2;13;784;Vaux-sur-Somme;295;2;297
32;Hauts-de-France;80;2;08;785;Vecquemont;542;9;551
32;Hauts-de-France;80;2;03;786;Velennes;146;3;149
32;Hauts-de-France;80;1;23;787;Vercourt;96;1;97
32;Hauts-de-France;80;2;21;788;Vergies;175;2;177
32;Hauts-de-France;80;4;18;789;Vermandovillers;157;0;157
32;Hauts-de-France;80;3;22;790;Verpillières;168;3;171
32;Hauts-de-France;80;2;12;791;Vers-sur-Selle;775;5;780
32;Hauts-de-France;80;2;13;792;La Vicogne;246;4;250
32;Hauts-de-France;80;2;15;793;Vignacourt;2323;36;2359
32;Hauts-de-France;80;4;18;794;Villecourt;54;0;54
32;Hauts-de-France;80;2;15;795;Ville-le-Marclet;466;42;508
32;Hauts-de-France;80;2;21;796;Villeroy;178;5;183
32;Hauts-de-France;80;3;19;797;Villers-aux-Érables;139;3;142
32;Hauts-de-France;80;2;07;798;Villers-Bocage;1435;53;1488
32;Hauts-de-France;80;2;09;799;Villers-Bretonneux;4637;56;4693
32;Hauts-de-France;80;2;21;800;Villers-Campsart;139;7;146
32;Hauts-de-France;80;4;20;801;Villers-Carbonnel;312;4;316
32;Hauts-de-France;80;4;20;802;Villers-Faucon;554;9;563
32;Hauts-de-France;80;3;22;803;Villers-lès-Roye;276;0;276
32;Hauts-de-France;80;1;23;804;Villers-sous-Ailly;181;5;186
32;Hauts-de-France;80;3;22;805;Villers-Tournelle;154;6;160
32;Hauts-de-France;80;1;23;806;Villers-sur-Authie;469;8;477
32;Hauts-de-France;80;4;05;807;Ville-sur-Ancre;261;3;264
32;Hauts-de-France;80;1;23;808;Vironchaux;501;9;510
32;Hauts-de-France;80;1;17;809;Vismes;476;11;487
32;Hauts-de-France;80;1;23;810;Vitz-sur-Authie;135;1;136
32;Hauts-de-France;80;4;18;811;Voyennes;586;7;593
32;Hauts-de-France;80;4;20;812;Vraignes-en-Vermandois;137;2;139
32;Hauts-de-France;80;2;21;813;Vraignes-lès-Hornoy;96;2;98
32;Hauts-de-France;80;4;19;814;Vrély;452;9;461
32;Hauts-de-France;80;1;23;815;Vron;834;25;859
32;Hauts-de-France;80;2;13;819;Wargnies;83;2;85
32;Hauts-de-France;80;2;13;820;Warloy-Baillon;750;14;764
32;Hauts-de-France;80;2;04;821;Warlus;221;2;223
32;Hauts-de-France;80;3;22;822;Warsy;139;2;141
32;Hauts-de-France;80;4;19;823;Warvillers;126;9;135
32;Hauts-de-France;80;4;19;824;Wiencourt-l'Équipée;264;3;267
32;Hauts-de-France;80;1;17;825;Wiry-au-Mont;112;1;113
32;Hauts-de-France;80;1;16;826;Woignarue;779;18;797
32;Hauts-de-France;80;1;16;827;Woincourt;1224;14;1238
32;Hauts-de-France;80;2;21;828;Woirel;60;1;61
32;Hauts-de-France;80;4;18;829;Y;90;2;92
32;Hauts-de-France;80;1;23;830;Yaucourt-Bussus;245;4;249
32;Hauts-de-France;80;1;23;832;Yvrench;305;4;309
32;Hauts-de-France;80;1;23;833;Yvrencheux;124;2;126
32;Hauts-de-France;80;1;16;834;Yzengremer;512;42;554
32;Hauts-de-France;80;2;04;835;Yzeux;270;0;270
32;Hauts-de-France;80;1;02;836;Yonval;226;10;236
76;Occitanie;81;2;15;001;Aguts;230;9;239
76;Occitanie;81;2;16;002;Aiguefonde;2507;57;2564
76;Occitanie;81;1;13;003;Alban;925;35;960
76;Occitanie;81;1;96;004;Albi;49094;1689;50783
76;Occitanie;81;2;17;005;Albine;515;5;520
76;Occitanie;81;2;15;006;Algans;193;2;195
76;Occitanie;81;1;23;007;Alos;97;2;99
76;Occitanie;81;1;05;008;Almayrac;296;5;301
76;Occitanie;81;1;06;009;Amarens;69;0;69
76;Occitanie;81;1;13;010;Ambialet;468;7;475
76;Occitanie;81;2;21;011;Ambres;1023;40;1063
76;Occitanie;81;1;23;012;Andillac;120;1;121
76;Occitanie;81;1;05;013;Andouque;408;8;416
76;Occitanie;81;2;14;014;Anglès;507;12;519
76;Occitanie;81;2;19;015;Appelle;74;1;75
76;Occitanie;81;2;18;016;Arfons;167;7;174
76;Occitanie;81;2;13;017;Arifat;149;2;151
76;Occitanie;81;1;22;018;Arthès;2517;52;2569
76;Occitanie;81;1;05;019;Assac;146;4;150
76;Occitanie;81;1;10;020;Aussac;268;12;280
76;Occitanie;81;2;16;021;Aussillon;5795;134;5929
76;Occitanie;81;2;15;022;Bannières;206;3;209
76;Occitanie;81;2;14;023;Barre;208;2;210
76;Occitanie;81;1;23;024;Beauvais-sur-Tescou;367;7;374
76;Occitanie;81;2;15;025;Belcastel;246;9;255
76;Occitanie;81;1;13;026;Bellegarde-Marsal;700;7;707
76;Occitanie;81;2;18;027;Belleserre;155;2;157
76;Occitanie;81;2;14;028;Berlats;101;1;102
76;Occitanie;81;1;10;029;Bernac;183;5;188
76;Occitanie;81;2;19;030;Bertre;111;1;112
76;Occitanie;81;2;14;031;Le Bez;848;17;865
76;Occitanie;81;2;19;032;Blan;1123;18;1141
76;Occitanie;81;1;06;033;Blaye-les-Mines;2925;187;3112
76;Occitanie;81;2;16;034;Boissezon;381;7;388
76;Occitanie;81;1;06;035;Bournazel;226;7;233
76;Occitanie;81;2;17;036;Bout-du-Pont-de-Larn;1272;24;1296
76;Occitanie;81;2;14;037;Brassac;1297;32;1329
76;Occitanie;81;1;11;038;Brens;2367;66;2433
76;Occitanie;81;2;12;039;Briatexte;2011;36;2047
76;Occitanie;81;2;20;040;Brousse;431;7;438
76;Occitanie;81;1;11;041;Broze;116;1;117
76;Occitanie;81;2;08;042;Burlats;2014;43;2057
76;Occitanie;81;2;12;043;Busque;728;12;740
76;Occitanie;81;2;20;044;Cabanès;312;5;317
76;Occitanie;81;1;06;045;Les Cabannes;367;9;376
76;Occitanie;81;1;10;046;Cadalen;1528;45;1573
76;Occitanie;81;1;05;047;Cadix;220;7;227
76;Occitanie;81;1;03;048;Cagnac-les-Mines;2580;31;2611
76;Occitanie;81;2;18;049;Cahuzac;357;3;360
76;Occitanie;81;2;15;050;Cambon-lès-Lavaur;347;11;358
76;Occitanie;81;1;23;051;Cahuzac-sur-Vère;1164;19;1183
76;Occitanie;81;1;22;052;Cambon;2126;57;2183
76;Occitanie;81;2;14;053;Cambounès;334;3;337
76;Occitanie;81;2;19;054;Cambounet-sur-le-Sor;943;26;969
76;Occitanie;81;2;18;055;Les Cammazes;366;4;370
76;Occitanie;81;1;23;056;Campagnac;157;3;160
76;Occitanie;81;2;20;058;Carbes;233;7;240
76;Occitanie;81;1;02;059;Carlus;663;15;678
76;Occitanie;81;1;97;060;Carmaux;9870;166;10036
76;Occitanie;81;1;10;061;Castanet;194;2;196
76;Occitanie;81;2;14;062;Fontrieu;927;20;947
76;Occitanie;81;1;03;063;Castelnau-de-Lévis;1619;35;1654
76;Occitanie;81;1;23;064;Castelnau-de-Montmiral;1046;25;1071
76;Occitanie;81;2;98;065;Castres;42394;1439;43833
76;Occitanie;81;2;16;066;Caucalières;283;6;289
76;Occitanie;81;1;10;067;Cestayrols;471;16;487
76;Occitanie;81;1;06;068;Combefa;168;4;172
76;Occitanie;81;1;06;069;Cordes-sur-Ciel;817;39;856
76;Occitanie;81;1;21;070;Coufouleux;2971;56;3027
76;Occitanie;81;1;05;071;Courris;79;3;82
76;Occitanie;81;1;05;072;Crespin;123;2;125
76;Occitanie;81;1;05;073;Crespinet;180;1;181
76;Occitanie;81;1;22;074;Cunac;1614;62;1676
76;Occitanie;81;2;20;075;Cuq;501;11;512
76;Occitanie;81;2;15;076;Cuq-Toulza;702;19;721
76;Occitanie;81;1;13;077;Curvalle;393;9;402
76;Occitanie;81;2;20;078;Damiatte;1040;15;1055
76;Occitanie;81;1;22;079;Dénat;809;33;842
76;Occitanie;81;1;06;080;Donnazac;67;2;69
76;Occitanie;81;2;18;081;Dourgne;1307;35;1342
76;Occitanie;81;1;05;082;Le Dourn;113;3;116
76;Occitanie;81;2;18;083;Durfort;244;1;245
76;Occitanie;81;2;18;084;Escoussens;621;21;642
76;Occitanie;81;2;14;085;Escroux;44;1;45
76;Occitanie;81;2;14;086;Espérausses;173;3;176
76;Occitanie;81;1;10;087;Fayssac;364;10;374
76;Occitanie;81;1;13;088;Fauch;570;10;580
76;Occitanie;81;1;05;089;Faussergues;134;5;139
76;Occitanie;81;1;10;090;Fénols;253;5;258
76;Occitanie;81;2;20;092;Fiac;926;15;941
76;Occitanie;81;1;10;093;Florentin;693;48;741
76;Occitanie;81;1;05;094;Fraissines;93;4;97
76;Occitanie;81;1;06;095;Frausseilles;84;1;85
76;Occitanie;81;1;13;096;Le Fraysse;419;5;424
76;Occitanie;81;1;22;097;Fréjairolles;1334;35;1369
76;Occitanie;81;2;20;098;Fréjeville;719;20;739
76;Occitanie;81;1;11;099;Gaillac;15245;327;15572
76;Occitanie;81;2;19;100;Garrevaques;401;10;411
76;Occitanie;81;1;04;101;Le Garric;1272;18;1290
76;Occitanie;81;2;21;102;Garrigues;287;6;293
76;Occitanie;81;2;14;103;Gijounet;135;7;142
76;Occitanie;81;2;21;104;Giroussens;1504;37;1541
76;Occitanie;81;2;12;105;Graulhet;12914;239;13153
76;Occitanie;81;1;23;106;Grazac;625;11;636
76;Occitanie;81;1;06;108;Itzac;176;1;177
76;Occitanie;81;2;20;109;Jonquières;443;7;450
76;Occitanie;81;1;05;110;Jouqueviel;98;4;102
76;Occitanie;81;1;06;111;Labarthe-Bleys;76;0;76
76;Occitanie;81;1;10;112;Labastide-de-Lévis;950;24;974
76;Occitanie;81;1;06;114;Labastide-Gabausse;521;11;532
76;Occitanie;81;2;17;115;Labastide-Rouairoux;1413;25;1438
76;Occitanie;81;2;15;116;Labastide-Saint-Georges;1944;47;1991
76;Occitanie;81;1;10;117;Labessière-Candeil;758;22;780
76;Occitanie;81;2;20;118;Laboulbène;158;4;162
76;Occitanie;81;1;13;119;Laboutarie;489;5;494
76;Occitanie;81;2;18;120;Labruguière;6510;114;6624
76;Occitanie;81;2;17;121;Lacabarède;292;0;292
76;Occitanie;81;1;05;122;Lacapelle-Pinet;77;3;80
76;Occitanie;81;1;06;123;Lacapelle-Ségalar;93;3;96
76;Occitanie;81;2;14;124;Lacaune;2466;77;2543
76;Occitanie;81;2;14;125;Lacaze;313;7;320
76;Occitanie;81;2;15;126;Lacougotte-Cadoul;183;8;191
76;Occitanie;81;2;15;127;Lacroisille;106;7;113
76;Occitanie;81;2;14;128;Lacrouzette;1573;36;1609
76;Occitanie;81;2;18;129;Lagardiolle;229;5;234
76;Occitanie;81;2;16;130;Lagarrigue;1802;36;1838
76;Occitanie;81;1;10;131;Lagrave;2247;45;2292
76;Occitanie;81;2;20;132;Guitalens-L'Albarède;835;12;847
76;Occitanie;81;1;13;133;Lamillarié;499;13;512
76;Occitanie;81;2;14;134;Lamontélarié;57;0;57
76;Occitanie;81;1;06;135;Laparrouquial;95;0;95
76;Occitanie;81;1;23;136;Larroque;149;3;152
76;Occitanie;81;2;14;137;Lasfaillades;87;1;88
76;Occitanie;81;1;10;138;Lasgraisses;558;9;567
76;Occitanie;81;2;20;139;Lautrec;1706;50;1756
76;Occitanie;81;2;15;140;Lavaur;10820;394;11214
76;Occitanie;81;1;05;141;Lédas-et-Penthiès;154;6;160
76;Occitanie;81;2;19;142;Lempaut;894;14;908
76;Occitanie;81;2;19;143;Lescout;757;13;770
76;Occitanie;81;1;04;144;Lescure-d'Albigeois;4577;93;4670
76;Occitanie;81;1;23;145;Lisle-sur-Tarn;4693;83;4776
76;Occitanie;81;1;06;146;Livers-Cazelles;237;5;242
76;Occitanie;81;1;13;147;Lombers;1122;29;1151
76;Occitanie;81;1;06;148;Loubers;81;1;82
76;Occitanie;81;1;21;149;Loupiac;427;15;442
76;Occitanie;81;2;21;150;Lugan;427;13;440
76;Occitanie;81;2;20;151;Magrin;127;6;133
76;Occitanie;81;1;03;152;Mailhoc;320;3;323
76;Occitanie;81;1;06;154;Marnaves;78;1;79
76;Occitanie;81;1;03;156;Marssac-sur-Tarn;3439;83;3522
76;Occitanie;81;2;15;157;Marzens;312;11;323
76;Occitanie;81;2;14;158;Le Masnau-Massuguiès;259;6;265
76;Occitanie;81;2;15;159;Massac-Séran;432;19;451
76;Occitanie;81;2;18;160;Massaguel;355;8;363
76;Occitanie;81;1;13;161;Massals;112;1;113
76;Occitanie;81;2;15;162;Maurens-Scopont;149;2;151
76;Occitanie;81;2;99;163;Mazamet;9953;408;10361
76;Occitanie;81;1;23;164;Mézens;516;10;526
76;Occitanie;81;1;06;165;Milhars;242;3;245
76;Occitanie;81;1;03;166;Milhavet;94;3;97
76;Occitanie;81;1;13;167;Miolles;106;0;106
76;Occitanie;81;1;05;168;Mirandol-Bourgnounac;1041;17;1058
76;Occitanie;81;2;12;169;Missècle;99;1;100
76;Occitanie;81;1;06;170;Monestiés;1368;21;1389
76;Occitanie;81;1;10;171;Montans;1534;32;1566
76;Occitanie;81;1;05;172;Montauriol;60;0;60
76;Occitanie;81;2;15;173;Montcabrier;324;7;331
76;Occitanie;81;2;20;174;Montdragon;620;10;630
76;Occitanie;81;1;23;175;Montdurausse;425;5;430
76;Occitanie;81;1;23;176;Montels;104;5;109
76;Occitanie;81;2;08;177;Montfa;484;17;501
76;Occitanie;81;1;23;178;Montgaillard;359;13;372
76;Occitanie;81;2;15;179;Montgey;278;8;286
76;Occitanie;81;1;06;180;Montirat;255;3;258
76;Occitanie;81;2;20;181;Montpinier;189;3;192
76;Occitanie;81;2;13;182;Montredon-Labessonnié;2018;42;2060
76;Occitanie;81;2;13;183;Mont-Roc;187;7;194
76;Occitanie;81;1;06;184;Montrosier;35;0;35
76;Occitanie;81;1;23;185;Montvalen;239;4;243
76;Occitanie;81;1;05;186;Moularès;257;4;261
76;Occitanie;81;2;12;187;Moulayrès;214;3;217
76;Occitanie;81;2;14;188;Moulin-Mage;316;3;319
76;Occitanie;81;2;15;189;Mouzens;128;2;130
76;Occitanie;81;1;13;190;Mouzieys-Teulet;548;10;558
76;Occitanie;81;1;06;191;Mouzieys-Panens;234;1;235
76;Occitanie;81;2;14;192;Murat-sur-Vèbre;867;12;879
76;Occitanie;81;2;14;193;Nages;338;4;342
76;Occitanie;81;2;09;195;Navès;689;23;712
76;Occitanie;81;2;16;196;Noailhac;851;21;872
76;Occitanie;81;1;06;197;Noailles;212;4;216
76;Occitanie;81;1;13;198;Orban;330;4;334
76;Occitanie;81;1;05;199;Padiès;178;3;181
76;Occitanie;81;2;19;200;Palleville;440;53;493
76;Occitanie;81;1;05;201;Pampelonne;880;20;900
76;Occitanie;81;1;10;202;Parisot;963;19;982
76;Occitanie;81;1;13;203;Paulinet;541;14;555
76;Occitanie;81;2;16;204;Payrin-Augmontel;2181;38;2219
76;Occitanie;81;2;15;205;Péchaudier;190;6;196
76;Occitanie;81;1;06;206;Penne;587;18;605
76;Occitanie;81;2;20;207;Peyregoux;79;29;108
76;Occitanie;81;1;10;208;Peyrole;582;16;598
76;Occitanie;81;2;17;209;Pont-de-Larn;2781;78;2859
76;Occitanie;81;2;19;210;Poudis;264;7;271
76;Occitanie;81;1;13;211;Poulan-Pouzols;494;10;504
76;Occitanie;81;2;20;212;Prades;123;4;127
76;Occitanie;81;2;20;213;Pratviel;91;2;93
76;Occitanie;81;2;15;214;Puéchoursi;100;1;101
76;Occitanie;81;2;12;215;Puybegon;644;10;654
76;Occitanie;81;2;20;216;Puycalvel;210;3;213
76;Occitanie;81;1;23;217;Puycelsi;452;11;463
76;Occitanie;81;1;02;218;Puygouzon;3534;82;3616
76;Occitanie;81;2;19;219;Puylaurens;3194;72;3266
76;Occitanie;81;1;23;220;Rabastens;5748;147;5895
76;Occitanie;81;2;13;221;Rayssac;234;1;235
76;Occitanie;81;1;13;222;Réalmont;3501;57;3558
76;Occitanie;81;2;17;223;Le Rialet;57;1;58
76;Occitanie;81;1;06;224;Le Riols;100;1;101
76;Occitanie;81;1;10;225;Rivières;1072;30;1102
76;Occitanie;81;2;08;227;Roquecourbe;2185;40;2225
76;Occitanie;81;1;23;228;Roquemaure;468;10;478
76;Occitanie;81;2;15;229;Roquevidal;130;4;134
76;Occitanie;81;1;05;230;Rosières;725;13;738
76;Occitanie;81;2;17;231;Rouairoux;383;7;390
76;Occitanie;81;1;02;232;Rouffiac;626;14;640
76;Occitanie;81;1;13;233;Terre-de-Bancalié;1730;28;1758
76;Occitanie;81;1;06;234;Roussayrolles;87;3;90
76;Occitanie;81;2;18;235;Saint-Affrique-les-Montagnes;733;16;749
76;Occitanie;81;2;21;236;Saint-Agnan;276;9;285
76;Occitanie;81;2;18;237;Saint-Amancet;185;3;188
76;Occitanie;81;2;17;238;Saint-Amans-Soult;1514;123;1637
76;Occitanie;81;2;17;239;Saint-Amans-Valtoret;865;12;877
76;Occitanie;81;1;13;240;Saint-André;102;4;106
76;Occitanie;81;2;18;242;Saint-Avit;266;1;267
76;Occitanie;81;1;23;243;Saint-Beauzile;132;2;134
76;Occitanie;81;1;06;244;Saint-Benoît-de-Carmaux;2058;32;2090
76;Occitanie;81;1;06;245;Saint-Christophe;122;6;128
76;Occitanie;81;1;23;246;Sainte-Cécile-du-Cayrou;109;2;111
76;Occitanie;81;1;05;247;Saint-Cirgue;208;3;211
76;Occitanie;81;2;12;248;Saint-Gauzens;899;20;919
76;Occitanie;81;1;05;249;Sainte-Gemme;899;17;916
76;Occitanie;81;2;20;250;Saint-Genest-de-Contest;281;8;289
76;Occitanie;81;2;19;251;Saint-Germain-des-Prés;928;28;956
76;Occitanie;81;2;08;252;Saint-Germier;147;1;148
76;Occitanie;81;1;05;253;Saint-Grégoire;456;7;463
76;Occitanie;81;1;05;254;Saint-Jean-de-Marcel;380;4;384
76;Occitanie;81;2;21;255;Saint-Jean-de-Rives;525;14;539
76;Occitanie;81;2;08;256;Saint-Jean-de-Vals;79;4;83
76;Occitanie;81;1;22;257;Saint-Juéry;6627;105;6732
76;Occitanie;81;2;20;258;Saint-Julien-du-Puy;443;13;456
76;Occitanie;81;1;05;259;Saint-Julien-Gaulène;224;1;225
76;Occitanie;81;2;21;261;Saint-Lieux-lès-Lavaur;1157;19;1176
76;Occitanie;81;1;06;262;Saint-Marcel-Campes;211;2;213
76;Occitanie;81;1;06;263;Saint-Martin-Laguépie;391;10;401
76;Occitanie;81;1;05;264;Saint-Michel-Labadié;89;2;91
76;Occitanie;81;1;06;265;Saint-Michel-de-Vax;79;1;80
76;Occitanie;81;2;20;266;Saint-Paul-Cap-de-Joux;1067;28;1095
76;Occitanie;81;2;14;267;Saint-Pierre-de-Trivisy;614;11;625
76;Occitanie;81;2;14;268;Saint-Salvi-de-Carcavès;72;4;76
76;Occitanie;81;2;08;269;Saint-Salvy-de-la-Balme;507;6;513
76;Occitanie;81;2;19;270;Saint-Sernin-lès-Lavaur;168;3;171
76;Occitanie;81;2;21;271;Saint-Sulpice-la-Pointe;9480;271;9751
76;Occitanie;81;1;23;272;Saint-Urcisse;219;1;220
76;Occitanie;81;2;19;273;Saïx;3630;73;3703
76;Occitanie;81;1;02;274;Saliès;832;18;850
76;Occitanie;81;1;06;275;Salles;194;2;196
76;Occitanie;81;1;23;276;Salvagnac;1242;19;1261
76;Occitanie;81;1;05;277;Saussenac;611;10;621
76;Occitanie;81;2;17;278;Sauveterre;169;2;171
76;Occitanie;81;1;23;279;La Sauzière-Saint-Jean;260;9;269
76;Occitanie;81;1;06;280;Le Ségur;261;7;268
76;Occitanie;81;2;20;281;Sémalens;2006;54;2060
76;Occitanie;81;2;14;282;Senaux;34;0;34
76;Occitanie;81;1;10;283;Senouillac;1123;34;1157
76;Occitanie;81;1;02;284;Le Sequestre;1951;30;1981
76;Occitanie;81;1;05;285;Sérénac;491;3;494
76;Occitanie;81;2;20;286;Serviès;599;20;619
76;Occitanie;81;1;13;287;Sieurac;271;2;273
76;Occitanie;81;2;18;288;Sorèze;2938;65;3003
76;Occitanie;81;2;19;289;Soual;2627;38;2665
76;Occitanie;81;1;06;290;Souel;166;1;167
76;Occitanie;81;1;06;291;Taïx;506;6;512
76;Occitanie;81;1;05;292;Tanus;539;19;558
76;Occitanie;81;1;23;293;Tauriac;363;3;366
76;Occitanie;81;1;10;294;Técou;1034;28;1062
76;Occitanie;81;1;13;295;Teillet;438;6;444
76;Occitanie;81;1;03;297;Terssac;1220;31;1251
76;Occitanie;81;2;15;298;Teulat;476;13;489
76;Occitanie;81;2;20;299;Teyssode;378;16;394
76;Occitanie;81;1;06;300;Tonnac;98;2;100
76;Occitanie;81;1;05;302;Tréban;56;1;57
76;Occitanie;81;1;05;303;Trébas;411;4;415
76;Occitanie;81;1;06;304;Trévien;190;3;193
76;Occitanie;81;2;14;305;Vabre;731;18;749
76;Occitanie;81;1;05;306;Valderiès;834;23;857
76;Occitanie;81;2;16;307;Valdurenque;862;18;880
76;Occitanie;81;1;05;308;Valence-d'Albigeois;1295;28;1323
76;Occitanie;81;1;06;309;Vaour;296;15;311
76;Occitanie;81;2;15;310;Veilhes;157;2;159
76;Occitanie;81;2;20;311;Vénès;732;19;751
76;Occitanie;81;2;18;312;Verdalle;1015;171;1186
76;Occitanie;81;1;23;313;Le Verdier;227;7;234
76;Occitanie;81;2;14;314;Viane;533;38;571
76;Occitanie;81;2;20;315;Vielmur-sur-Agout;1401;47;1448
76;Occitanie;81;1;23;316;Vieux;227;3;230
76;Occitanie;81;1;13;317;Villefranche-d'Albigeois;1244;20;1264
76;Occitanie;81;2;15;318;Villeneuve-lès-Lavaur;142;2;144
76;Occitanie;81;1;03;319;Villeneuve-sur-Vère;515;14;529
76;Occitanie;81;1;06;320;Vindrac-Alayrac;147;4;151
76;Occitanie;81;2;17;321;Le Vintrou;91;1;92
76;Occitanie;81;1;06;322;Virac;251;6;257
76;Occitanie;81;2;20;323;Viterbe;360;6;366
76;Occitanie;81;2;15;324;Viviers-lès-Lavaur;239;5;244
76;Occitanie;81;2;19;325;Viviers-lès-Montagnes;1976;50;2026
76;Occitanie;81;1;03;326;Sainte-Croix;399;9;408
76;Occitanie;82;1;09;001;Albefeuille-Lagarde;614;12;626
76;Occitanie;82;2;11;002;Albias;3337;58;3395
76;Occitanie;82;1;02;003;Angeville;246;6;252
76;Occitanie;82;1;04;004;Asques;136;0;136
76;Occitanie;82;2;15;005;Aucamville;1531;19;1550
76;Occitanie;82;1;02;006;Auterive;78;2;80
76;Occitanie;82;2;11;007;Auty;146;1;147
76;Occitanie;82;1;04;008;Auvillar;910;41;951
76;Occitanie;82;1;04;009;Balignac;39;2;41
76;Occitanie;82;1;04;010;Bardigues;242;5;247
76;Occitanie;82;1;03;011;Barry-d'Islemade;936;20;956
76;Occitanie;82;1;03;012;Les Barthes;571;8;579
76;Occitanie;82;1;02;013;Beaumont-de-Lomagne;3778;173;3951
76;Occitanie;82;2;15;014;Beaupuy;262;8;270
76;Occitanie;82;1;02;015;Belbèze-en-Lomagne;160;4;164
76;Occitanie;82;1;10;016;Belvèze;217;2;219
76;Occitanie;82;2;09;017;Bessens;1478;25;1503
76;Occitanie;82;2;01;018;Bioule;1164;28;1192
76;Occitanie;82;1;14;019;Boudou;750;18;768
76;Occitanie;82;2;15;020;Bouillac;588;13;601
76;Occitanie;82;1;10;021;Bouloc-en-Quercy;192;3;195
76;Occitanie;82;1;14;022;Bourg-de-Visa;380;9;389
76;Occitanie;82;2;02;023;Bourret;981;11;992
76;Occitanie;82;1;14;024;Brassac;249;3;252
76;Occitanie;82;2;09;025;Bressols;3700;104;3804
76;Occitanie;82;2;13;026;Bruniquel;614;11;625
76;Occitanie;82;2;15;027;Campsas;1429;23;1452
76;Occitanie;82;2;15;028;Canals;806;11;817
76;Occitanie;82;2;12;029;Castanet;277;3;280
76;Occitanie;82;1;02;030;Castelferrus;491;11;502
76;Occitanie;82;1;04;031;Castelmayran;1212;17;1229
76;Occitanie;82;1;14;032;Castelsagrat;540;13;553
76;Occitanie;82;1;03;033;Castelsarrasin;14131;273;14404
76;Occitanie;82;1;04;034;Castéra-Bouzet;107;3;110
76;Occitanie;82;1;04;035;Caumont;344;9;353
76;Occitanie;82;1;02;036;Le Causé;134;5;139
76;Occitanie;82;2;01;037;Caussade;6819;203;7022
76;Occitanie;82;2;12;038;Caylus;1489;30;1519
76;Occitanie;82;2;11;039;Cayrac;563;22;585
76;Occitanie;82;2;12;040;Cayriech;280;9;289
76;Occitanie;82;2;12;041;Cazals;236;3;239
76;Occitanie;82;1;10;042;Cazes-Mondenard;1203;16;1219
76;Occitanie;82;2;02;043;Comberouger;269;2;271
76;Occitanie;82;2;13;044;Corbarieu;1697;53;1750
76;Occitanie;82;1;02;045;Cordes-Tolosannes;357;6;363
76;Occitanie;82;1;02;046;Coutures;115;0;115
76;Occitanie;82;1;02;047;Cumont;51;0;51
76;Occitanie;82;2;15;048;Dieupentale;1625;14;1639
76;Occitanie;82;1;04;049;Donzac;1032;11;1043
76;Occitanie;82;1;04;050;Dunes;1200;23;1223
76;Occitanie;82;1;10;051;Durfort-Lacapelette;841;90;931
76;Occitanie;82;2;02;052;Escatalens;1115;106;1221
76;Occitanie;82;1;02;053;Escazeaux;287;3;290
76;Occitanie;82;1;14;054;Espalais;386;7;393
76;Occitanie;82;1;02;055;Esparsac;256;8;264
76;Occitanie;82;2;12;056;Espinas;185;3;188
76;Occitanie;82;2;15;057;Fabas;668;15;683
76;Occitanie;82;1;02;058;Fajolles;101;2;103
76;Occitanie;82;1;02;059;Faudoas;291;10;301
76;Occitanie;82;1;10;060;Fauroux;190;4;194
76;Occitanie;82;2;12;061;Féneyrols;139;2;141
76;Occitanie;82;2;09;062;Finhan;1522;22;1544
76;Occitanie;82;1;02;063;Garganvillar;681;15;696
76;Occitanie;82;1;02;064;Gariès;125;0;125
76;Occitanie;82;1;14;065;Gasques;407;10;417
76;Occitanie;82;2;13;066;Génébrières;609;13;622
76;Occitanie;82;1;04;067;Gensac;106;1;107
76;Occitanie;82;1;02;068;Gimat;243;6;249
76;Occitanie;82;2;12;069;Ginals;200;6;206
76;Occitanie;82;1;02;070;Glatens;71;2;73
76;Occitanie;82;1;02;071;Goas;37;2;39
76;Occitanie;82;1;14;072;Golfech;1013;12;1025
76;Occitanie;82;1;14;073;Goudourville;948;23;971
76;Occitanie;82;1;04;074;Gramont;131;5;136
76;Occitanie;82;2;15;075;Grisolles;4187;81;4268
76;Occitanie;82;2;11;076;L'Honor-de-Cos;1600;32;1632
76;Occitanie;82;2;10;077;Labarthe;400;6;406
76;Occitanie;82;2;12;078;Labastide-de-Penne;128;0;128
76;Occitanie;82;2;13;079;Labastide-Saint-Pierre;3803;78;3881
76;Occitanie;82;1;03;080;Labastide-du-Temple;1148;27;1175
76;Occitanie;82;1;02;081;Labourgade;183;3;186
76;Occitanie;82;2;12;082;Lacapelle-Livron;195;6;201
76;Occitanie;82;1;04;083;Lachapelle;118;1;119
76;Occitanie;82;1;10;084;Lacour;169;2;171
76;Occitanie;82;2;09;085;Lacourt-Saint-Pierre;1261;11;1272
76;Occitanie;82;1;02;086;Lafitte;225;3;228
76;Occitanie;82;2;10;087;Lafrançaise;2843;61;2904
76;Occitanie;82;2;12;088;Laguépie;620;6;626
76;Occitanie;82;1;14;089;Lamagistère;1182;20;1202
76;Occitanie;82;2;11;090;Lamothe-Capdeville;1054;28;1082
76;Occitanie;82;1;02;091;Lamothe-Cumont;125;3;128
76;Occitanie;82;2;12;092;Lapenche;289;4;293
76;Occitanie;82;1;02;093;Larrazet;702;8;710
76;Occitanie;82;1;10;094;Lauzerte;1453;18;1471
76;Occitanie;82;2;12;095;Lavaurette;217;13;230
76;Occitanie;82;2;03;096;La Ville-Dieu-du-Temple;3140;48;3188
76;Occitanie;82;1;04;097;Lavit;1625;18;1643
76;Occitanie;82;2;13;098;Léojac;1262;29;1291
76;Occitanie;82;1;05;099;Lizac;539;8;547
76;Occitanie;82;2;12;100;Loze;126;7;133
76;Occitanie;82;1;04;101;Malause;1219;17;1236
76;Occitanie;82;1;04;102;Mansonville;302;4;306
76;Occitanie;82;1;02;103;Marignac;105;6;111
76;Occitanie;82;1;04;104;Marsac;183;6;189
76;Occitanie;82;2;15;105;Mas-Grenier;1344;20;1364
76;Occitanie;82;1;02;106;Maubec;137;1;138
76;Occitanie;82;1;04;107;Maumusson;48;2;50
76;Occitanie;82;1;03;108;Meauzac;1385;30;1415
76;Occitanie;82;1;04;109;Merles;204;13;217
76;Occitanie;82;2;11;110;Mirabel;1036;18;1054
76;Occitanie;82;1;10;111;Miramont-de-Quercy;313;6;319
76;Occitanie;82;1;05;112;Moissac;13738;336;14074
76;Occitanie;82;2;11;113;Molières;1215;14;1229
76;Occitanie;82;2;09;114;Monbéqui;647;6;653
76;Occitanie;82;2;13;115;Monclar-de-Quercy;2014;37;2051
76;Occitanie;82;1;10;116;Montagudet;193;4;197
76;Occitanie;82;1;10;117;Montaigu-de-Quercy;1300;24;1324
76;Occitanie;82;1;02;118;Montaïn;97;1;98
76;Occitanie;82;2;11;119;Montalzat;657;18;675
76;Occitanie;82;2;11;120;Montastruc;292;5;297
76;Occitanie;82;2;99;121;Montauban;61677;1481;63158
76;Occitanie;82;1;10;122;Montbarla;186;3;189
76;Occitanie;82;2;09;123;Montbartier;1558;18;1576
76;Occitanie;82;2;09;124;Montbeton;4238;90;4328
76;Occitanie;82;2;09;125;Montech;6669;130;6799
76;Occitanie;82;2;12;126;Monteils;1366;104;1470
76;Occitanie;82;1;05;127;Montesquieu;754;18;772
76;Occitanie;82;2;11;128;Montfermier;106;3;109
76;Occitanie;82;1;04;129;Montgaillard;149;4;153
76;Occitanie;82;1;14;130;Montjoi;167;1;168
76;Occitanie;82;2;11;131;Montpezat-de-Quercy;1600;40;1640
76;Occitanie;82;2;01;132;Montricoux;1175;27;1202
76;Occitanie;82;2;12;133;Mouillac;90;1;91
76;Occitanie;82;2;01;134;Nègrepelisse;5740;81;5821
76;Occitanie;82;2;13;135;Nohic;1332;18;1350
76;Occitanie;82;2;13;136;Orgueil;1720;24;1744
76;Occitanie;82;2;12;137;Parisot;555;11;566
76;Occitanie;82;1;14;138;Perville;167;2;169
76;Occitanie;82;1;04;139;Le Pin;121;3;124
76;Occitanie;82;2;11;140;Piquecos;453;3;456
76;Occitanie;82;1;14;141;Pommevic;551;4;555
76;Occitanie;82;2;15;142;Pompignan;1632;24;1656
76;Occitanie;82;1;04;143;Poupas;86;0;86
76;Occitanie;82;2;10;144;Puycornet;755;11;766
76;Occitanie;82;2;13;145;Puygaillard-de-Quercy;373;8;381
76;Occitanie;82;1;04;146;Puygaillard-de-Lomagne;58;2;60
76;Occitanie;82;2;12;147;Puylagarde;332;10;342
76;Occitanie;82;2;12;148;Puylaroque;689;25;714
76;Occitanie;82;2;11;149;Réalville;1865;32;1897
76;Occitanie;82;2;13;150;Reyniès;874;23;897
76;Occitanie;82;1;10;151;Roquecor;401;6;407
76;Occitanie;82;1;04;152;Saint-Aignan;396;11;407
76;Occitanie;82;1;10;153;Saint-Amans-du-Pech;226;1;227
76;Occitanie;82;1;10;154;Saint-Amans-de-Pellagal;209;5;214
76;Occitanie;82;2;12;155;Saint-Antonin-Noble-Val;1884;37;1921
76;Occitanie;82;1;02;156;Saint-Arroumex;147;4;151
76;Occitanie;82;1;10;157;Saint-Beauzeil;101;1;102
76;Occitanie;82;1;04;158;Saint-Cirice;142;6;148
76;Occitanie;82;2;12;159;Saint-Cirq;565;17;582
76;Occitanie;82;1;14;160;Saint-Clair;260;8;268
76;Occitanie;82;2;01;161;Saint-Étienne-de-Tulmont;3965;80;4045
76;Occitanie;82;2;12;162;Saint-Georges;267;7;274
76;Occitanie;82;1;04;163;Saint-Jean-du-Bouzet;51;1;52
76;Occitanie;82;1;10;164;Sainte-Juliette;125;3;128
76;Occitanie;82;1;04;165;Saint-Loup;535;4;539
76;Occitanie;82;1;04;166;Saint-Michel;284;3;287
76;Occitanie;82;2;13;167;Saint-Nauphary;1907;42;1949
76;Occitanie;82;1;14;168;Saint-Nazaire-de-Valentane;319;3;322
76;Occitanie;82;1;04;169;Saint-Nicolas-de-la-Grave;2298;29;2327
76;Occitanie;82;1;14;170;Saint-Paul-d'Espis;560;17;577
76;Occitanie;82;2;02;171;Saint-Porquier;1384;26;1410
76;Occitanie;82;2;12;172;Saint-Projet;274;8;282
76;Occitanie;82;2;15;173;Saint-Sardos;1166;15;1181
76;Occitanie;82;2;11;174;Saint-Vincent-d'Autéjac;286;2;288
76;Occitanie;82;1;14;175;Saint-Vincent-Lespinasse;277;4;281
76;Occitanie;82;2;13;176;La Salvetat-Belmontet;896;14;910
76;Occitanie;82;1;10;177;Sauveterre;157;2;159
76;Occitanie;82;2;15;178;Savenès;815;17;832
76;Occitanie;82;2;12;179;Septfonds;2261;50;2311
76;Occitanie;82;1;02;180;Sérignac;518;8;526
76;Occitanie;82;1;04;181;Sistels;205;4;209
76;Occitanie;82;1;10;182;Touffailles;336;3;339
76;Occitanie;82;1;10;183;Tréjouls;237;10;247
76;Occitanie;82;2;01;184;Vaïssac;930;10;940
76;Occitanie;82;1;10;185;Valeilles;251;6;257
76;Occitanie;82;1;14;186;Valence;5233;148;5381
76;Occitanie;82;2;12;187;Varen;654;10;664
76;Occitanie;82;2;13;188;Varennes;637;14;651
76;Occitanie;82;2;10;189;Vazerac;748;14;762
76;Occitanie;82;2;15;190;Verdun-sur-Garonne;4831;69;4900
76;Occitanie;82;2;12;191;Verfeil;426;4;430
76;Occitanie;82;2;13;192;Verlhac-Tescou;541;13;554
76;Occitanie;82;1;02;193;Vigueron;137;3;140
76;Occitanie;82;2;13;194;Villebrumier;1359;34;1393
76;Occitanie;82;2;11;195;Villemade;796;13;809
93;Provence-Alpes-Côte d'Azur;83;1;14;001;Les Adrets-de-l'Estérel;2803;74;2877
93;Provence-Alpes-Côte d'Azur;83;3;04;002;Aiguines;271;5;276
93;Provence-Alpes-Côte d'Azur;83;1;04;003;Ampus;903;23;926
93;Provence-Alpes-Côte d'Azur;83;1;23;004;Les Arcs;7292;179;7471
93;Provence-Alpes-Côte d'Azur;83;3;04;005;Artignosc-sur-Verdon;285;6;291
93;Provence-Alpes-Côte d'Azur;83;3;13;006;Artigues;283;8;291
93;Provence-Alpes-Côte d'Azur;83;3;04;007;Aups;2303;39;2342
93;Provence-Alpes-Côte d'Azur;83;1;11;008;Bagnols-en-Forêt;2889;59;2948
93;Provence-Alpes-Côte d'Azur;83;2;10;009;Bandol;8359;124;8483
93;Provence-Alpes-Côte d'Azur;83;1;04;010;Bargème;228;1;229
93;Provence-Alpes-Côte d'Azur;83;1;04;011;Bargemon;1367;16;1383
93;Provence-Alpes-Côte d'Azur;83;3;13;012;Barjols;3017;39;3056
93;Provence-Alpes-Côte d'Azur;83;1;04;013;La Bastide;205;1;206
93;Provence-Alpes-Côte d'Azur;83;3;04;014;Baudinard-sur-Verdon;241;9;250
93;Provence-Alpes-Côte d'Azur;83;3;04;015;Bauduen;319;4;323
93;Provence-Alpes-Côte d'Azur;83;2;12;016;Le Beausset;9802;181;9983
93;Provence-Alpes-Côte d'Azur;83;2;18;017;Belgentier;2411;45;2456
93;Provence-Alpes-Côte d'Azur;83;3;09;018;Besse-sur-Issole;3066;56;3122
93;Provence-Alpes-Côte d'Azur;83;2;02;019;Bormes-les-Mimosas;8162;115;8277
93;Provence-Alpes-Côte d'Azur;83;1;04;020;Le Bourguet;42;1;43
93;Provence-Alpes-Côte d'Azur;83;3;13;021;Bras;2625;49;2674
93;Provence-Alpes-Côte d'Azur;83;1;04;022;Brenon;23;0;23
93;Provence-Alpes-Côte d'Azur;83;3;01;023;Brignoles;17652;312;17964
93;Provence-Alpes-Côte d'Azur;83;3;13;025;Brue-Auriac;1440;23;1463
93;Provence-Alpes-Côte d'Azur;83;3;09;026;Cabasse;1934;36;1970
93;Provence-Alpes-Côte d'Azur;83;2;12;027;La Cadière-d'Azur;5548;99;5647
93;Provence-Alpes-Côte d'Azur;83;1;04;028;Callas;1961;37;1998
93;Provence-Alpes-Côte d'Azur;83;1;11;029;Callian;3498;69;3567
93;Provence-Alpes-Côte d'Azur;83;3;07;030;Camps-la-Source;1893;47;1940
93;Provence-Alpes-Côte d'Azur;83;3;09;031;Le Cannet-des-Maures;4325;61;4386
93;Provence-Alpes-Côte d'Azur;83;3;01;032;Carcès;3388;82;3470
93;Provence-Alpes-Côte d'Azur;83;3;07;033;Carnoules;3587;36;3623
93;Provence-Alpes-Côte d'Azur;83;2;06;034;Carqueiranne;9462;165;9627
93;Provence-Alpes-Côte d'Azur;83;2;12;035;Le Castellet;4578;55;4633
93;Provence-Alpes-Côte d'Azur;83;1;15;036;Cavalaire-sur-Mer;7642;93;7735
93;Provence-Alpes-Côte d'Azur;83;3;01;037;La Celle;1536;68;1604
93;Provence-Alpes-Côte d'Azur;83;1;04;038;Châteaudouble;479;15;494
93;Provence-Alpes-Côte d'Azur;83;3;13;039;Châteauvert;147;5;152
93;Provence-Alpes-Côte d'Azur;83;1;04;040;Châteauvieux;77;1;78
93;Provence-Alpes-Côte d'Azur;83;1;04;041;Claviers;720;10;730
93;Provence-Alpes-Côte d'Azur;83;1;15;042;Cogolin;11794;213;12007
93;Provence-Alpes-Côte d'Azur;83;2;09;043;Collobrières;1855;88;1943
93;Provence-Alpes-Côte d'Azur;83;1;04;044;Comps-sur-Artuby;336;5;341
93;Provence-Alpes-Côte d'Azur;83;3;01;045;Correns;902;13;915
93;Provence-Alpes-Côte d'Azur;83;3;01;046;Cotignac;2105;40;2145
93;Provence-Alpes-Côte d'Azur;83;2;02;047;La Crau;19052;429;19481
93;Provence-Alpes-Côte d'Azur;83;1;15;048;La Croix-Valmer;3780;93;3873
93;Provence-Alpes-Côte d'Azur;83;2;18;049;Cuers;12298;135;12433
93;Provence-Alpes-Côte d'Azur;83;1;03;050;Draguignan;39434;928;40362
93;Provence-Alpes-Côte d'Azur;83;3;01;051;Entrecasteaux;1122;23;1145
93;Provence-Alpes-Côte d'Azur;83;3;13;052;Esparron;370;5;375
93;Provence-Alpes-Côte d'Azur;83;2;10;053;Évenos;2407;50;2457
93;Provence-Alpes-Côte d'Azur;83;2;18;054;La Farlède;9605;120;9725
93;Provence-Alpes-Côte d'Azur;83;1;11;055;Fayence;5770;87;5857
93;Provence-Alpes-Côte d'Azur;83;1;04;056;Figanières;2623;55;2678
93;Provence-Alpes-Côte d'Azur;83;3;09;057;Flassans-sur-Issole;3582;68;3650
93;Provence-Alpes-Côte d'Azur;83;1;04;058;Flayosc;4195;103;4298
93;Provence-Alpes-Côte d'Azur;83;3;07;059;Forcalqueiret;3185;37;3222
93;Provence-Alpes-Côte d'Azur;83;3;04;060;Fox-Amphoux;471;7;478
93;Provence-Alpes-Côte d'Azur;83;1;96;061;Fréjus;55750;848;56598
93;Provence-Alpes-Côte d'Azur;83;2;06;062;La Garde;25563;313;25876
93;Provence-Alpes-Côte d'Azur;83;1;09;063;La Garde-Freinet;1827;44;1871
93;Provence-Alpes-Côte d'Azur;83;3;07;064;Garéoult;5307;99;5406
93;Provence-Alpes-Côte d'Azur;83;1;15;065;Gassin;2642;57;2699
93;Provence-Alpes-Côte d'Azur;83;3;13;066;Ginasservis;1930;30;1960
93;Provence-Alpes-Côte d'Azur;83;3;09;067;Gonfaron;4352;58;4410
93;Provence-Alpes-Côte d'Azur;83;1;15;068;Grimaud;4607;64;4671
93;Provence-Alpes-Côte d'Azur;83;2;97;069;Hyères;54615;913;55528
93;Provence-Alpes-Côte d'Azur;83;2;02;070;Le Lavandou;5980;68;6048
93;Provence-Alpes-Côte d'Azur;83;2;02;071;La Londe-les-Maures;11493;150;11643
93;Provence-Alpes-Côte d'Azur;83;1;23;072;Lorgues;9280;309;9589
93;Provence-Alpes-Côte d'Azur;83;3;09;073;Le Luc;11058;108;11166
93;Provence-Alpes-Côte d'Azur;83;1;04;074;La Martre;210;1;211
93;Provence-Alpes-Côte d'Azur;83;3;09;075;Les Mayons;625;7;632
93;Provence-Alpes-Côte d'Azur;83;3;07;076;Mazaugues;873;12;885
93;Provence-Alpes-Côte d'Azur;83;3;07;077;Méounes-lès-Montrieux;2226;20;2246
93;Provence-Alpes-Côte d'Azur;83;3;04;078;Moissac-Bellevue;297;5;302
93;Provence-Alpes-Côte d'Azur;83;1;15;079;La Môle;1473;25;1498
93;Provence-Alpes-Côte d'Azur;83;1;11;080;Mons;802;15;817
93;Provence-Alpes-Côte d'Azur;83;1;11;081;Montauroux;6599;131;6730
93;Provence-Alpes-Côte d'Azur;83;1;04;082;Montferrat;1591;9;1600
93;Provence-Alpes-Côte d'Azur;83;3;01;083;Montfort-sur-Argens;1456;27;1483
93;Provence-Alpes-Côte d'Azur;83;3;04;084;Montmeyan;554;4;558
93;Provence-Alpes-Côte d'Azur;83;1;04;085;La Motte;2886;58;2944
93;Provence-Alpes-Côte d'Azur;83;1;23;086;Le Muy;9468;249;9717
93;Provence-Alpes-Côte d'Azur;83;3;12;087;Nans-les-Pins;4916;86;5002
93;Provence-Alpes-Côte d'Azur;83;3;07;088;Néoules;2887;69;2956
93;Provence-Alpes-Côte d'Azur;83;3;13;089;Ollières;647;24;671
93;Provence-Alpes-Côte d'Azur;83;2;10;090;Ollioules;13991;269;14260
93;Provence-Alpes-Côte d'Azur;83;2;07;091;Pierrefeu-du-Var;6083;105;6188
93;Provence-Alpes-Côte d'Azur;83;3;09;092;Pignans;4658;47;4705
93;Provence-Alpes-Côte d'Azur;83;3;12;093;Plan-d'Aups-Sainte-Baume;2235;27;2262
93;Provence-Alpes-Côte d'Azur;83;1;15;094;Le Plan-de-la-Tour;3046;54;3100
93;Provence-Alpes-Côte d'Azur;83;3;13;095;Pontevès;727;19;746
93;Provence-Alpes-Côte d'Azur;83;3;13;096;Pourcieux;1570;20;1590
93;Provence-Alpes-Côte d'Azur;83;3;13;097;Pourrières;5327;104;5431
93;Provence-Alpes-Côte d'Azur;83;2;06;098;Le Pradet;10496;160;10656
93;Provence-Alpes-Côte d'Azur;83;1;11;099;Puget-sur-Argens;8061;112;8173
93;Provence-Alpes-Côte d'Azur;83;3;07;100;Puget-Ville;4409;47;4456
93;Provence-Alpes-Côte d'Azur;83;1;15;101;Ramatuelle;2037;34;2071
93;Provence-Alpes-Côte d'Azur;83;3;04;102;Régusse;2562;45;2607
93;Provence-Alpes-Côte d'Azur;83;2;21;103;Le Revest-les-Eaux;4011;60;4071
93;Provence-Alpes-Côte d'Azur;83;3;13;104;Rians;4301;83;4384
93;Provence-Alpes-Côte d'Azur;83;2;12;105;Riboux;51;0;51
93;Provence-Alpes-Côte d'Azur;83;3;07;106;Rocbaron;5323;73;5396
93;Provence-Alpes-Côte d'Azur;83;1;11;107;Roquebrune-sur-Argens;14335;187;14522
93;Provence-Alpes-Côte d'Azur;83;3;07;108;La Roquebrussanne;2184;40;2224
93;Provence-Alpes-Côte d'Azur;83;1;04;109;La Roque-Esclapon;248;2;250
93;Provence-Alpes-Côte d'Azur;83;3;01;110;Rougiers;1672;27;1699
93;Provence-Alpes-Côte d'Azur;83;3;07;111;Sainte-Anastasie-sur-Issole;2102;26;2128
93;Provence-Alpes-Côte d'Azur;83;2;12;112;Saint-Cyr-sur-Mer;12058;245;12303
93;Provence-Alpes-Côte d'Azur;83;3;13;113;Saint-Julien;2401;41;2442
93;Provence-Alpes-Côte d'Azur;83;3;13;114;Saint-Martin-de-Pallières;247;4;251
93;Provence-Alpes-Côte d'Azur;83;1;15;115;Sainte-Maxime;14750;204;14954
93;Provence-Alpes-Côte d'Azur;83;3;13;116;Saint-Maximin-la-Sainte-Baume;17468;538;18006
93;Provence-Alpes-Côte d'Azur;83;1;11;117;Saint-Paul-en-Forêt;1770;43;1813
93;Provence-Alpes-Côte d'Azur;83;1;14;118;Saint-Raphaël;35881;579;36460
93;Provence-Alpes-Côte d'Azur;83;1;15;119;Saint-Tropez;3600;69;3669
93;Provence-Alpes-Côte d'Azur;83;3;12;120;Saint-Zacharie;5985;73;6058
93;Provence-Alpes-Côte d'Azur;83;1;04;121;Salernes;3771;77;3848
93;Provence-Alpes-Côte d'Azur;83;3;04;122;Les Salles-sur-Verdon;229;3;232
93;Provence-Alpes-Côte d'Azur;83;2;10;123;Sanary-sur-Mer;17173;267;17440
93;Provence-Alpes-Côte d'Azur;83;1;11;124;Seillans;2674;33;2707
93;Provence-Alpes-Côte d'Azur;83;3;13;125;Seillons-Source-d'Argens;2526;39;2565
93;Provence-Alpes-Côte d'Azur;83;2;98;126;La Seyne-sur-Mer;62232;767;62999
93;Provence-Alpes-Côte d'Azur;83;2;12;127;Signes;2992;46;3038
93;Provence-Alpes-Côte d'Azur;83;1;04;128;Sillans-la-Cascade;762;49;811
93;Provence-Alpes-Côte d'Azur;83;2;17;129;Six-Fours-les-Plages;35339;551;35890
93;Provence-Alpes-Côte d'Azur;83;2;18;130;Solliès-Pont;11974;184;12158
93;Provence-Alpes-Côte d'Azur;83;2;18;131;Solliès-Toucas;5867;108;5975
93;Provence-Alpes-Côte d'Azur;83;2;18;132;Solliès-Ville;2523;46;2569
93;Provence-Alpes-Côte d'Azur;83;1;11;133;Tanneron;1674;33;1707
93;Provence-Alpes-Côte d'Azur;83;1;23;134;Taradeau;1791;31;1822
93;Provence-Alpes-Côte d'Azur;83;3;04;135;Tavernes;1425;19;1444
93;Provence-Alpes-Côte d'Azur;83;3;09;136;Le Thoronet;2598;49;2647
93;Provence-Alpes-Côte d'Azur;83;2;99;137;Toulon;179659;1847;181506
93;Provence-Alpes-Côte d'Azur;83;1;11;138;Tourrettes;2874;54;2928
93;Provence-Alpes-Côte d'Azur;83;3;04;139;Tourtour;587;14;601
93;Provence-Alpes-Côte d'Azur;83;3;01;140;Tourves;5101;75;5176
93;Provence-Alpes-Côte d'Azur;83;1;03;141;Trans-en-Provence;5983;136;6119
93;Provence-Alpes-Côte d'Azur;83;1;04;142;Trigance;206;5;211
93;Provence-Alpes-Côte d'Azur;83;3;01;143;Le Val;4287;93;4380
93;Provence-Alpes-Côte d'Azur;83;2;21;144;La Valette-du-Var;24114;263;24377
93;Provence-Alpes-Côte d'Azur;83;3;13;145;Varages;1165;15;1180
93;Provence-Alpes-Côte d'Azur;83;3;13;146;La Verdière;1628;22;1650
93;Provence-Alpes-Côte d'Azur;83;3;04;147;Vérignon;9;0;9
93;Provence-Alpes-Côte d'Azur;83;1;23;148;Vidauban;12693;156;12849
93;Provence-Alpes-Côte d'Azur;83;3;04;149;Villecroze;1483;28;1511
93;Provence-Alpes-Côte d'Azur;83;3;13;150;Vinon-sur-Verdon;4280;101;4381
93;Provence-Alpes-Côte d'Azur;83;3;01;151;Vins-sur-Caramy;937;15;952
93;Provence-Alpes-Côte d'Azur;83;1;02;152;Rayol-Canadel-sur-Mer;646;13;659
93;Provence-Alpes-Côte d'Azur;83;2;17;153;Saint-Mandrier-sur-Mer;6100;70;6170
93;Provence-Alpes-Côte d'Azur;83;1;01;154;Saint-Antonin-du-Var;735;14;749
93;Provence-Alpes-Côte d'Azur;84;3;10;001;Althen-des-Paluds;2824;45;2869
93;Provence-Alpes-Côte d'Azur;84;1;13;002;Ansouis;1058;24;1082
93;Provence-Alpes-Côte d'Azur;84;1;01;003;Apt;10889;227;11116
93;Provence-Alpes-Côte d'Azur;84;3;06;004;Aubignan;5825;95;5920
93;Provence-Alpes-Côte d'Azur;84;3;12;005;Aurel;190;2;192
93;Provence-Alpes-Côte d'Azur;84;1;01;006;Auribeau;71;4;75
93;Provence-Alpes-Côte d'Azur;84;2;99;007;Avignon;90597;1680;92277
93;Provence-Alpes-Côte d'Azur;84;3;16;008;Le Barroux;653;35;688
93;Provence-Alpes-Côte d'Azur;84;1;13;009;La Bastide-des-Jourdans;1652;96;1748
93;Provence-Alpes-Côte d'Azur;84;1;13;010;La Bastidonne;883;24;907
93;Provence-Alpes-Côte d'Azur;84;3;12;011;Le Beaucet;355;9;364
93;Provence-Alpes-Côte d'Azur;84;3;10;012;Beaumes-de-Venise;2379;47;2426
93;Provence-Alpes-Côte d'Azur;84;1;01;013;Beaumettes;293;4;297
93;Provence-Alpes-Côte d'Azur;84;1;13;014;Beaumont-de-Pertuis;1129;17;1146
93;Provence-Alpes-Côte d'Azur;84;3;16;015;Beaumont-du-Ventoux;304;5;309
93;Provence-Alpes-Côte d'Azur;84;2;15;016;Bédarrides;5358;74;5432
93;Provence-Alpes-Côte d'Azur;84;3;12;017;Bédoin;3091;66;3157
93;Provence-Alpes-Côte d'Azur;84;3;12;018;Blauvac;535;10;545
93;Provence-Alpes-Côte d'Azur;84;3;05;019;Bollène;13830;213;14043
93;Provence-Alpes-Côte d'Azur;84;1;01;020;Bonnieux;1190;25;1215
93;Provence-Alpes-Côte d'Azur;84;3;16;021;Brantes;89;0;89
93;Provence-Alpes-Côte d'Azur;84;3;16;022;Buisson;267;11;278
93;Provence-Alpes-Côte d'Azur;84;1;01;023;Buoux;96;3;99
93;Provence-Alpes-Côte d'Azur;84;1;13;024;Cabrières-d'Aigues;959;14;973
93;Provence-Alpes-Côte d'Azur;84;1;08;025;Cabrières-d'Avignon;1845;38;1883
93;Provence-Alpes-Côte d'Azur;84;1;08;026;Cadenet;4219;78;4297
93;Provence-Alpes-Côte d'Azur;84;3;11;027;Caderousse;2639;49;2688
93;Provence-Alpes-Côte d'Azur;84;3;16;028;Cairanne;1090;20;1110
93;Provence-Alpes-Côte d'Azur;84;3;16;029;Camaret-sur-Aigues;4544;92;4636
93;Provence-Alpes-Côte d'Azur;84;3;10;030;Caromb;3448;57;3505
93;Provence-Alpes-Côte d'Azur;84;3;06;031;Carpentras;29865;699;30564
93;Provence-Alpes-Côte d'Azur;84;1;01;032;Caseneuve;503;8;511
93;Provence-Alpes-Côte d'Azur;84;1;01;033;Castellet-en-Luberon;114;1;115
93;Provence-Alpes-Côte d'Azur;84;2;07;034;Caumont-sur-Durance;5094;103;5197
93;Provence-Alpes-Côte d'Azur;84;1;07;035;Cavaillon;25832;374;26206
93;Provence-Alpes-Côte d'Azur;84;2;09;036;Châteauneuf-de-Gadagne;3379;73;3452
93;Provence-Alpes-Côte d'Azur;84;3;15;037;Châteauneuf-du-Pape;2061;29;2090
93;Provence-Alpes-Côte d'Azur;84;1;08;038;Cheval-Blanc;4300;73;4373
93;Provence-Alpes-Côte d'Azur;84;3;15;039;Courthézon;6049;78;6127
93;Provence-Alpes-Côte d'Azur;84;3;16;040;Crestet;425;16;441
93;Provence-Alpes-Côte d'Azur;84;3;12;041;Crillon-le-Brave;479;13;492
93;Provence-Alpes-Côte d'Azur;84;1;08;042;Cucuron;1777;33;1810
93;Provence-Alpes-Côte d'Azur;84;2;10;043;Entraigues-sur-la-Sorgue;8605;124;8729
93;Provence-Alpes-Côte d'Azur;84;3;16;044;Entrechaux;1138;33;1171
93;Provence-Alpes-Côte d'Azur;84;3;16;045;Faucon;449;11;460
93;Provence-Alpes-Côte d'Azur;84;3;12;046;Flassan;471;13;484
93;Provence-Alpes-Côte d'Azur;84;1;01;047;Gargas;3058;57;3115
93;Provence-Alpes-Côte d'Azur;84;1;01;048;Gignac;73;1;74
93;Provence-Alpes-Côte d'Azur;84;3;16;049;Gigondas;432;11;443
93;Provence-Alpes-Côte d'Azur;84;1;01;050;Gordes;1666;34;1700
93;Provence-Alpes-Côte d'Azur;84;1;01;051;Goult;1092;26;1118
93;Provence-Alpes-Côte d'Azur;84;1;13;052;Grambois;1225;28;1253
93;Provence-Alpes-Côte d'Azur;84;3;17;053;Grillon;1757;31;1788
93;Provence-Alpes-Côte d'Azur;84;2;09;054;L'Isle-sur-la-Sorgue;20029;502;20531
93;Provence-Alpes-Côte d'Azur;84;2;14;055;Jonquerettes;1571;37;1608
93;Provence-Alpes-Côte d'Azur;84;3;15;056;Jonquières;5384;68;5452
93;Provence-Alpes-Côte d'Azur;84;1;01;057;Joucas;351;4;355
93;Provence-Alpes-Côte d'Azur;84;1;01;058;Lacoste;424;8;432
93;Provence-Alpes-Côte d'Azur;84;3;16;059;Lafare;122;1;123
93;Provence-Alpes-Côte d'Azur;84;1;01;060;Lagarde-d'Apt;30;1;31
93;Provence-Alpes-Côte d'Azur;84;3;05;061;Lagarde-Paréol;325;12;337
93;Provence-Alpes-Côte d'Azur;84;1;08;062;Lagnes;1638;33;1671
93;Provence-Alpes-Côte d'Azur;84;3;05;063;Lamotte-du-Rhône;394;1;395
93;Provence-Alpes-Côte d'Azur;84;3;05;064;Lapalud;3842;79;3921
93;Provence-Alpes-Côte d'Azur;84;1;08;065;Lauris;3890;71;3961
93;Provence-Alpes-Côte d'Azur;84;1;01;066;Lioux;289;4;293
93;Provence-Alpes-Côte d'Azur;84;3;06;067;Loriol-du-Comtat;2488;53;2541
93;Provence-Alpes-Côte d'Azur;84;1;08;068;Lourmarin;1042;21;1063
93;Provence-Alpes-Côte d'Azur;84;3;16;069;Malaucène;2736;58;2794
93;Provence-Alpes-Côte d'Azur;84;3;12;070;Malemort-du-Comtat;1919;24;1943
93;Provence-Alpes-Côte d'Azur;84;1;08;071;Maubec;1914;47;1961
93;Provence-Alpes-Côte d'Azur;84;3;12;072;Mazan;6235;160;6395
93;Provence-Alpes-Côte d'Azur;84;1;01;073;Ménerbes;992;22;1014
93;Provence-Alpes-Côte d'Azur;84;1;08;074;Mérindol;2232;38;2270
93;Provence-Alpes-Côte d'Azur;84;3;12;075;Méthamis;446;8;454
93;Provence-Alpes-Côte d'Azur;84;1;13;076;Mirabeau;1389;42;1431
93;Provence-Alpes-Côte d'Azur;84;3;12;077;Modène;467;7;474
93;Provence-Alpes-Côte d'Azur;84;3;05;078;Mondragon;3708;63;3771
93;Provence-Alpes-Côte d'Azur;84;3;12;079;Monieux;279;7;286
93;Provence-Alpes-Côte d'Azur;84;3;10;080;Monteux;12979;227;13206
93;Provence-Alpes-Côte d'Azur;84;2;04;081;Morières-lès-Avignon;8848;130;8978
93;Provence-Alpes-Côte d'Azur;84;3;12;082;Mormoiron;1869;47;1916
93;Provence-Alpes-Côte d'Azur;84;3;05;083;Mornas;2450;47;2497
93;Provence-Alpes-Côte d'Azur;84;1;13;084;La Motte-d'Aigues;1378;41;1419
93;Provence-Alpes-Côte d'Azur;84;1;01;085;Murs;418;6;424
93;Provence-Alpes-Côte d'Azur;84;1;01;086;Oppède;1292;29;1321
93;Provence-Alpes-Côte d'Azur;84;3;11;087;Orange;28454;649;29103
93;Provence-Alpes-Côte d'Azur;84;3;12;088;Pernes-les-Fontaines;10294;284;10578
93;Provence-Alpes-Côte d'Azur;84;1;13;089;Pertuis;20498;269;20767
93;Provence-Alpes-Côte d'Azur;84;1;13;090;Peypin-d'Aigues;673;14;687
93;Provence-Alpes-Côte d'Azur;84;3;11;091;Piolenc;5465;95;5560
93;Provence-Alpes-Côte d'Azur;84;2;14;092;Le Pontet;17018;128;17146
93;Provence-Alpes-Côte d'Azur;84;1;08;093;Puget;852;22;874
93;Provence-Alpes-Côte d'Azur;84;3;16;094;Puyméras;583;11;594
93;Provence-Alpes-Côte d'Azur;84;1;08;095;Puyvert;823;13;836
93;Provence-Alpes-Côte d'Azur;84;3;16;096;Rasteau;795;20;815
93;Provence-Alpes-Côte d'Azur;84;3;17;097;Richerenches;536;81;617
93;Provence-Alpes-Côte d'Azur;84;3;16;098;Roaix;626;9;635
93;Provence-Alpes-Côte d'Azur;84;1;08;099;Robion;4688;85;4773
93;Provence-Alpes-Côte d'Azur;84;3;16;100;La Roque-Alric;54;0;54
93;Provence-Alpes-Côte d'Azur;84;3;12;101;La Roque-sur-Pernes;417;13;430
93;Provence-Alpes-Côte d'Azur;84;1;01;102;Roussillon;1290;31;1321
93;Provence-Alpes-Côte d'Azur;84;1;01;103;Rustrel;670;20;690
93;Provence-Alpes-Côte d'Azur;84;3;16;104;Sablet;1381;34;1415
93;Provence-Alpes-Côte d'Azur;84;1;01;105;Saignon;925;22;947
93;Provence-Alpes-Côte d'Azur;84;3;05;106;Sainte-Cécile-les-Vignes;2634;52;2686
93;Provence-Alpes-Côte d'Azur;84;3;12;107;Saint-Christol;1429;20;1449
93;Provence-Alpes-Côte d'Azur;84;3;12;108;Saint-Didier;2060;37;2097
93;Provence-Alpes-Côte d'Azur;84;3;10;109;Saint-Hippolyte-le-Graveyron;169;9;178
93;Provence-Alpes-Côte d'Azur;84;3;16;110;Saint-Léger-du-Ventoux;31;0;31
93;Provence-Alpes-Côte d'Azur;84;3;16;111;Saint-Marcellin-lès-Vaison;335;11;346
93;Provence-Alpes-Côte d'Azur;84;1;01;112;Saint-Martin-de-Castillon;702;6;708
93;Provence-Alpes-Côte d'Azur;84;1;13;113;Saint-Martin-de-la-Brasque;822;17;839
93;Provence-Alpes-Côte d'Azur;84;1;01;114;Saint-Pantaléon;194;3;197
93;Provence-Alpes-Côte d'Azur;84;3;12;115;Saint-Pierre-de-Vassols;501;12;513
93;Provence-Alpes-Côte d'Azur;84;3;16;116;Saint-Romain-en-Viennois;808;12;820
93;Provence-Alpes-Côte d'Azur;84;3;16;117;Saint-Roman-de-Malegarde;333;7;340
93;Provence-Alpes-Côte d'Azur;84;1;01;118;Saint-Saturnin-lès-Apt;2910;75;2985
93;Provence-Alpes-Côte d'Azur;84;2;14;119;Saint-Saturnin-lès-Avignon;5027;82;5109
93;Provence-Alpes-Côte d'Azur;84;3;12;120;Saint-Trinit;120;1;121
93;Provence-Alpes-Côte d'Azur;84;1;13;121;Sannes;278;0;278
93;Provence-Alpes-Côte d'Azur;84;3;10;122;Sarrians;6030;84;6114
93;Provence-Alpes-Côte d'Azur;84;3;12;123;Sault;1356;22;1378
93;Provence-Alpes-Côte d'Azur;84;2;09;124;Saumane-de-Vaucluse;926;15;941
93;Provence-Alpes-Côte d'Azur;84;3;16;125;Savoillan;59;0;59
93;Provence-Alpes-Côte d'Azur;84;3;16;126;Séguret;830;17;847
93;Provence-Alpes-Côte d'Azur;84;3;05;127;Sérignan-du-Comtat;2856;78;2934
93;Provence-Alpes-Côte d'Azur;84;1;01;128;Sivergues;46;1;47
93;Provence-Alpes-Côte d'Azur;84;2;15;129;Sorgues;18930;246;19176
93;Provence-Alpes-Côte d'Azur;84;3;16;130;Suzette;111;3;114
93;Provence-Alpes-Côte d'Azur;84;1;08;131;Taillades;1917;40;1957
93;Provence-Alpes-Côte d'Azur;84;2;09;132;Le Thor;8883;180;9063
93;Provence-Alpes-Côte d'Azur;84;1;13;133;La Tour-d'Aigues;4327;139;4466
93;Provence-Alpes-Côte d'Azur;84;3;16;134;Travaillan;712;13;725
93;Provence-Alpes-Côte d'Azur;84;3;05;135;Uchaux;1674;50;1724
93;Provence-Alpes-Côte d'Azur;84;3;16;136;Vacqueyras;1206;31;1237
93;Provence-Alpes-Côte d'Azur;84;3;16;137;Vaison-la-Romaine;5892;127;6019
93;Provence-Alpes-Côte d'Azur;84;3;17;138;Valréas;9381;235;9616
93;Provence-Alpes-Côte d'Azur;84;2;09;139;Fontaine-de-Vaucluse;573;16;589
93;Provence-Alpes-Côte d'Azur;84;1;08;140;Vaugines;553;19;572
93;Provence-Alpes-Côte d'Azur;84;2;14;141;Vedène;11423;357;11780
93;Provence-Alpes-Côte d'Azur;84;2;14;142;Velleron;3030;71;3101
93;Provence-Alpes-Côte d'Azur;84;3;12;143;Venasque;1032;22;1054
93;Provence-Alpes-Côte d'Azur;84;1;01;144;Viens;635;16;651
93;Provence-Alpes-Côte d'Azur;84;1;01;145;Villars;779;14;793
93;Provence-Alpes-Côte d'Azur;84;3;16;146;Villedieu;483;14;497
93;Provence-Alpes-Côte d'Azur;84;1;13;147;Villelaure;3295;82;3377
93;Provence-Alpes-Côte d'Azur;84;3;12;148;Villes-sur-Auzon;1273;32;1305
93;Provence-Alpes-Côte d'Azur;84;3;16;149;Violès;1727;29;1756
93;Provence-Alpes-Côte d'Azur;84;3;17;150;Visan;1929;33;1962
93;Provence-Alpes-Côte d'Azur;84;1;13;151;Vitrolles-en-Lubéron;162;7;169
52;Pays de la Loire;85;3;09;001;L'Aiguillon-la-Presqu'île;2745;44;2789
52;Pays de la Loire;85;3;15;002;L'Aiguillon-sur-Vie;2067;24;2091
52;Pays de la Loire;85;2;01;003;Aizenay;10067;203;10270
52;Pays de la Loire;85;3;09;004;Angles;2905;36;2941
52;Pays de la Loire;85;1;04;005;Antigny;1051;21;1072
52;Pays de la Loire;85;2;02;006;Apremont;1867;13;1880
52;Pays de la Loire;85;2;13;008;Aubigny-Les Clouzeaux;7040;106;7146
52;Pays de la Loire;85;1;05;009;Auchay-sur-Vendée;1149;21;1170
52;Pays de la Loire;85;3;17;010;Avrillé;1424;18;1442
52;Pays de la Loire;85;3;16;011;Barbâtre;1721;50;1771
52;Pays de la Loire;85;3;16;012;La Barre-de-Monts;2240;40;2280
52;Pays de la Loire;85;2;10;013;Bazoges-en-Paillers;1481;28;1509
52;Pays de la Loire;85;1;04;014;Bazoges-en-Pareds;1145;27;1172
52;Pays de la Loire;85;2;01;015;Beaufou;1565;23;1588
52;Pays de la Loire;85;3;17;016;Beaulieu-sous-la-Roche;2275;30;2305
52;Pays de la Loire;85;2;11;017;Beaurepaire;2446;49;2495
52;Pays de la Loire;85;3;16;018;Beauvoir-sur-Mer;3887;63;3950
52;Pays de la Loire;85;2;01;019;Bellevigny;6193;127;6320
52;Pays de la Loire;85;1;05;020;Benet;4047;77;4124
52;Pays de la Loire;85;2;11;021;La Bernardière;1877;34;1911
52;Pays de la Loire;85;3;17;022;Le Bernard;1266;18;1284
52;Pays de la Loire;85;1;09;023;Bessay;440;9;449
52;Pays de la Loire;85;3;02;024;Bois-de-Céné;2103;29;2132
52;Pays de la Loire;85;2;10;025;La Boissière-de-Montaigu;2276;52;2328
52;Pays de la Loire;85;3;09;026;La Boissière-des-Landes;1432;19;1451
52;Pays de la Loire;85;1;05;028;Bouillé-Courdault;593;10;603
52;Pays de la Loire;85;3;16;029;Bouin;2155;35;2190
52;Pays de la Loire;85;1;03;031;Le Boupère;3208;67;3275
52;Pays de la Loire;85;1;04;033;Bourneau;728;18;746
52;Pays de la Loire;85;2;03;034;Bournezeau;3431;98;3529
52;Pays de la Loire;85;3;15;035;Bretignolles-sur-Mer;5093;87;5180
52;Pays de la Loire;85;1;09;036;La Bretonnière-la-Claye;578;17;595
52;Pays de la Loire;85;1;04;037;Breuil-Barret;579;16;595
52;Pays de la Loire;85;2;10;038;Les Brouzils;2883;44;2927
52;Pays de la Loire;85;2;11;039;La Bruffière;4074;62;4136
52;Pays de la Loire;85;1;04;040;La Caillère-Saint-Hilaire;1113;20;1133
52;Pays de la Loire;85;1;04;041;Cezais;296;12;308
52;Pays de la Loire;85;1;08;042;Chaillé-les-Marais;1884;24;1908
52;Pays de la Loire;85;3;15;045;La Chaize-Giraud;1095;14;1109
52;Pays de la Loire;85;2;13;046;La Chaize-le-Vicomte;3838;59;3897
52;Pays de la Loire;85;3;02;047;Challans;21900;790;22690
52;Pays de la Loire;85;1;08;049;Champagné-les-Marais;1797;21;1818
52;Pays de la Loire;85;3;09;050;Le Champ-Saint-Père;1852;22;1874
52;Pays de la Loire;85;2;03;051;Chantonnay;8434;493;8927
52;Pays de la Loire;85;1;04;053;La Chapelle-aux-Lys;259;3;262
52;Pays de la Loire;85;3;17;054;La Chapelle-Hermier;961;11;972
52;Pays de la Loire;85;2;02;055;La Chapelle-Palluau;992;27;1019
52;Pays de la Loire;85;1;04;056;La Chapelle-Thémer;389;9;398
52;Pays de la Loire;85;1;08;058;Chasnais;757;21;778
52;Pays de la Loire;85;1;04;059;La Châtaigneraie;2601;37;2638
52;Pays de la Loire;85;1;09;061;Château-Guibert;1506;34;1540
52;Pays de la Loire;85;3;02;062;Châteauneuf;1118;20;1138
52;Pays de la Loire;85;2;10;064;Chauché;2485;35;2520
52;Pays de la Loire;85;2;10;065;Chavagnes-en-Paillers;3572;102;3674
52;Pays de la Loire;85;1;06;066;Chavagnes-les-Redoux;829;17;846
52;Pays de la Loire;85;1;04;067;Cheffois;1002;21;1023
52;Pays de la Loire;85;3;15;070;Coëx;3339;38;3377
52;Pays de la Loire;85;3;15;071;Commequiers;3657;59;3716
52;Pays de la Loire;85;2;10;072;La Copechagnière;1046;11;1057
52;Pays de la Loire;85;1;09;073;Corpe;1015;18;1033
52;Pays de la Loire;85;1;09;074;La Couture;225;3;228
52;Pays de la Loire;85;2;11;076;Cugand;3633;88;3721
52;Pays de la Loire;85;3;09;077;Curzon;523;8;531
52;Pays de la Loire;85;1;05;078;Damvix;735;17;752
52;Pays de la Loire;85;1;05;080;Doix lès Fontaines;1740;33;1773
52;Pays de la Loire;85;2;12;081;Dompierre-sur-Yon;4394;117;4511
52;Pays de la Loire;85;2;06;082;Les Epesses;2941;56;2997
52;Pays de la Loire;85;3;16;083;L'Épine;1644;39;1683
52;Pays de la Loire;85;2;03;084;Essarts en Bocage;9300;164;9464
52;Pays de la Loire;85;2;02;086;Falleron;1667;15;1682
52;Pays de la Loire;85;1;05;087;Faymoreau;197;4;201
52;Pays de la Loire;85;3;15;088;Le Fenouiller;4897;128;5025
52;Pays de la Loire;85;2;03;089;La Ferrière;5363;157;5520
52;Pays de la Loire;85;1;06;090;Sèvremont;6417;255;6672
52;Pays de la Loire;85;1;05;092;Fontenay-le-Comte;13138;690;13828
52;Pays de la Loire;85;2;03;093;Fougeré;1230;20;1250
52;Pays de la Loire;85;1;05;094;Foussais-Payré;1173;32;1205
52;Pays de la Loire;85;3;02;095;Froidfond;1969;20;1989
52;Pays de la Loire;85;3;02;096;La Garnache;5220;106;5326
52;Pays de la Loire;85;2;11;097;La Gaubretière;3117;66;3183
52;Pays de la Loire;85;2;01;098;La Genétouze;1977;39;2016
52;Pays de la Loire;85;3;17;099;Le Girouard;1120;21;1141
52;Pays de la Loire;85;3;15;100;Givrand;2236;52;2288
52;Pays de la Loire;85;3;09;101;Le Givre;487;5;492
52;Pays de la Loire;85;2;02;102;Grand'Landes;700;8;708
52;Pays de la Loire;85;3;17;103;Grosbreuil;2225;39;2264
52;Pays de la Loire;85;1;08;104;Grues;897;9;906
52;Pays de la Loire;85;1;08;105;Le Gué-de-Velluire;527;16;543
52;Pays de la Loire;85;3;16;106;La Guérinière;1331;36;1367
52;Pays de la Loire;85;2;01;108;L'Herbergement;3344;110;3454
52;Pays de la Loire;85;2;06;109;Les Herbiers;16266;535;16801
52;Pays de la Loire;85;1;04;110;L'Hermenault;923;13;936
52;Pays de la Loire;85;1;08;111;L'Île-d'Elle;1506;23;1529
52;Pays de la Loire;85;3;17;112;L'Île-d'Olonne;2826;59;2885
52;Pays de la Loire;85;3;07;113;L'Île-d'Yeu;4870;138;5008
52;Pays de la Loire;85;3;17;114;Jard-sur-Mer;2670;31;2701
52;Pays de la Loire;85;1;04;115;La Jaudonnière;600;12;612
52;Pays de la Loire;85;3;09;116;La Jonchère;463;8;471
52;Pays de la Loire;85;1;08;117;Lairoux;616;9;625
52;Pays de la Loire;85;2;12;118;Landeronde;2336;46;2382
52;Pays de la Loire;85;2;11;119;Les Landes-Genusson;2431;42;2473
52;Pays de la Loire;85;3;15;120;Landevieille;1479;38;1517
52;Pays de la Loire;85;1;05;121;Le Langon;1012;19;1031
52;Pays de la Loire;85;1;05;123;Liez;284;4;288
52;Pays de la Loire;85;1;04;125;Loge-Fougereuse;402;4;406
52;Pays de la Loire;85;1;05;126;Longèves;1334;50;1384
52;Pays de la Loire;85;3;17;127;Longeville-sur-Mer;2412;25;2437
52;Pays de la Loire;85;1;08;128;Luçon;9541;377;9918
52;Pays de la Loire;85;2;01;129;Les Lucs-sur-Boulogne;3580;74;3654
52;Pays de la Loire;85;2;02;130;Maché;1601;19;1620
52;Pays de la Loire;85;1;08;131;Les Magnils-Reigniers;1484;39;1523
52;Pays de la Loire;85;1;05;132;Maillé;751;11;762
52;Pays de la Loire;85;1;05;133;Maillezais;906;23;929
52;Pays de la Loire;85;2;11;134;Mallièvre;242;9;251
52;Pays de la Loire;85;1;09;135;Mareuil-sur-Lay-Dissais;2789;121;2910
52;Pays de la Loire;85;1;04;136;Marillet;123;0;123
52;Pays de la Loire;85;1;04;137;Marsais-Sainte-Radégonde;472;14;486
52;Pays de la Loire;85;3;17;138;Martinet;1183;12;1195
52;Pays de la Loire;85;1;05;139;Le Mazeau;443;15;458
52;Pays de la Loire;85;1;06;140;La Meilleraie-Tillay;1498;31;1529
52;Pays de la Loire;85;1;04;141;Menomblet;677;12;689
52;Pays de la Loire;85;2;03;142;La Merlatière;1013;15;1028
52;Pays de la Loire;85;1;05;143;Mervent;1057;18;1075
52;Pays de la Loire;85;2;10;144;Mesnard-la-Barotière;1538;27;1565
52;Pays de la Loire;85;1;06;145;Monsireigne;967;17;984
52;Pays de la Loire;85;2;10;146;Montaigu-Vendée;20578;628;21206
52;Pays de la Loire;85;1;06;147;Montournais;1630;50;1680
52;Pays de la Loire;85;1;05;148;Montreuil;822;23;845
52;Pays de la Loire;85;1;08;149;Moreilles;410;5;415
52;Pays de la Loire;85;2;11;151;Mortagne-sur-Sèvre;6063;136;6199
52;Pays de la Loire;85;3;17;152;Les Achards;5331;114;5445
52;Pays de la Loire;85;2;06;153;Mouchamps;2923;43;2966
52;Pays de la Loire;85;1;04;154;Mouilleron-Saint-Germain;1786;90;1876
52;Pays de la Loire;85;2;12;155;Mouilleron-le-Captif;4996;125;5121
52;Pays de la Loire;85;3;09;156;Moutiers-les-Mauxfaits;2255;38;2293
52;Pays de la Loire;85;1;09;157;Moutiers-sur-le-Lay;782;12;794
52;Pays de la Loire;85;1;08;158;Mouzeuil-Saint-Martin;1190;26;1216
52;Pays de la Loire;85;1;08;159;Nalliers;2333;33;2366
52;Pays de la Loire;85;2;13;160;Nesmy;2961;44;3005
52;Pays de la Loire;85;3;17;161;Nieul-le-Dolent;2525;36;2561
52;Pays de la Loire;85;1;05;162;Rives-d'Autise;2082;61;2143
52;Pays de la Loire;85;3;16;163;Noirmoutier-en-l'Île;4486;102;4588
52;Pays de la Loire;85;3;16;164;Notre-Dame-de-Monts;2158;48;2206
52;Pays de la Loire;85;1;05;167;L'Orbrie;788;17;805
52;Pays de la Loire;85;2;02;169;Palluau;1106;17;1123
52;Pays de la Loire;85;1;09;171;Péault;611;23;634
52;Pays de la Loire;85;3;16;172;Le Perrier;2068;34;2102
52;Pays de la Loire;85;1;04;174;Petosse;681;18;699
52;Pays de la Loire;85;1;09;175;Les Pineaux;658;5;663
52;Pays de la Loire;85;1;05;176;Pissotte;1164;35;1199
52;Pays de la Loire;85;1;05;177;Les Velluire-sur-Vendée;1377;31;1408
52;Pays de la Loire;85;2;01;178;Le Poiré-sur-Vie;8616;270;8886
52;Pays de la Loire;85;3;17;179;Poiroux;1192;12;1204
52;Pays de la Loire;85;1;08;181;Pouillé;641;17;658
52;Pays de la Loire;85;1;06;182;Pouzauges;5565;199;5764
52;Pays de la Loire;85;1;05;184;Puy-de-Serre;324;7;331
52;Pays de la Loire;85;1;08;185;Puyravault;653;6;659
52;Pays de la Loire;85;2;10;186;La Rabatelière;1007;17;1024
52;Pays de la Loire;85;1;06;187;Réaumur;862;15;877
52;Pays de la Loire;85;1;04;188;La Réorthe;1114;14;1128
52;Pays de la Loire;85;3;16;189;Notre-Dame-de-Riez;2162;45;2207
52;Pays de la Loire;85;2;01;190;Rocheservière;3467;63;3530
52;Pays de la Loire;85;2;99;191;La Roche-sur-Yon;55213;2955;58168
52;Pays de la Loire;85;2;03;192;Rochetrejoux;986;17;1003
52;Pays de la Loire;85;1;09;193;Rosnay;652;17;669
52;Pays de la Loire;85;3;14;194;Les Sables-d'Olonne;46941;1460;48401
52;Pays de la Loire;85;2;10;196;Saint-André-Goule-d'Oie;1916;16;1932
52;Pays de la Loire;85;2;01;197;Montréverd;3790;60;3850
52;Pays de la Loire;85;2;11;198;Saint-Aubin-des-Ormeaux;1369;18;1387
52;Pays de la Loire;85;1;04;199;Saint-Aubin-la-Plaine;542;4;546
52;Pays de la Loire;85;3;09;200;Saint-Avaugourd-des-Landes;1106;18;1124
52;Pays de la Loire;85;3;09;201;Saint-Benoist-sur-Mer;500;6;506
52;Pays de la Loire;85;2;03;202;Sainte-Cécile;1588;113;1701
52;Pays de la Loire;85;3;02;204;Saint-Christophe-du-Ligneron;2620;44;2664
52;Pays de la Loire;85;1;04;205;Saint-Cyr-des-Gâts;539;8;547
52;Pays de la Loire;85;3;09;206;Saint-Cyr-en-Talmondais;402;13;415
52;Pays de la Loire;85;1;08;207;Saint-Denis-du-Payré;391;9;400
52;Pays de la Loire;85;2;01;208;Saint-Denis-la-Chevasse;2392;40;2432
52;Pays de la Loire;85;1;04;209;Saint-Étienne-de-Brillouet;632;11;643
52;Pays de la Loire;85;2;02;210;Saint-Étienne-du-Bois;2144;24;2168
52;Pays de la Loire;85;3;17;211;Sainte-Flaive-des-Loups;2490;24;2514
52;Pays de la Loire;85;2;09;213;Rives de l'Yon;4238;172;4410
52;Pays de la Loire;85;3;17;214;Sainte-Foy;2422;48;2470
52;Pays de la Loire;85;2;10;215;Saint-Fulgent;3839;137;3976
52;Pays de la Loire;85;1;08;216;Sainte-Gemme-la-Plaine;2077;214;2291
52;Pays de la Loire;85;3;17;218;Saint-Georges-de-Pointindoux;1721;14;1735
52;Pays de la Loire;85;2;03;220;Saint-Germain-de-Prinçay;1600;26;1626
52;Pays de la Loire;85;3;16;221;Saint-Gervais;2694;38;2732
52;Pays de la Loire;85;3;15;222;Saint-Gilles-Croix-de-Vie;7922;248;8170
52;Pays de la Loire;85;1;04;223;Sainte-Hermine;2949;59;3008
52;Pays de la Loire;85;3;15;226;Saint-Hilaire-de-Riez;12137;245;12382
52;Pays de la Loire;85;1;05;227;Saint-Hilaire-des-Loges;1911;52;1963
52;Pays de la Loire;85;1;04;229;Saint-Hilaire-de-Voust;580;12;592
52;Pays de la Loire;85;3;17;231;Saint-Hilaire-la-Forêt;799;15;814
52;Pays de la Loire;85;2;03;232;Saint-Hilaire-le-Vouhis;1094;24;1118
52;Pays de la Loire;85;1;04;233;Saint-Jean-de-Beugné;613;10;623
52;Pays de la Loire;85;3;16;234;Saint-Jean-de-Monts;8725;229;8954
52;Pays de la Loire;85;1;04;235;Saint-Juire-Champgillon;428;13;441
52;Pays de la Loire;85;3;17;236;Saint-Julien-des-Landes;1926;25;1951
52;Pays de la Loire;85;1;04;237;Saint-Laurent-de-la-Salle;389;10;399
52;Pays de la Loire;85;2;11;238;Saint-Laurent-sur-Sèvre;3724;443;4167
52;Pays de la Loire;85;3;15;239;Saint-Maixent-sur-Vie;1149;5;1154
52;Pays de la Loire;85;2;11;240;Saint-Malô-du-Bois;1616;53;1669
52;Pays de la Loire;85;2;06;242;Saint-Mars-la-Réorthe;1009;20;1029
52;Pays de la Loire;85;3;15;243;Brem-sur-Mer;2855;48;2903
52;Pays de la Loire;85;1;05;244;Saint-Martin-de-Fraigneau;820;58;878
52;Pays de la Loire;85;1;04;245;Saint-Martin-des-Fontaines;170;2;172
52;Pays de la Loire;85;2;03;246;Saint-Martin-des-Noyers;2512;39;2551
52;Pays de la Loire;85;2;11;247;Saint-Martin-des-Tilleuls;1095;18;1113
52;Pays de la Loire;85;1;04;248;Saint-Martin-Lars-en-Sainte-Hermine;420;12;432
52;Pays de la Loire;85;3;17;250;Saint-Mathurin;2340;34;2374
52;Pays de la Loire;85;1;04;251;Saint-Maurice-des-Noues;628;19;647
52;Pays de la Loire;85;1;04;252;Saint-Maurice-le-Girard;594;24;618
52;Pays de la Loire;85;1;06;254;Saint-Mesmin;1750;43;1793
52;Pays de la Loire;85;1;08;255;Saint-Michel-en-l'Herm;2339;80;2419
52;Pays de la Loire;85;1;05;256;Saint-Michel-le-Cloucq;1283;32;1315
52;Pays de la Loire;85;2;06;259;Saint-Paul-en-Pareds;1324;35;1359
52;Pays de la Loire;85;2;02;260;Saint-Paul-Mont-Penit;831;10;841
52;Pays de la Loire;85;1;09;261;Sainte-Pexine;284;12;296
52;Pays de la Loire;85;2;01;262;Saint-Philbert-de-Bouaine;3565;40;3605
52;Pays de la Loire;85;1;04;264;Saint-Pierre-du-Chemin;1330;18;1348
52;Pays de la Loire;85;1;05;265;Saint-Pierre-le-Vieux;930;21;951
52;Pays de la Loire;85;2;03;266;Saint-Prouant;1680;29;1709
52;Pays de la Loire;85;1;08;267;Sainte-Radégonde-des-Noyers;952;21;973
52;Pays de la Loire;85;3;15;268;Saint-Révérend;1472;31;1503
52;Pays de la Loire;85;1;05;269;Saint-Sigismond;421;7;428
52;Pays de la Loire;85;1;04;271;Saint-Sulpice-en-Pareds;435;13;448
52;Pays de la Loire;85;3;16;273;Saint-Urbain;1916;35;1951
52;Pays de la Loire;85;1;04;274;Saint-Valérien;533;13;546
52;Pays de la Loire;85;2;03;276;Saint-Vincent-Sterlanges;746;13;759
52;Pays de la Loire;85;3;09;277;Saint-Vincent-sur-Graon;1554;25;1579
52;Pays de la Loire;85;3;17;278;Saint-Vincent-sur-Jard;1324;21;1345
52;Pays de la Loire;85;3;02;280;Sallertaine;3232;72;3304
52;Pays de la Loire;85;1;04;281;Sérigné;999;31;1030
52;Pays de la Loire;85;2;03;282;Sigournais;914;14;928
52;Pays de la Loire;85;3;16;284;Soullans;4297;95;4392
52;Pays de la Loire;85;2;09;285;Le Tablier;748;15;763
52;Pays de la Loire;85;1;08;286;La Taillée;551;5;556
52;Pays de la Loire;85;1;06;287;Tallud-Sainte-Gemme;453;8;461
52;Pays de la Loire;85;3;17;288;Talmont-Saint-Hilaire;7933;186;8119
52;Pays de la Loire;85;1;04;289;La Tardière;1332;26;1358
52;Pays de la Loire;85;1;04;290;Thiré;544;13;557
52;Pays de la Loire;85;2;03;291;Thorigny;1235;19;1254
52;Pays de la Loire;85;1;04;292;Thouarsais-Bouildroux;778;9;787
52;Pays de la Loire;85;2;11;293;Tiffauges;1581;38;1619
52;Pays de la Loire;85;3;09;294;La Tranche-sur-Mer;2980;60;3040
52;Pays de la Loire;85;2;10;295;Treize-Septiers;3281;81;3362
52;Pays de la Loire;85;2;11;296;Treize-Vents;1247;24;1271
52;Pays de la Loire;85;1;08;297;Triaize;1011;12;1023
52;Pays de la Loire;85;3;17;298;Vairé;1814;21;1835
52;Pays de la Loire;85;2;12;300;Venansault;4698;180;4878
52;Pays de la Loire;85;2;10;301;Vendrennes;1779;46;1825
52;Pays de la Loire;85;2;11;302;Chanverrie;5468;135;5603
52;Pays de la Loire;85;1;05;303;Vix;1821;28;1849
52;Pays de la Loire;85;1;08;304;Vouillé-les-Marais;755;10;765
52;Pays de la Loire;85;1;04;305;Vouvant;846;66;912
52;Pays de la Loire;85;1;05;306;Xanton-Chassenon;733;9;742
75;Nouvelle-Aquitaine;86;2;10;001;Adriers;711;8;719
75;Nouvelle-Aquitaine;86;3;11;002;Amberre;575;14;589
75;Nouvelle-Aquitaine;86;2;09;003;Anché;340;7;347
75;Nouvelle-Aquitaine;86;1;12;004;Angles-sur-l'Anglin;345;13;358
75;Nouvelle-Aquitaine;86;1;08;005;Angliers;612;22;634
75;Nouvelle-Aquitaine;86;2;12;006;Antigny;541;17;558
75;Nouvelle-Aquitaine;86;1;03;007;Antran;1157;33;1190
75;Nouvelle-Aquitaine;86;1;08;008;Arçay;337;7;344
75;Nouvelle-Aquitaine;86;1;05;009;Archigny;1063;15;1078
75;Nouvelle-Aquitaine;86;3;18;010;Aslonnes;1115;21;1136
75;Nouvelle-Aquitaine;86;2;10;011;Asnières-sur-Blour;180;4;184
75;Nouvelle-Aquitaine;86;2;06;012;Asnois;153;4;157
75;Nouvelle-Aquitaine;86;1;08;013;Aulnay;96;3;99
75;Nouvelle-Aquitaine;86;1;05;014;Availles-en-Châtellerault;1740;40;1780
75;Nouvelle-Aquitaine;86;2;06;015;Availles-Limouzine;1237;25;1262
75;Nouvelle-Aquitaine;86;3;11;016;Avanton;2213;39;2252
75;Nouvelle-Aquitaine;86;3;19;017;Ayron;1096;16;1112
75;Nouvelle-Aquitaine;86;1;08;018;Basses;322;2;324
75;Nouvelle-Aquitaine;86;3;07;019;Beaumont Saint-Cyr;2954;40;2994
75;Nouvelle-Aquitaine;86;1;05;020;Bellefonds;252;4;256
75;Nouvelle-Aquitaine;86;1;08;022;Berrie;254;4;258
75;Nouvelle-Aquitaine;86;1;08;023;Berthegon;267;6;273
75;Nouvelle-Aquitaine;86;3;19;024;Béruges;1561;25;1586
75;Nouvelle-Aquitaine;86;2;12;025;Béthines;475;5;480
75;Nouvelle-Aquitaine;86;1;08;026;Beuxes;543;5;548
75;Nouvelle-Aquitaine;86;3;13;027;Biard;1860;38;1898
75;Nouvelle-Aquitaine;86;3;01;028;Bignoux;1072;18;1090
75;Nouvelle-Aquitaine;86;2;06;029;Blanzay;789;23;812
75;Nouvelle-Aquitaine;86;3;01;031;Bonnes;1715;24;1739
75;Nouvelle-Aquitaine;86;1;05;032;Bonneuil-Matours;2091;93;2184
75;Nouvelle-Aquitaine;86;2;10;034;Bouresse;607;13;620
75;Nouvelle-Aquitaine;86;2;12;035;Bourg-Archambault;180;1;181
75;Nouvelle-Aquitaine;86;1;08;036;Bournand;897;20;917
75;Nouvelle-Aquitaine;86;2;12;037;Brigueil-le-Chantre;491;7;498
75;Nouvelle-Aquitaine;86;2;10;038;Brion;215;8;223
75;Nouvelle-Aquitaine;86;2;09;039;Brux;740;10;750
75;Nouvelle-Aquitaine;86;2;12;040;La Bussière;310;11;321
75;Nouvelle-Aquitaine;86;3;14;041;Buxerolles;10001;126;10127
75;Nouvelle-Aquitaine;86;1;03;042;Buxeuil;913;11;924
75;Nouvelle-Aquitaine;86;1;08;044;Ceaux-en-Loudun;546;11;557
75;Nouvelle-Aquitaine;86;3;09;045;Celle-Lévescault;1352;17;1369
75;Nouvelle-Aquitaine;86;1;05;046;Cenon-sur-Vienne;1720;26;1746
75;Nouvelle-Aquitaine;86;1;08;047;Cernay;488;14;502
75;Nouvelle-Aquitaine;86;3;07;048;Chabournay;1188;18;1206
75;Nouvelle-Aquitaine;86;1;08;049;Chalais;494;16;510
75;Nouvelle-Aquitaine;86;3;19;050;Chalandray;844;13;857
75;Nouvelle-Aquitaine;86;2;06;051;Champagné-le-Sec;202;2;204
75;Nouvelle-Aquitaine;86;2;06;052;Champagné-Saint-Hilaire;992;19;1011
75;Nouvelle-Aquitaine;86;3;11;053;Champigny en Rochereau;1938;45;1983
75;Nouvelle-Aquitaine;86;2;06;054;Champniers;353;6;359
75;Nouvelle-Aquitaine;86;2;06;055;La Chapelle-Bâton;354;9;363
75;Nouvelle-Aquitaine;86;3;01;058;La Chapelle-Moulière;728;20;748
75;Nouvelle-Aquitaine;86;2;05;059;Chapelle-Viviers;590;4;594
75;Nouvelle-Aquitaine;86;2;06;061;Charroux;1099;20;1119
75;Nouvelle-Aquitaine;86;3;01;062;Chasseneuil-du-Poitou;4699;49;4748
75;Nouvelle-Aquitaine;86;2;06;063;Chatain;247;3;250
75;Nouvelle-Aquitaine;86;2;06;064;Château-Garnier;612;10;622
75;Nouvelle-Aquitaine;86;3;18;065;Château-Larcher;1048;17;1065
75;Nouvelle-Aquitaine;86;1;98;066;Châtellerault;31573;772;32345
75;Nouvelle-Aquitaine;86;2;09;068;Chaunay;1216;21;1237
75;Nouvelle-Aquitaine;86;1;08;069;La Chaussée;182;1;183
75;Nouvelle-Aquitaine;86;3;05;070;Chauvigny;7084;114;7198
75;Nouvelle-Aquitaine;86;1;04;072;Chenevelles;451;11;462
75;Nouvelle-Aquitaine;86;3;11;073;Cherves;523;11;534
75;Nouvelle-Aquitaine;86;3;19;074;Chiré-en-Montreuil;921;15;936
75;Nouvelle-Aquitaine;86;3;08;075;Chouppes;766;11;777
75;Nouvelle-Aquitaine;86;3;11;076;Cissé;2849;49;2898
75;Nouvelle-Aquitaine;86;2;10;077;Civaux;1208;17;1225
75;Nouvelle-Aquitaine;86;2;06;078;Civray;2574;134;2708
75;Nouvelle-Aquitaine;86;1;08;079;La Roche-Rigault;559;36;595
75;Nouvelle-Aquitaine;86;3;09;080;Cloué;496;5;501
75;Nouvelle-Aquitaine;86;1;02;081;Colombiers;1428;28;1456
75;Nouvelle-Aquitaine;86;2;09;082;Valence-en-Poitou;4412;129;4541
75;Nouvelle-Aquitaine;86;3;09;083;Coulombiers;1131;13;1144
75;Nouvelle-Aquitaine;86;2;12;084;Coulonges;234;4;238
75;Nouvelle-Aquitaine;86;3;08;085;Coussay;248;8;256
75;Nouvelle-Aquitaine;86;1;04;086;Coussay-les-Bois;929;17;946
75;Nouvelle-Aquitaine;86;1;08;087;Craon;183;3;186
75;Nouvelle-Aquitaine;86;3;13;088;Croutelle;889;13;902
75;Nouvelle-Aquitaine;86;3;11;089;Cuhon;389;6;395
75;Nouvelle-Aquitaine;86;1;08;090;Curçay-sur-Dive;217;1;218
75;Nouvelle-Aquitaine;86;3;09;091;Curzay-sur-Vonne;383;7;390
75;Nouvelle-Aquitaine;86;1;03;092;Dangé-Saint-Romain;2963;55;3018
75;Nouvelle-Aquitaine;86;1;08;093;Dercé;159;3;162
75;Nouvelle-Aquitaine;86;3;18;094;Dienné;581;12;593
75;Nouvelle-Aquitaine;86;3;07;095;Dissay;3264;50;3314
75;Nouvelle-Aquitaine;86;1;08;096;Doussay;660;8;668
75;Nouvelle-Aquitaine;86;2;06;097;La Ferrière-Airoux;331;5;336
75;Nouvelle-Aquitaine;86;2;05;098;Fleix;144;2;146
75;Nouvelle-Aquitaine;86;3;18;099;Fleuré;1051;8;1059
75;Nouvelle-Aquitaine;86;3;13;100;Fontaine-le-Comte;3971;75;4046
75;Nouvelle-Aquitaine;86;3;19;102;Frozes;593;8;601
75;Nouvelle-Aquitaine;86;2;10;103;Gençay;1743;64;1807
75;Nouvelle-Aquitaine;86;2;06;104;Genouillé;494;5;499
75;Nouvelle-Aquitaine;86;3;18;105;Gizay;363;1;364
75;Nouvelle-Aquitaine;86;1;08;106;Glénouze;96;2;98
75;Nouvelle-Aquitaine;86;2;10;107;Gouex;467;8;475
75;Nouvelle-Aquitaine;86;1;08;108;La Grimaudière;405;7;412
75;Nouvelle-Aquitaine;86;1;08;109;Guesnes;219;8;227
75;Nouvelle-Aquitaine;86;2;12;110;Haims;230;4;234
75;Nouvelle-Aquitaine;86;1;03;111;Ingrandes;1724;68;1792
75;Nouvelle-Aquitaine;86;2;10;112;L'Isle-Jourdain;1169;11;1180
75;Nouvelle-Aquitaine;86;3;18;113;Iteuil;2974;55;3029
75;Nouvelle-Aquitaine;86;3;01;114;Jardres;1269;29;1298
75;Nouvelle-Aquitaine;86;3;07;115;Jaunay-Marigny;7664;255;7919
75;Nouvelle-Aquitaine;86;3;09;116;Jazeneuil;788;22;810
75;Nouvelle-Aquitaine;86;2;12;117;Jouhet;526;7;533
75;Nouvelle-Aquitaine;86;2;12;118;Journet;371;9;380
75;Nouvelle-Aquitaine;86;2;06;119;Joussé;305;1;306
75;Nouvelle-Aquitaine;86;2;12;120;Lathus-Saint-Rémy;1217;15;1232
75;Nouvelle-Aquitaine;86;3;19;121;Latillé;1460;29;1489
75;Nouvelle-Aquitaine;86;2;05;122;Lauthiers;67;2;69
75;Nouvelle-Aquitaine;86;3;19;123;Boivre-la-Vallée;3079;52;3131
75;Nouvelle-Aquitaine;86;3;01;124;Lavoux;1183;15;1198
75;Nouvelle-Aquitaine;86;1;04;125;Leigné-les-Bois;595;13;608
75;Nouvelle-Aquitaine;86;2;05;126;Leignes-sur-Fontaine;647;13;660
75;Nouvelle-Aquitaine;86;1;03;127;Leigné-sur-Usseau;462;3;465
75;Nouvelle-Aquitaine;86;1;02;128;Lencloître;2474;39;2513
75;Nouvelle-Aquitaine;86;1;04;129;Lésigny;522;8;530
75;Nouvelle-Aquitaine;86;1;03;130;Leugny;378;3;381
75;Nouvelle-Aquitaine;86;2;10;131;Lhommaizé;892;24;916
75;Nouvelle-Aquitaine;86;2;12;132;Liglet;309;3;312
75;Nouvelle-Aquitaine;86;3;17;133;Ligugé;3394;58;3452
75;Nouvelle-Aquitaine;86;2;06;134;Linazay;219;0;219
75;Nouvelle-Aquitaine;86;3;01;135;Liniers;577;14;591
75;Nouvelle-Aquitaine;86;2;06;136;Lizant;387;8;395
75;Nouvelle-Aquitaine;86;1;08;137;Loudun;6702;350;7052
75;Nouvelle-Aquitaine;86;2;10;138;Luchapt;251;3;254
75;Nouvelle-Aquitaine;86;3;09;139;Lusignan;2622;58;2680
75;Nouvelle-Aquitaine;86;2;10;140;Lussac-les-Châteaux;2271;47;2318
75;Nouvelle-Aquitaine;86;2;06;141;Magné;672;14;686
75;Nouvelle-Aquitaine;86;3;19;142;Maillé;640;12;652
75;Nouvelle-Aquitaine;86;1;04;143;Mairé;175;4;179
75;Nouvelle-Aquitaine;86;3;11;144;Maisonneuve;322;7;329
75;Nouvelle-Aquitaine;86;3;18;145;Marçay;1192;26;1218
75;Nouvelle-Aquitaine;86;3;18;147;Marigny-Chemereau;604;8;612
75;Nouvelle-Aquitaine;86;3;18;148;Marnay;713;12;725
75;Nouvelle-Aquitaine;86;1;08;149;Martaizé;371;10;381
75;Nouvelle-Aquitaine;86;3;11;150;Massognes;269;7;276
75;Nouvelle-Aquitaine;86;1;08;151;Maulay;172;7;179
75;Nouvelle-Aquitaine;86;2;06;152;Mauprévoir;579;15;594
75;Nouvelle-Aquitaine;86;2;10;153;Mazerolles;865;13;878
75;Nouvelle-Aquitaine;86;1;08;154;Mazeuil;257;2;259
75;Nouvelle-Aquitaine;86;1;08;156;Messemé;239;5;244
75;Nouvelle-Aquitaine;86;3;16;157;Mignaloux-Beauvoir;5031;178;5209
75;Nouvelle-Aquitaine;86;3;11;158;Migné-Auxances;6183;115;6298
75;Nouvelle-Aquitaine;86;2;10;159;Millac;524;4;528
75;Nouvelle-Aquitaine;86;3;11;160;Mirebeau;2147;33;2180
75;Nouvelle-Aquitaine;86;1;08;161;Moncontour;993;18;1011
75;Nouvelle-Aquitaine;86;1;03;162;Mondion;112;1;113
75;Nouvelle-Aquitaine;86;3;01;163;Montamisé;3685;67;3752
75;Nouvelle-Aquitaine;86;1;05;164;Monthoiron;667;5;672
75;Nouvelle-Aquitaine;86;2;12;165;Montmorillon;5914;458;6372
75;Nouvelle-Aquitaine;86;1;08;167;Monts-sur-Guesnes;916;6;922
75;Nouvelle-Aquitaine;86;1;08;169;Morton;359;5;364
75;Nouvelle-Aquitaine;86;2;12;170;Moulismes;367;12;379
75;Nouvelle-Aquitaine;86;2;10;171;Moussac;437;14;451
75;Nouvelle-Aquitaine;86;2;10;172;Mouterre-sur-Blourde;160;4;164
75;Nouvelle-Aquitaine;86;1;08;173;Mouterre-Silly;659;13;672
75;Nouvelle-Aquitaine;86;1;02;174;Naintré;5933;116;6049
75;Nouvelle-Aquitaine;86;2;12;175;Nalliers;308;12;320
75;Nouvelle-Aquitaine;86;2;10;176;Nérignac;123;5;128
75;Nouvelle-Aquitaine;86;3;11;177;Neuville-de-Poitou;5376;83;5459
75;Nouvelle-Aquitaine;86;3;18;178;Nieuil-l'Espoir;2777;39;2816
75;Nouvelle-Aquitaine;86;3;18;180;Nouaillé-Maupertuis;2895;52;2947
75;Nouvelle-Aquitaine;86;1;08;181;Nueil-sous-Faye;212;9;221
75;Nouvelle-Aquitaine;86;1;03;182;Orches;362;8;370
75;Nouvelle-Aquitaine;86;1;03;183;Les Ormes;1611;20;1631
75;Nouvelle-Aquitaine;86;1;02;184;Ouzilly;949;12;961
75;Nouvelle-Aquitaine;86;1;03;186;Oyré;956;18;974
75;Nouvelle-Aquitaine;86;2;05;187;Paizay-le-Sec;461;13;474
75;Nouvelle-Aquitaine;86;2;06;189;Payroux;468;6;474
75;Nouvelle-Aquitaine;86;2;10;190;Persac;720;13;733
75;Nouvelle-Aquitaine;86;2;12;191;Pindray;246;5;251
75;Nouvelle-Aquitaine;86;2;12;192;Plaisance;176;3;179
75;Nouvelle-Aquitaine;86;1;04;193;Pleumartin;1203;12;1215
75;Nouvelle-Aquitaine;86;3;99;194;Poitiers;90033;2263;92296
75;Nouvelle-Aquitaine;86;1;03;195;Port-de-Piles;563;7;570
75;Nouvelle-Aquitaine;86;1;08;196;Pouançay;233;4;237
75;Nouvelle-Aquitaine;86;1;08;197;Pouant;418;12;430
75;Nouvelle-Aquitaine;86;3;01;198;Pouillé;709;9;718
75;Nouvelle-Aquitaine;86;2;06;200;Pressac;561;12;573
75;Nouvelle-Aquitaine;86;1;08;201;Prinçay;209;2;211
75;Nouvelle-Aquitaine;86;3;12;202;La Puye;600;9;609
75;Nouvelle-Aquitaine;86;2;10;203;Queaux;549;11;560
75;Nouvelle-Aquitaine;86;3;19;204;Quinçay;2132;55;2187
75;Nouvelle-Aquitaine;86;1;08;205;Ranton;204;3;207
75;Nouvelle-Aquitaine;86;1;08;206;Raslay;137;4;141
75;Nouvelle-Aquitaine;86;1;04;207;La Roche-Posay;1569;32;1601
75;Nouvelle-Aquitaine;86;3;18;209;Roches-Prémarie-Andillé;2071;34;2105
75;Nouvelle-Aquitaine;86;1;08;210;Roiffé;750;20;770
75;Nouvelle-Aquitaine;86;2;09;211;Romagne;869;99;968
75;Nouvelle-Aquitaine;86;3;09;213;Rouillé;2498;187;2685
75;Nouvelle-Aquitaine;86;3;17;214;Saint-Benoît;7308;195;7503
75;Nouvelle-Aquitaine;86;1;03;217;Saint-Christophe;284;11;295
75;Nouvelle-Aquitaine;86;1;08;218;Saint-Clair;198;8;206
75;Nouvelle-Aquitaine;86;2;06;220;Saint-Gaudent;313;8;321
75;Nouvelle-Aquitaine;86;1;02;221;Saint-Genest-d'Ambière;1197;21;1218
75;Nouvelle-Aquitaine;86;3;07;222;Saint-Georges-lès-Baillargeaux;4265;55;4320
75;Nouvelle-Aquitaine;86;2;12;223;Saint-Germain;904;24;928
75;Nouvelle-Aquitaine;86;1;03;224;Saint-Gervais-les-Trois-Clochers;1333;31;1364
75;Nouvelle-Aquitaine;86;1;08;225;Saint-Jean-de-Sauves;1369;22;1391
75;Nouvelle-Aquitaine;86;3;01;226;Saint-Julien-l'Ars;2838;50;2888
75;Nouvelle-Aquitaine;86;1;08;227;Saint-Laon;135;4;139
75;Nouvelle-Aquitaine;86;2;10;228;Saint-Laurent-de-Jourdes;199;3;202
75;Nouvelle-Aquitaine;86;1;08;229;Saint-Léger-de-Montbrillais;340;5;345
75;Nouvelle-Aquitaine;86;2;12;230;Saint-Léomer;170;3;173
75;Nouvelle-Aquitaine;86;2;06;231;Saint-Macoux;481;17;498
75;Nouvelle-Aquitaine;86;2;05;233;Valdivienne;2753;42;2795
75;Nouvelle-Aquitaine;86;2;06;234;Saint-Martin-l'Ars;383;3;386
75;Nouvelle-Aquitaine;86;2;10;235;Saint-Maurice-la-Clouère;1305;36;1341
75;Nouvelle-Aquitaine;86;2;12;236;Saint-Pierre-de-Maillé;885;15;900
75;Nouvelle-Aquitaine;86;2;06;237;Saint-Pierre-d'Exideuil;768;20;788
75;Nouvelle-Aquitaine;86;3;05;239;Sainte-Radégonde;176;0;176
75;Nouvelle-Aquitaine;86;1;03;241;Saint-Rémy-sur-Creuse;412;6;418
75;Nouvelle-Aquitaine;86;2;06;242;Saint-Romain;393;7;400
75;Nouvelle-Aquitaine;86;3;09;244;Saint-Sauvant;1268;29;1297
75;Nouvelle-Aquitaine;86;1;04;245;Senillé-Saint-Sauveur;1754;41;1795
75;Nouvelle-Aquitaine;86;2;12;246;Saint-Savin;817;16;833
75;Nouvelle-Aquitaine;86;2;06;247;Saint-Saviol;535;13;548
75;Nouvelle-Aquitaine;86;2;10;248;Saint-Secondin;536;17;553
75;Nouvelle-Aquitaine;86;1;08;249;Saires;125;1;126
75;Nouvelle-Aquitaine;86;1;08;250;Saix;289;5;294
75;Nouvelle-Aquitaine;86;1;08;252;Sammarçolles;650;17;667
75;Nouvelle-Aquitaine;86;3;09;253;Sanxay;549;11;560
75;Nouvelle-Aquitaine;86;2;12;254;Saulgé;1001;10;1011
75;Nouvelle-Aquitaine;86;2;06;255;Savigné;1303;25;1328
75;Nouvelle-Aquitaine;86;3;01;256;Savigny-Lévescault;1208;25;1233
75;Nouvelle-Aquitaine;86;1;03;257;Savigny-sous-Faye;369;5;374
75;Nouvelle-Aquitaine;86;1;02;258;Scorbé-Clairvaux;2209;46;2255
75;Nouvelle-Aquitaine;86;1;03;260;Sérigny;313;1;314
75;Nouvelle-Aquitaine;86;3;01;261;Sèvres-Anxaumont;2256;76;2332
75;Nouvelle-Aquitaine;86;2;10;262;Sillars;582;15;597
75;Nouvelle-Aquitaine;86;3;18;263;Smarves;2910;47;2957
75;Nouvelle-Aquitaine;86;2;06;264;Sommières-du-Clain;746;17;763
75;Nouvelle-Aquitaine;86;1;03;265;Sossais;423;7;430
75;Nouvelle-Aquitaine;86;2;06;266;Surin;136;1;137
75;Nouvelle-Aquitaine;86;3;01;268;Tercé;1124;15;1139
75;Nouvelle-Aquitaine;86;1;08;269;Ternay;190;3;193
75;Nouvelle-Aquitaine;86;2;12;270;Thollet;155;3;158
75;Nouvelle-Aquitaine;86;3;11;271;Thurageau;787;15;802
75;Nouvelle-Aquitaine;86;1;02;272;Thuré;2843;146;2989
75;Nouvelle-Aquitaine;86;2;12;273;La Trimouille;859;22;881
75;Nouvelle-Aquitaine;86;1;08;274;Les Trois-Moutiers;1091;25;1116
75;Nouvelle-Aquitaine;86;1;03;275;Usseau;600;9;609
75;Nouvelle-Aquitaine;86;2;10;276;Usson-du-Poitou;1245;22;1267
75;Nouvelle-Aquitaine;86;1;03;279;Vaux-sur-Vienne;540;12;552
75;Nouvelle-Aquitaine;86;1;03;280;Vellèches;355;6;361
75;Nouvelle-Aquitaine;86;3;07;281;Saint-Martin-la-Pallu;5594;86;5680
75;Nouvelle-Aquitaine;86;3;18;284;Vernon;717;12;729
75;Nouvelle-Aquitaine;86;2;10;285;Verrières;951;25;976
75;Nouvelle-Aquitaine;86;1;08;286;Verrue;387;4;391
75;Nouvelle-Aquitaine;86;1;08;287;Vézières;357;6;363
75;Nouvelle-Aquitaine;86;1;04;288;Vicq-sur-Gartempe;625;9;634
75;Nouvelle-Aquitaine;86;2;10;289;Le Vigeant;667;30;697
75;Nouvelle-Aquitaine;86;3;18;290;La Villedieu-du-Clain;1536;33;1569
75;Nouvelle-Aquitaine;86;2;12;291;Villemort;102;7;109
75;Nouvelle-Aquitaine;86;3;11;292;Villiers;933;18;951
75;Nouvelle-Aquitaine;86;3;18;293;Vivonne;4437;73;4510
75;Nouvelle-Aquitaine;86;3;19;294;Vouillé;3677;74;3751
75;Nouvelle-Aquitaine;86;2;06;295;Voulême;391;5;396
75;Nouvelle-Aquitaine;86;2;09;296;Voulon;470;9;479
75;Nouvelle-Aquitaine;86;3;19;297;Vouneuil-sous-Biard;6142;144;6286
75;Nouvelle-Aquitaine;86;1;05;298;Vouneuil-sur-Vienne;2284;45;2329
75;Nouvelle-Aquitaine;86;3;11;299;Vouzailles;572;9;581
75;Nouvelle-Aquitaine;86;3;11;300;Yversay;617;5;622
75;Nouvelle-Aquitaine;87;2;01;001;Aixe-sur-Vienne;5809;78;5887
75;Nouvelle-Aquitaine;87;2;02;002;Ambazac;5556;69;5625
75;Nouvelle-Aquitaine;87;1;04;003;Arnac-la-Poste;928;25;953
75;Nouvelle-Aquitaine;87;2;07;004;Augne;114;2;116
75;Nouvelle-Aquitaine;87;2;20;005;Aureil;1009;20;1029
75;Nouvelle-Aquitaine;87;1;04;006;Azat-le-Ris;240;0;240
75;Nouvelle-Aquitaine;87;1;04;007;Balledent;196;2;198
75;Nouvelle-Aquitaine;87;1;04;008;La Bazeuge;148;0;148
75;Nouvelle-Aquitaine;87;2;07;009;Beaumont-du-Lac;141;5;146
75;Nouvelle-Aquitaine;87;1;03;011;Bellac;3619;125;3744
75;Nouvelle-Aquitaine;87;1;03;012;Berneuil;440;5;445
75;Nouvelle-Aquitaine;87;2;02;013;Bersac-sur-Rivalier;658;16;674
75;Nouvelle-Aquitaine;87;1;02;014;Bessines-sur-Gartempe;2787;57;2844
75;Nouvelle-Aquitaine;87;2;01;015;Beynac;711;71;782
75;Nouvelle-Aquitaine;87;2;02;016;Les Billanges;287;5;292
75;Nouvelle-Aquitaine;87;1;03;017;Blanzac;500;10;510
75;Nouvelle-Aquitaine;87;1;03;018;Blond;693;24;717
75;Nouvelle-Aquitaine;87;2;05;019;Boisseuil;2925;63;2988
75;Nouvelle-Aquitaine;87;2;02;020;Bonnac-la-Côte;1655;27;1682
75;Nouvelle-Aquitaine;87;2;01;021;Bosmie-l'Aiguille;2612;33;2645
75;Nouvelle-Aquitaine;87;1;03;022;Breuilaufa;117;1;118
75;Nouvelle-Aquitaine;87;1;03;023;Le Buis;187;4;191
75;Nouvelle-Aquitaine;87;2;07;024;Bujaleuf;833;9;842
75;Nouvelle-Aquitaine;87;2;01;025;Burgnac;853;12;865
75;Nouvelle-Aquitaine;87;2;21;027;Bussière-Galant;1268;15;1283
75;Nouvelle-Aquitaine;87;1;04;028;Val-d'Oire-et-Gartempe;1669;21;1690
75;Nouvelle-Aquitaine;87;2;21;029;Les Cars;620;11;631
75;Nouvelle-Aquitaine;87;3;19;030;Chaillac-sur-Vienne;1254;23;1277
75;Nouvelle-Aquitaine;87;2;21;031;Le Chalard;307;4;311
75;Nouvelle-Aquitaine;87;2;21;032;Châlus;1647;31;1678
75;Nouvelle-Aquitaine;87;1;03;033;Chamboret;795;9;804
75;Nouvelle-Aquitaine;87;3;18;034;Champagnac-la-Rivière;568;8;576
75;Nouvelle-Aquitaine;87;2;20;035;Champnétery;520;9;529
75;Nouvelle-Aquitaine;87;3;18;036;Champsac;674;10;684
75;Nouvelle-Aquitaine;87;3;18;037;La Chapelle-Montbrandeix;263;2;265
75;Nouvelle-Aquitaine;87;2;06;038;Chaptelat;2093;17;2110
75;Nouvelle-Aquitaine;87;2;07;039;Château-Chervix;798;13;811
75;Nouvelle-Aquitaine;87;2;07;040;Châteauneuf-la-Forêt;1524;18;1542
75;Nouvelle-Aquitaine;87;1;04;041;Châteauponsac;2036;21;2057
75;Nouvelle-Aquitaine;87;2;20;042;Le Châtenet-en-Dognon;384;6;390
75;Nouvelle-Aquitaine;87;2;07;043;Cheissoux;217;1;218
75;Nouvelle-Aquitaine;87;3;18;044;Chéronnac;317;5;322
75;Nouvelle-Aquitaine;87;1;03;045;Cieux;1002;22;1024
75;Nouvelle-Aquitaine;87;3;18;046;Cognac-la-Forêt;1191;8;1199
75;Nouvelle-Aquitaine;87;1;03;047;Compreignac;1867;16;1883
75;Nouvelle-Aquitaine;87;2;05;048;Condat-sur-Vienne;5117;67;5184
75;Nouvelle-Aquitaine;87;2;07;049;Coussac-Bonneval;1302;27;1329
75;Nouvelle-Aquitaine;87;2;06;050;Couzeix;9612;160;9772
75;Nouvelle-Aquitaine;87;2;07;051;La Croisille-sur-Briance;613;11;624
75;Nouvelle-Aquitaine;87;1;04;052;La Croix-sur-Gartempe;174;3;177
75;Nouvelle-Aquitaine;87;1;04;053;Cromac;239;2;241
75;Nouvelle-Aquitaine;87;3;18;054;Cussac;1184;15;1199
75;Nouvelle-Aquitaine;87;1;04;056;Dinsac;265;5;270
75;Nouvelle-Aquitaine;87;1;04;057;Dompierre-les-Églises;371;5;376
75;Nouvelle-Aquitaine;87;2;07;058;Domps;101;3;104
75;Nouvelle-Aquitaine;87;1;04;059;Le Dorat;1535;59;1594
75;Nouvelle-Aquitaine;87;3;18;060;Dournazac;669;9;678
75;Nouvelle-Aquitaine;87;1;04;061;Droux;346;5;351
75;Nouvelle-Aquitaine;87;2;20;062;Eybouleuf;467;8;475
75;Nouvelle-Aquitaine;87;2;05;063;Eyjeaux;1313;20;1333
75;Nouvelle-Aquitaine;87;2;07;064;Eymoutiers;2087;20;2107
75;Nouvelle-Aquitaine;87;2;17;065;Feytiat;6120;71;6191
75;Nouvelle-Aquitaine;87;2;21;066;Flavignac;1070;13;1083
75;Nouvelle-Aquitaine;87;1;02;067;Folles;456;8;464
75;Nouvelle-Aquitaine;87;1;02;068;Fromental;516;16;532
75;Nouvelle-Aquitaine;87;1;03;069;Gajoubert;145;1;146
75;Nouvelle-Aquitaine;87;2;20;070;La Geneytouse;979;16;995
75;Nouvelle-Aquitaine;87;2;21;071;Glandon;790;13;803
75;Nouvelle-Aquitaine;87;2;07;072;Glanges;507;10;517
75;Nouvelle-Aquitaine;87;3;18;073;Gorre;389;9;398
75;Nouvelle-Aquitaine;87;1;04;074;Les Grands-Chézeaux;240;6;246
75;Nouvelle-Aquitaine;87;2;16;075;Isle;7869;136;8005
75;Nouvelle-Aquitaine;87;2;02;076;Jabreilles-les-Bordes;236;3;239
75;Nouvelle-Aquitaine;87;2;21;077;Janailhac;528;9;537
75;Nouvelle-Aquitaine;87;3;19;078;Javerdat;693;5;698
75;Nouvelle-Aquitaine;87;2;02;079;La Jonchère-Saint-Maurice;826;13;839
75;Nouvelle-Aquitaine;87;1;04;080;Jouac;176;3;179
75;Nouvelle-Aquitaine;87;2;01;081;Jourgnac;1104;14;1118
75;Nouvelle-Aquitaine;87;2;21;082;Ladignac-le-Long;1156;12;1168
75;Nouvelle-Aquitaine;87;2;02;083;Laurière;530;7;537
75;Nouvelle-Aquitaine;87;2;21;084;Lavignac;164;4;168
75;Nouvelle-Aquitaine;87;2;99;085;Limoges;130592;2176;132768
75;Nouvelle-Aquitaine;87;2;07;086;Linards;1016;17;1033
75;Nouvelle-Aquitaine;87;1;04;087;Lussac-les-Églises;466;3;469
75;Nouvelle-Aquitaine;87;2;07;088;Magnac-Bourg;1114;19;1133
75;Nouvelle-Aquitaine;87;1;04;089;Magnac-Laval;1705;166;1871
75;Nouvelle-Aquitaine;87;1;04;090;Mailhac-sur-Benaize;263;5;268
75;Nouvelle-Aquitaine;87;3;18;091;Maisonnais-sur-Tardoire;382;7;389
75;Nouvelle-Aquitaine;87;3;18;092;Marval;495;6;501
75;Nouvelle-Aquitaine;87;2;07;093;Masléon;282;3;285
75;Nouvelle-Aquitaine;87;2;21;094;Meilhac;522;4;526
75;Nouvelle-Aquitaine;87;2;07;095;Meuzac;731;14;745
75;Nouvelle-Aquitaine;87;2;21;096;La Meyze;843;20;863
75;Nouvelle-Aquitaine;87;1;03;097;Val d'Issoire;1013;12;1025
75;Nouvelle-Aquitaine;87;2;20;099;Moissannes;332;16;348
75;Nouvelle-Aquitaine;87;1;03;100;Montrol-Sénard;260;2;262
75;Nouvelle-Aquitaine;87;1;03;101;Mortemart;123;1;124
75;Nouvelle-Aquitaine;87;1;03;103;Nantiat;1604;22;1626
75;Nouvelle-Aquitaine;87;2;07;104;Nedde;454;4;458
75;Nouvelle-Aquitaine;87;2;07;105;Neuvic-Entier;907;16;923
75;Nouvelle-Aquitaine;87;2;21;106;Nexon;2511;45;2556
75;Nouvelle-Aquitaine;87;2;06;107;Nieul;1629;17;1646
75;Nouvelle-Aquitaine;87;1;03;108;Nouic;451;8;459
75;Nouvelle-Aquitaine;87;1;04;109;Oradour-Saint-Genest;328;34;362
75;Nouvelle-Aquitaine;87;3;19;110;Oradour-sur-Glane;2478;21;2499
75;Nouvelle-Aquitaine;87;3;18;111;Oradour-sur-Vayres;1527;27;1554
75;Nouvelle-Aquitaine;87;2;21;112;Pageas;597;8;605
75;Nouvelle-Aquitaine;87;2;12;113;Le Palais-sur-Vienne;6008;58;6066
75;Nouvelle-Aquitaine;87;2;17;114;Panazol;11002;183;11185
75;Nouvelle-Aquitaine;87;3;18;115;Pensol;174;2;176
75;Nouvelle-Aquitaine;87;1;03;116;Peyrat-de-Bellac;1049;16;1065
75;Nouvelle-Aquitaine;87;2;07;117;Peyrat-le-Château;1029;15;1044
75;Nouvelle-Aquitaine;87;2;06;118;Peyrilhac;1307;18;1325
75;Nouvelle-Aquitaine;87;2;05;119;Pierre-Buffière;1163;11;1174
75;Nouvelle-Aquitaine;87;2;07;120;La Porcherie;505;11;516
75;Nouvelle-Aquitaine;87;1;04;121;Rancon;482;10;492
75;Nouvelle-Aquitaine;87;1;02;122;Razès;1169;12;1181
75;Nouvelle-Aquitaine;87;2;07;123;Rempnat;148;0;148
75;Nouvelle-Aquitaine;87;2;21;124;Rilhac-Lastours;373;3;376
75;Nouvelle-Aquitaine;87;2;12;125;Rilhac-Rancon;4655;70;4725
75;Nouvelle-Aquitaine;87;3;18;126;Rochechouart;3725;47;3772
75;Nouvelle-Aquitaine;87;2;21;127;La Roche-l'Abeille;597;14;611
75;Nouvelle-Aquitaine;87;1;03;128;Saint-Pardoux-le-Lac;1330;15;1345
75;Nouvelle-Aquitaine;87;2;20;129;Royères;951;7;958
75;Nouvelle-Aquitaine;87;2;07;130;Roziers-Saint-Georges;168;0;168
75;Nouvelle-Aquitaine;87;3;19;131;Saillat-sur-Vienne;799;11;810
75;Nouvelle-Aquitaine;87;2;07;132;Saint-Amand-le-Petit;110;4;114
75;Nouvelle-Aquitaine;87;1;04;133;Saint-Amand-Magnazeix;484;4;488
75;Nouvelle-Aquitaine;87;2;07;134;Sainte-Anne-Saint-Priest;148;3;151
75;Nouvelle-Aquitaine;87;3;18;135;Saint-Auvent;958;18;976
75;Nouvelle-Aquitaine;87;3;18;137;Saint-Bazile;138;2;140
75;Nouvelle-Aquitaine;87;2;05;138;Saint-Bonnet-Briance;560;13;573
75;Nouvelle-Aquitaine;87;1;03;139;Saint-Bonnet-de-Bellac;453;7;460
75;Nouvelle-Aquitaine;87;3;19;140;Saint-Brice-sur-Vienne;1665;30;1695
75;Nouvelle-Aquitaine;87;3;18;141;Saint-Cyr;679;10;689
75;Nouvelle-Aquitaine;87;2;20;142;Saint-Denis-des-Murs;543;6;549
75;Nouvelle-Aquitaine;87;2;06;143;Saint-Gence;2218;29;2247
75;Nouvelle-Aquitaine;87;2;05;144;Saint-Genest-sur-Roselle;524;5;529
75;Nouvelle-Aquitaine;87;1;04;145;Saint-Georges-les-Landes;235;1;236
75;Nouvelle-Aquitaine;87;2;07;146;Saint-Germain-les-Belles;1152;12;1164
75;Nouvelle-Aquitaine;87;2;07;147;Saint-Gilles-les-Forêts;46;2;48
75;Nouvelle-Aquitaine;87;2;05;148;Saint-Hilaire-Bonneval;996;11;1007
75;Nouvelle-Aquitaine;87;1;04;149;Saint-Hilaire-la-Treille;364;4;368
75;Nouvelle-Aquitaine;87;2;21;150;Saint-Hilaire-les-Places;831;14;845
75;Nouvelle-Aquitaine;87;2;05;151;Saint-Jean-Ligoure;494;8;502
75;Nouvelle-Aquitaine;87;2;06;152;Saint-Jouvent;1658;24;1682
75;Nouvelle-Aquitaine;87;2;07;153;Saint-Julien-le-Petit;292;0;292
75;Nouvelle-Aquitaine;87;3;19;154;Saint-Junien;11295;305;11600
75;Nouvelle-Aquitaine;87;1;03;155;Saint-Junien-les-Combes;181;7;188
75;Nouvelle-Aquitaine;87;2;20;156;Saint-Just-le-Martel;2693;47;2740
75;Nouvelle-Aquitaine;87;2;02;157;Saint-Laurent-les-Églises;829;33;862
75;Nouvelle-Aquitaine;87;3;18;158;Saint-Laurent-sur-Gorre;1409;14;1423
75;Nouvelle-Aquitaine;87;2;02;159;Saint-Léger-la-Montagne;351;2;353
75;Nouvelle-Aquitaine;87;1;04;160;Saint-Léger-Magnazeix;497;4;501
75;Nouvelle-Aquitaine;87;2;20;161;Saint-Léonard-de-Noblat;4357;111;4468
75;Nouvelle-Aquitaine;87;3;18;162;Sainte-Marie-de-Vaux;202;2;204
75;Nouvelle-Aquitaine;87;1;03;163;Saint-Martial-sur-Isop;140;3;143
75;Nouvelle-Aquitaine;87;3;19;164;Saint-Martin-de-Jussac;567;10;577
75;Nouvelle-Aquitaine;87;1;04;165;Saint-Martin-le-Mault;141;1;142
75;Nouvelle-Aquitaine;87;2;01;166;Saint-Martin-le-Vieux;913;11;924
75;Nouvelle-Aquitaine;87;2;20;167;Saint-Martin-Terressus;553;5;558
75;Nouvelle-Aquitaine;87;3;18;168;Saint-Mathieu;1077;14;1091
75;Nouvelle-Aquitaine;87;2;05;169;Saint-Maurice-les-Brousses;1048;24;1072
75;Nouvelle-Aquitaine;87;2;07;170;Saint-Méard;356;5;361
75;Nouvelle-Aquitaine;87;1;04;172;Saint-Ouen-sur-Gartempe;217;5;222
75;Nouvelle-Aquitaine;87;2;05;174;Saint-Paul;1222;23;1245
75;Nouvelle-Aquitaine;87;2;07;176;Saint-Priest-Ligoure;675;5;680
75;Nouvelle-Aquitaine;87;2;01;177;Saint-Priest-sous-Aixe;1809;18;1827
75;Nouvelle-Aquitaine;87;2;20;178;Saint-Priest-Taurion;2895;32;2927
75;Nouvelle-Aquitaine;87;1;04;179;Saint-Sornin-la-Marche;233;0;233
75;Nouvelle-Aquitaine;87;1;04;180;Saint-Sornin-Leulac;571;3;574
75;Nouvelle-Aquitaine;87;2;02;181;Saint-Sulpice-Laurière;819;17;836
75;Nouvelle-Aquitaine;87;1;04;182;Saint-Sulpice-les-Feuilles;1206;17;1223
75;Nouvelle-Aquitaine;87;2;02;183;Saint-Sylvestre;920;12;932
75;Nouvelle-Aquitaine;87;3;19;185;Saint-Victurnien;1764;25;1789
75;Nouvelle-Aquitaine;87;2;07;186;Saint-Vitte-sur-Briance;321;4;325
75;Nouvelle-Aquitaine;87;2;21;187;Saint-Yrieix-la-Perche;6778;369;7147
75;Nouvelle-Aquitaine;87;2;01;188;Saint-Yrieix-sous-Aixe;435;3;438
75;Nouvelle-Aquitaine;87;3;18;189;Les Salles-Lavauguyon;145;1;146
75;Nouvelle-Aquitaine;87;2;20;190;Sauviat-sur-Vige;856;7;863
75;Nouvelle-Aquitaine;87;2;01;191;Séreilhac;2010;19;2029
75;Nouvelle-Aquitaine;87;2;05;192;Solignac;1576;23;1599
75;Nouvelle-Aquitaine;87;2;07;193;Surdoux;44;3;47
75;Nouvelle-Aquitaine;87;2;07;194;Sussac;347;3;350
75;Nouvelle-Aquitaine;87;1;04;195;Tersannes;133;1;134
75;Nouvelle-Aquitaine;87;1;03;197;Thouron;567;9;576
75;Nouvelle-Aquitaine;87;1;03;198;Vaulry;408;6;414
75;Nouvelle-Aquitaine;87;3;18;199;Vayres;725;6;731
75;Nouvelle-Aquitaine;87;1;04;200;Verneuil-Moustiers;129;0;129
75;Nouvelle-Aquitaine;87;2;01;201;Verneuil-sur-Vienne;4886;215;5101
75;Nouvelle-Aquitaine;87;2;06;202;Veyrac;2132;35;2167
75;Nouvelle-Aquitaine;87;2;07;203;Vicq-sur-Breuilh;1327;29;1356
75;Nouvelle-Aquitaine;87;3;18;204;Videix;203;4;207
75;Nouvelle-Aquitaine;87;2;05;205;Le Vigen;2271;38;2309
75;Nouvelle-Aquitaine;87;1;04;206;Villefavard;162;1;163
44;Grand Est;88;1;04;001;Les Ableuvenettes;56;0;56
44;Grand Est;88;1;04;002;Ahéville;73;3;76
44;Grand Est;88;2;17;003;Aingeville;62;1;63
44;Grand Est;88;2;04;004;Ainvelle;129;6;135
44;Grand Est;88;3;11;005;Allarmont;200;4;204
44;Grand Est;88;1;09;006;Ambacourt;282;8;290
44;Grand Est;88;2;04;007;Ameuvelle;48;1;49
44;Grand Est;88;1;11;008;Anglemont;169;3;172
44;Grand Est;88;3;07;009;Anould;3339;70;3409
44;Grand Est;88;2;09;010;Aouze;202;0;202
44;Grand Est;88;1;05;011;Arches;1628;49;1677
44;Grand Est;88;1;06;012;Archettes;1104;12;1116
44;Grand Est;88;2;09;013;Aroffe;89;0;89
44;Grand Est;88;3;07;014;Arrentès-de-Corcieux;184;5;189
44;Grand Est;88;2;10;015;Attignéville;202;3;205
44;Grand Est;88;2;04;016;Attigny;203;9;212
44;Grand Est;88;2;17;017;Aulnois;168;6;174
44;Grand Est;88;2;10;019;Autigny-la-Tour;145;3;148
44;Grand Est;88;2;10;020;Autreville;190;5;195
44;Grand Est;88;1;13;021;Autrey;280;12;292
44;Grand Est;88;2;17;022;Auzainvilliers;240;6;246
44;Grand Est;88;1;03;023;Avillers;83;0;83
44;Grand Est;88;1;03;024;Avrainville;124;0;124
44;Grand Est;88;2;10;025;Avranville;69;3;72
44;Grand Est;88;1;02;026;Aydoilles;1006;48;1054
44;Grand Est;88;1;02;027;Badménil-aux-Bois;144;6;150
44;Grand Est;88;1;06;028;La Baffe;618;94;712
44;Grand Est;88;1;16;029;La Vôge-les-Bains;1589;123;1712
44;Grand Est;88;1;04;030;Bainville-aux-Saules;151;0;151
44;Grand Est;88;2;09;031;Balléville;98;4;102
44;Grand Est;88;3;14;032;Ban-de-Laveline;1193;34;1227
44;Grand Est;88;3;11;033;Ban-de-Sapt;351;7;358
44;Grand Est;88;3;07;035;Barbey-Seroux;143;5;148
44;Grand Est;88;2;10;036;Barville;91;1;92
44;Grand Est;88;3;01;037;Basse-sur-le-Rupt;877;27;904
44;Grand Est;88;1;03;038;Battexey;36;0;36
44;Grand Est;88;1;09;039;Baudricourt;337;7;344
44;Grand Est;88;1;02;040;Bayecourt;246;5;251
44;Grand Est;88;1;04;041;Bazegney;107;8;115
44;Grand Est;88;1;11;042;Bazien;79;1;80
44;Grand Est;88;2;17;043;Bazoilles-et-Ménil;109;3;112
44;Grand Est;88;2;10;044;Bazoilles-sur-Meuse;605;16;621
44;Grand Est;88;2;10;045;Beaufremont;88;0;88
44;Grand Est;88;1;02;046;Beauménil;131;1;132
44;Grand Est;88;1;04;047;Begnécourt;148;7;155
44;Grand Est;88;1;16;048;Bellefontaine;975;26;1001
44;Grand Est;88;2;04;049;Belmont-lès-Darney;112;2;114
44;Grand Est;88;1;02;050;Belmont-sur-Buttant;302;5;307
44;Grand Est;88;2;17;051;Belmont-sur-Vair;130;1;131
44;Grand Est;88;2;04;052;Belrupt;94;2;96
44;Grand Est;88;3;11;053;Belval;155;2;157
44;Grand Est;88;3;14;054;Bertrimoutier;306;10;316
44;Grand Est;88;1;03;055;Bettegney-Saint-Brice;161;0;161
44;Grand Est;88;1;03;056;Bettoncourt;96;2;98
44;Grand Est;88;3;14;057;Le Beulay;92;2;94
44;Grand Est;88;1;09;058;Biécourt;94;5;99
44;Grand Est;88;3;02;059;Biffontaine;395;11;406
44;Grand Est;88;1;09;060;Blémerey;34;1;35
44;Grand Est;88;2;04;061;Bleurville;294;13;307
44;Grand Est;88;2;04;062;Blevaincourt;93;2;95
44;Grand Est;88;1;04;063;Bocquegney;135;6;141
44;Grand Est;88;3;02;064;Bois-de-Champ;106;0;106
44;Grand Est;88;2;04;065;Bonvillet;281;5;286
44;Grand Est;88;1;09;066;Boulaincourt;66;4;70
44;Grand Est;88;3;13;068;La Bourgonce;903;20;923
44;Grand Est;88;1;03;069;Bouxières-aux-Bois;136;6;142
44;Grand Est;88;1;03;070;Bouxurulles;176;1;177
44;Grand Est;88;1;04;071;Bouzemont;52;1;53
44;Grand Est;88;1;03;073;Brantigny;209;3;212
44;Grand Est;88;2;10;074;Brechainville;60;0;60
44;Grand Est;88;3;01;075;La Bresse;4139;150;4289
44;Grand Est;88;1;02;076;Brouvelieures;427;8;435
44;Grand Est;88;1;11;077;Brû;568;13;581
44;Grand Est;88;1;02;078;Bruyères;3028;41;3069
44;Grand Est;88;2;17;079;Bulgnéville;1537;103;1640
44;Grand Est;88;1;03;080;Bult;310;3;313
44;Grand Est;88;1;15;081;Bussang;1339;22;1361
44;Grand Est;88;3;11;082;Celles-sur-Plaine;773;17;790
44;Grand Est;88;2;10;083;Certilleux;213;10;223
44;Grand Est;88;1;03;084;Chamagne;458;4;462
44;Grand Est;88;3;02;085;Champdray;191;2;193
44;Grand Est;88;1;02;086;Champ-le-Duc;505;23;528
44;Grand Est;88;1;05;087;Chantraine;3190;95;3285
44;Grand Est;88;1;16;088;La Chapelle-aux-Bois;674;6;680
44;Grand Est;88;3;07;089;La Chapelle-devant-Bruyères;555;13;568
44;Grand Est;88;1;03;090;Charmes;4625;52;4677
44;Grand Est;88;1;02;091;Charmois-devant-Bruyères;384;9;393
44;Grand Est;88;1;16;092;Charmois-l'Orgueilleux;586;9;595
44;Grand Est;88;3;11;093;Châtas;39;1;40
44;Grand Est;88;1;03;094;Châtel-sur-Moselle;1718;48;1766
44;Grand Est;88;2;09;095;Châtenois;1719;26;1745
44;Grand Est;88;2;04;096;Châtillon-sur-Saône;110;7;117
44;Grand Est;88;1;09;097;Chauffecourt;42;0;42
44;Grand Est;88;1;05;098;Chaumousey;893;24;917
44;Grand Est;88;1;08;099;Chavelot;1364;22;1386
44;Grand Est;88;1;09;100;Chef-Haut;47;2;49
44;Grand Est;88;1;02;101;Cheniménil;1242;22;1264
44;Grand Est;88;2;10;102;Chermisey;93;1;94
44;Grand Est;88;1;04;103;Circourt;85;0;85
44;Grand Est;88;2;10;104;Circourt-sur-Mouzon;183;10;193
44;Grand Est;88;2;04;105;Claudon;213;4;217
44;Grand Est;88;3;07;106;Ban-sur-Meurthe-Clefcy;952;23;975
44;Grand Est;88;2;10;107;Clérey-la-Côte;32;0;32
44;Grand Est;88;1;16;108;Le Clerjus;479;15;494
44;Grand Est;88;3;12;109;Cleurie;647;13;660
44;Grand Est;88;1;03;110;Clézentaine;221;4;225
44;Grand Est;88;3;14;111;Coinches;352;4;356
44;Grand Est;88;3;14;113;Combrimont;134;1;135
44;Grand Est;88;2;17;114;Contrexéville;3105;210;3315
44;Grand Est;88;3;07;115;Corcieux;1500;12;1512
44;Grand Est;88;3;01;116;Cornimont;3062;72;3134
44;Grand Est;88;2;09;117;Courcelles-sous-Châtenois;78;1;79
44;Grand Est;88;2;10;118;Coussey;711;17;728
44;Grand Est;88;2;17;119;Crainvilliers;178;2;180
44;Grand Est;88;3;14;120;La Croix-aux-Mines;478;9;487
44;Grand Est;88;1;03;121;Damas-aux-Bois;272;6;278
44;Grand Est;88;1;04;122;Damas-et-Bettegney;367;7;374
44;Grand Est;88;2;04;123;Damblain;251;5;256
44;Grand Est;88;2;04;124;Darney;1065;53;1118
44;Grand Est;88;2;09;125;Darney-aux-Chênes;67;1;68
44;Grand Est;88;1;08;126;Darnieulles;1369;31;1400
44;Grand Est;88;1;03;127;Deinvillers;56;2;58
44;Grand Est;88;3;11;128;Denipaire;249;6;255
44;Grand Est;88;1;03;129;Derbamont;109;2;111
44;Grand Est;88;1;02;130;Destord;244;5;249
44;Grand Est;88;1;02;131;Deycimont;306;13;319
44;Grand Est;88;1;06;132;Deyvillers;1358;36;1394
44;Grand Est;88;1;06;133;Dignonville;210;9;219
44;Grand Est;88;1;05;134;Dinozé;633;16;649
44;Grand Est;88;1;02;135;Docelles;864;19;883
44;Grand Est;88;1;06;136;Dogneville;1504;28;1532
44;Grand Est;88;2;09;137;Dolaincourt;101;0;101
44;Grand Est;88;2;04;138;Dombasle-devant-Darney;78;2;80
44;Grand Est;88;1;09;139;Dombasle-en-Xaintois;120;1;121
44;Grand Est;88;2;17;140;Dombrot-le-Sec;367;14;381
44;Grand Est;88;2;17;141;Dombrot-sur-Vair;241;2;243
44;Grand Est;88;1;08;142;Domèvre-sur-Avière;420;9;429
44;Grand Est;88;1;02;143;Domèvre-sur-Durbion;264;14;278
44;Grand Est;88;2;17;144;Domèvre-sous-Montfort;58;0;58
44;Grand Est;88;1;02;145;Domfaing;213;2;215
44;Grand Est;88;2;17;146;Domjulien;174;2;176
44;Grand Est;88;1;04;147;Dommartin-aux-Bois;389;9;398
44;Grand Est;88;1;15;148;Dommartin-lès-Remiremont;1879;50;1929
44;Grand Est;88;2;04;149;Dommartin-lès-Vallois;53;0;53
44;Grand Est;88;2;09;150;Dommartin-sur-Vraine;295;6;301
44;Grand Est;88;1;04;151;Dompaire;1098;26;1124
44;Grand Est;88;1;02;152;Dompierre;244;14;258
44;Grand Est;88;1;11;153;Domptail;344;7;351
44;Grand Est;88;2;10;154;Domrémy-la-Pucelle;88;2;90
44;Grand Est;88;1;09;155;Domvallier;100;8;108
44;Grand Est;88;1;11;156;Doncières;140;0;140
44;Grand Est;88;1;16;157;Dounoux;861;15;876
44;Grand Est;88;1;12;158;Éloyes;3110;58;3168
44;Grand Est;88;3;14;159;Entre-deux-Eaux;500;13;513
44;Grand Est;88;1;98;160;Épinal;31832;1385;33217
44;Grand Est;88;2;04;161;Escles;418;10;428
44;Grand Est;88;2;04;162;Esley;185;3;188
44;Grand Est;88;1;03;163;Essegney;746;9;755
44;Grand Est;88;2;17;164;Estrennes;97;1;98
44;Grand Est;88;3;11;165;Étival-Clairefontaine;2558;59;2617
44;Grand Est;88;1;03;166;Évaux-et-Ménil;361;3;364
44;Grand Est;88;1;01;167;Faucompierre;231;3;234
44;Grand Est;88;1;03;168;Fauconcourt;142;2;144
44;Grand Est;88;1;02;169;Fays;212;6;218
44;Grand Est;88;1;15;170;Ferdrupt;724;17;741
44;Grand Est;88;2;04;171;Fignévelle;48;1;49
44;Grand Est;88;1;02;172;Fiménil;227;4;231
44;Grand Est;88;1;03;173;Florémont;477;12;489
44;Grand Est;88;1;08;174;Fomerey;147;4;151
44;Grand Est;88;1;02;175;Fontenay;462;18;480
44;Grand Est;88;1;16;176;Fontenoy-le-Château;496;34;530
44;Grand Est;88;3;01;177;La Forge;518;9;527
44;Grand Est;88;1;05;178;Les Forges;1811;69;1880
44;Grand Est;88;2;04;179;Fouchécourt;43;3;46
44;Grand Est;88;2;04;180;Frain;125;2;127
44;Grand Est;88;3;07;181;Fraize;2844;31;2875
44;Grand Est;88;3;14;182;Frapelle;198;9;207
44;Grand Est;88;2;10;183;Frebécourt;343;7;350
44;Grand Est;88;1;02;184;Fremifontaine;435;8;443
44;Grand Est;88;1;09;185;Frenelle-la-Grande;108;4;112
44;Grand Est;88;1;09;186;Frenelle-la-Petite;47;0;47
44;Grand Est;88;2;04;187;Frénois;53;3;56
44;Grand Est;88;1;15;188;Fresse-sur-Moselle;1719;35;1754
44;Grand Est;88;2;10;189;Fréville;131;4;135
44;Grand Est;88;1;08;190;Frizon;509;7;516
44;Grand Est;88;1;04;192;Gelvécourt-et-Adompt;107;1;108
44;Grand Est;88;3;14;193;Gemaingoutte;146;1;147
44;Grand Est;88;2;17;194;Gemmelaincourt;135;12;147
44;Grand Est;88;2;17;195;Gendreville;105;3;108
44;Grand Est;88;3;07;196;Gérardmer;7822;620;8442
44;Grand Est;88;3;01;197;Gerbamont;352;11;363
44;Grand Est;88;3;07;198;Gerbépal;580;17;597
44;Grand Est;88;2;04;199;Gignéville;77;1;78
44;Grand Est;88;1;08;200;Gigney;56;1;57
44;Grand Est;88;1;04;201;Girancourt;891;18;909
44;Grand Est;88;1;03;202;Gircourt-lès-Viéville;194;3;197
44;Grand Est;88;1;02;203;Girecourt-sur-Durbion;353;11;364
44;Grand Est;88;1;16;205;Girmont-Val-d'Ajol;253;17;270
44;Grand Est;88;2;09;206;Gironcourt-sur-Vraine;882;16;898
44;Grand Est;88;2;04;208;Godoncourt;115;4;119
44;Grand Est;88;1;08;209;Golbey;8882;119;9001
44;Grand Est;88;1;04;210;Gorhey;172;3;175
44;Grand Est;88;2;10;212;Grand;348;10;358
44;Grand Est;88;3;14;213;La Grande-Fosse;137;0;137
44;Grand Est;88;2;16;214;Grandrupt-de-Bains;76;3;79
44;Grand Est;88;3;11;215;Grandrupt;77;2;79
44;Grand Est;88;1;02;216;Grandvillers;738;9;747
44;Grand Est;88;3;07;218;Granges-Aumontzey;2605;56;2661
44;Grand Est;88;2;10;219;Greux;144;7;151
44;Grand Est;88;2;04;220;Grignoncourt;47;1;48
44;Grand Est;88;1;16;221;Gruey-lès-Surance;224;10;234
44;Grand Est;88;1;02;222;Gugnécourt;258;19;277
44;Grand Est;88;1;03;223;Gugney-aux-Aulx;166;3;169
44;Grand Est;88;1;03;224;Hadigny-les-Verrières;380;11;391
44;Grand Est;88;1;16;225;Hadol;2357;102;2459
44;Grand Est;88;1;04;226;Hagécourt;128;3;131
44;Grand Est;88;2;17;227;Hagnéville-et-Roncourt;86;1;87
44;Grand Est;88;1;03;228;Haillainville;178;4;182
44;Grand Est;88;2;10;229;Harchéchamp;78;2;80
44;Grand Est;88;1;03;230;Hardancourt;38;1;39
44;Grand Est;88;2;17;231;Haréville;476;18;494
44;Grand Est;88;2;10;232;Harmonville;217;3;220
44;Grand Est;88;1;04;233;Harol;638;52;690
44;Grand Est;88;1;16;236;La Haye;131;0;131
44;Grand Est;88;1;04;237;Hennecourt;360;8;368
44;Grand Est;88;2;04;238;Hennezel;389;12;401
44;Grand Est;88;1;03;239;Hergugney;130;3;133
44;Grand Est;88;1;02;240;Herpelmont;278;1;279
44;Grand Est;88;2;09;241;Houécourt;437;12;449
44;Grand Est;88;2;10;242;Houéville;43;1;44
44;Grand Est;88;1;13;243;Housseras;486;12;498
44;Grand Est;88;3;07;244;La Houssière;527;17;544
44;Grand Est;88;3;11;245;Hurbache;310;6;316
44;Grand Est;88;1;09;246;Hymont;488;12;500
44;Grand Est;88;1;08;247;Igney;1156;14;1170
44;Grand Est;88;2;04;248;Isches;173;4;177
44;Grand Est;88;2;10;249;Jainvillotte;74;3;77
44;Grand Est;88;1;12;250;Jarménil;481;5;486
44;Grand Est;88;1;13;251;Jeanménil;1115;25;1140
44;Grand Est;88;2;04;252;Jésonville;138;1;139
44;Grand Est;88;1;06;253;Jeuxey;680;13;693
44;Grand Est;88;1;03;254;Jorxey;83;1;84
44;Grand Est;88;2;10;255;Jubainville;91;3;94
44;Grand Est;88;1;02;256;Jussarupt;268;2;270
44;Grand Est;88;1;09;257;Juvaincourt;181;2;183
44;Grand Est;88;2;04;258;Lamarche;849;16;865
44;Grand Est;88;2;10;259;Landaville;298;9;307
44;Grand Est;88;1;03;260;Langley;152;1;153
44;Grand Est;88;1;02;261;Laval-sur-Vologne;631;9;640
44;Grand Est;88;1;02;262;Laveline-devant-Bruyères;580;11;591
44;Grand Est;88;1;02;263;Laveline-du-Houx;204;6;210
44;Grand Est;88;1;04;264;Légéville-et-Bonfays;61;3;64
44;Grand Est;88;2;10;265;Lemmecourt;28;0;28
44;Grand Est;88;1;02;266;Lépanges-sur-Vologne;827;16;843
44;Grand Est;88;2;04;267;Lerrain;447;16;463
44;Grand Est;88;3;14;268;Lesseux;139;8;147
44;Grand Est;88;3;07;269;Liézey;297;7;304
44;Grand Est;88;2;10;270;Liffol-le-Grand;2124;60;2184
44;Grand Est;88;2;17;271;Lignéville;302;7;309
44;Grand Est;88;2;04;272;Lironcourt;73;0;73
44;Grand Est;88;1;06;273;Longchamp;453;8;461
44;Grand Est;88;2;09;274;Longchamp-sous-Châtenois;81;2;83
44;Grand Est;88;3;14;275;Lubine;242;2;244
44;Grand Est;88;3;14;276;Lusse;376;15;391
44;Grand Est;88;3;11;277;Luvigny;113;3;116
44;Grand Est;88;2;09;278;Maconcourt;70;1;71
44;Grand Est;88;1;09;279;Madecourt;47;1;48
44;Grand Est;88;1;03;280;Madegney;143;0;143
44;Grand Est;88;1;04;281;Madonne-et-Lamerey;407;12;419
44;Grand Est;88;2;17;283;Malaincourt;79;2;81
44;Grand Est;88;3;14;284;Mandray;580;11;591
44;Grand Est;88;2;17;285;Mandres-sur-Vair;440;127;567
44;Grand Est;88;1;03;286;Marainville-sur-Madon;97;0;97
44;Grand Est;88;2;04;287;Marey;66;1;67
44;Grand Est;88;1;04;288;Maroncourt;6;0;6
44;Grand Est;88;2;04;289;Martigny-les-Bains;807;66;873
44;Grand Est;88;2;10;290;Martigny-les-Gerbonvaux;111;2;113
44;Grand Est;88;2;04;291;Martinvelle;132;3;135
44;Grand Est;88;1;09;292;Mattaincourt;799;24;823
44;Grand Est;88;2;10;293;Maxey-sur-Meuse;216;4;220
44;Grand Est;88;1;08;294;Mazeley;261;3;264
44;Grand Est;88;1;09;295;Mazirot;232;7;239
44;Grand Est;88;2;17;296;Médonville;61;0;61
44;Grand Est;88;1;02;297;Méménil;162;4;166
44;Grand Est;88;1;11;298;Ménarmont;62;0;62
44;Grand Est;88;2;09;299;Ménil-en-Xaintois;154;2;156
44;Grand Est;88;3;11;300;Ménil-de-Senones;127;6;133
44;Grand Est;88;1;11;301;Ménil-sur-Belvitte;292;11;303
44;Grand Est;88;1;15;302;Le Ménil;1005;23;1028
44;Grand Est;88;2;10;303;Midrevaux;188;1;189
44;Grand Est;88;1;09;304;Mirecourt;4819;473;5292
44;Grand Est;88;2;10;305;Moncel-sur-Vair;192;5;197
44;Grand Est;88;3;11;306;Le Mont;51;0;51
44;Grand Est;88;2;04;307;Mont-lès-Lamarche;98;2;100
44;Grand Est;88;2;10;308;Mont-lès-Neufchâteau;300;5;305
44;Grand Est;88;2;17;309;Monthureux-le-Sec;164;4;168
44;Grand Est;88;2;04;310;Monthureux-sur-Saône;896;18;914
44;Grand Est;88;1;16;311;Montmotier;37;0;37
44;Grand Est;88;2;09;312;Morelmaison;195;4;199
44;Grand Est;88;1;03;313;Moriville;421;9;430
44;Grand Est;88;2;04;314;Morizécourt;99;4;103
44;Grand Est;88;3;02;315;Mortagne;173;2;175
44;Grand Est;88;2;17;316;Morville;46;1;47
44;Grand Est;88;3;11;317;Moussey;561;5;566
44;Grand Est;88;1;03;318;Moyemont;226;5;231
44;Grand Est;88;3;11;319;Moyenmoutier;3065;63;3128
44;Grand Est;88;3;14;320;Nayemont-les-Fosses;773;36;809
44;Grand Est;88;2;10;321;Neufchâteau;6644;281;6925
44;Grand Est;88;1;02;322;La Neuveville-devant-Lépanges;508;14;522
44;Grand Est;88;2;09;324;La Neuveville-sous-Châtenois;377;10;387
44;Grand Est;88;2;17;325;La Neuveville-sous-Montfort;189;8;197
44;Grand Est;88;3;14;326;Neuvillers-sur-Fave;354;11;365
44;Grand Est;88;1;03;327;Nomexy;1955;22;1977
44;Grand Est;88;3;11;328;Nompatelize;533;23;556
44;Grand Est;88;2;04;330;Nonville;193;1;194
44;Grand Est;88;1;02;331;Nonzeville;54;2;56
44;Grand Est;88;2;17;332;Norroy;213;6;219
44;Grand Est;88;1;11;333;Nossoncourt;126;1;127
44;Grand Est;88;1;09;334;Oëlleville;297;7;304
44;Grand Est;88;2;17;335;Offroicourt;154;3;157
44;Grand Est;88;2;09;336;Ollainville;74;1;75
44;Grand Est;88;1;03;338;Ortoncourt;84;0;84
44;Grand Est;88;1;02;340;Padoux;492;9;501
44;Grand Est;88;3;14;341;Pair-et-Grandrupt;502;17;519
44;Grand Est;88;1;02;342;Pallegney;168;3;171
44;Grand Est;88;2;17;343;Parey-sous-Montfort;163;4;167
44;Grand Est;88;2;10;344;Pargny-sous-Mureau;181;5;186
44;Grand Est;88;3;14;345;La Petite-Fosse;70;4;74
44;Grand Est;88;3;11;346;La Petite-Raon;739;10;749
44;Grand Est;88;1;04;347;Pierrefitte;117;1;118
44;Grand Est;88;1;02;348;Pierrepont-sur-l'Arentèle;135;3;138
44;Grand Est;88;3;07;349;Plainfaing;1627;20;1647
44;Grand Est;88;2;09;350;Pleuvezain;76;2;78
44;Grand Est;88;1;16;351;Plombières-les-Bains;1566;33;1599
44;Grand Est;88;2;10;352;Pompierre;194;5;199
44;Grand Est;88;2;04;353;Pont-lès-Bonfays;106;3;109
44;Grand Est;88;1;03;354;Pont-sur-Madon;188;0;188
44;Grand Est;88;1;03;355;Portieux;1230;21;1251
44;Grand Est;88;3;02;356;Les Poulières;287;5;292
44;Grand Est;88;1;09;357;Poussay;675;21;696
44;Grand Est;88;1;12;358;Pouxeux;1968;34;2002
44;Grand Est;88;1;02;359;Prey;90;2;92
44;Grand Est;88;2;04;360;Provenchères-lès-Darney;149;5;154
44;Grand Est;88;3;14;361;Provenchères-et-Colroy;1328;115;1443
44;Grand Est;88;3;11;362;Le Puid;114;1;115
44;Grand Est;88;2;10;363;Punerot;153;5;158
44;Grand Est;88;1;09;364;Puzieux;147;3;150
44;Grand Est;88;1;04;365;Racécourt;152;9;161
44;Grand Est;88;2;09;366;Rainville;281;13;294
44;Grand Est;88;1;13;367;Rambervillers;5072;134;5206
44;Grand Est;88;1;09;368;Ramecourt;177;3;180
44;Grand Est;88;1;15;369;Ramonchamp;1869;132;2001
44;Grand Est;88;1;17;370;Rancourt;66;0;66
44;Grand Est;88;1;12;371;Raon-aux-Bois;1221;33;1254
44;Grand Est;88;3;11;372;Raon-l'Étape;6113;134;6247
44;Grand Est;88;3;11;373;Raon-sur-Plaine;147;2;149
44;Grand Est;88;1;03;374;Rapey;23;0;23
44;Grand Est;88;3;14;375;Raves;474;9;483
44;Grand Est;88;2;10;376;Rebeuville;281;7;288
44;Grand Est;88;2;04;377;Regnévelle;122;2;124
44;Grand Est;88;1;03;378;Regney;99;2;101
44;Grand Est;88;1;03;379;Rehaincourt;356;6;362
44;Grand Est;88;3;02;380;Rehaupal;208;2;210
44;Grand Est;88;2;04;381;Relanges;196;8;204
44;Grand Est;88;1;09;382;Remicourt;66;1;67
44;Grand Est;88;1;12;383;Remiremont;7711;299;8010
44;Grand Est;88;2;17;385;Remoncourt;573;9;582
44;Grand Est;88;3;14;386;Remomeix;446;4;450
44;Grand Est;88;2;09;387;Removille;209;3;212
44;Grand Est;88;1;05;388;Renauvoid;120;3;123
44;Grand Est;88;1;09;389;Repel;81;0;81
44;Grand Est;88;2;04;390;Robécourt;105;8;113
44;Grand Est;88;3;01;391;Rochesson;680;17;697
44;Grand Est;88;2;10;393;Rollainville;315;9;324
44;Grand Est;88;2;04;394;Romain-aux-Bois;49;1;50
44;Grand Est;88;1;03;395;Romont;369;8;377
44;Grand Est;88;3;02;398;Les Rouges-Eaux;82;4;86
44;Grand Est;88;1;02;399;Le Roulier;206;3;209
44;Grand Est;88;1;09;400;Rouvres-en-Xaintois;268;12;280
44;Grand Est;88;2;10;401;Rouvres-la-Chétive;452;9;461
44;Grand Est;88;1;11;402;Roville-aux-Chênes;370;139;509
44;Grand Est;88;2;17;403;Rozerotte;187;2;189
44;Grand Est;88;2;04;404;Rozières-sur-Mouzon;68;1;69
44;Grand Est;88;1;03;406;Rugney;131;1;132
44;Grand Est;88;2;10;407;Ruppes;141;3;144
44;Grand Est;88;1;15;408;Rupt-sur-Moselle;3536;66;3602
44;Grand Est;88;1;12;409;Saint-Amé;2161;38;2199
44;Grand Est;88;1;11;410;Sainte-Barbe;271;2;273
44;Grand Est;88;2;04;411;Saint-Baslemont;77;1;78
44;Grand Est;88;1;11;412;Saint-Benoît-la-Chipotte;449;6;455
44;Grand Est;88;3;99;413;Saint-Dié-des-Vosges;19490;446;19936
44;Grand Est;88;1;12;415;Saint-Étienne-lès-Remiremont;3827;76;3903
44;Grand Est;88;1;03;416;Saint-Genest;135;2;137
44;Grand Est;88;1;13;417;Saint-Gorgon;379;9;388
44;Grand Est;88;1;02;418;Sainte-Hélène;452;4;456
44;Grand Est;88;3;11;419;Saint-Jean-d'Ormont;117;0;117
44;Grand Est;88;2;04;421;Saint-Julien;102;2;104
44;Grand Est;88;3;14;423;Saint-Léonard;1359;23;1382
44;Grand Est;88;3;14;424;Sainte-Marguerite;2286;65;2351
44;Grand Est;88;1;03;425;Saint-Maurice-sur-Mortagne;179;4;183
44;Grand Est;88;1;15;426;Saint-Maurice-sur-Moselle;1369;33;1402
44;Grand Est;88;2;09;427;Saint-Menge;125;0;125
44;Grand Est;88;3;13;428;Saint-Michel-sur-Meurthe;1820;57;1877
44;Grand Est;88;1;12;429;Saint-Nabord;3992;257;4249
44;Grand Est;88;2;17;430;Saint-Ouen-lès-Parey;501;13;514
44;Grand Est;88;2;09;431;Saint-Paul;159;2;161
44;Grand Est;88;1;11;432;Saint-Pierremont;152;3;155
44;Grand Est;88;1;09;433;Saint-Prancher;73;1;74
44;Grand Est;88;2;17;434;Saint-Remimont;220;4;224
44;Grand Est;88;3;11;435;Saint-Remy;517;12;529
44;Grand Est;88;3;11;436;Saint-Stail;72;0;72
44;Grand Est;88;1;03;437;Saint-Vallier;100;3;103
44;Grand Est;88;3;13;438;La Salle;392;6;398
44;Grand Est;88;1;05;439;Sanchey;947;37;984
44;Grand Est;88;2;09;440;Sandaucourt;168;4;172
44;Grand Est;88;2;04;441;Sans-Vallois;128;2;130
44;Grand Est;88;3;01;442;Sapois;633;10;643
44;Grand Est;88;2;10;443;Sartes;95;2;97
44;Grand Est;88;3;11;444;Le Saulcy;317;8;325
44;Grand Est;88;3;14;445;Saulcy-sur-Meurthe;2323;55;2378
44;Grand Est;88;2;17;446;Saulxures-lès-Bulgnéville;244;3;247
44;Grand Est;88;3;01;447;Saulxures-sur-Moselotte;2514;80;2594
44;Grand Est;88;2;17;448;Sauville;176;7;183
44;Grand Est;88;1;03;449;Savigny;187;0;187
44;Grand Est;88;2;04;450;Senaide;183;4;187
44;Grand Est;88;3;11;451;Senones;2394;35;2429
44;Grand Est;88;2;04;452;Senonges;134;0;134
44;Grand Est;88;2;10;453;Seraumont;34;0;34
44;Grand Est;88;1;02;454;Sercœur;226;10;236
44;Grand Est;88;2;04;455;Serécourt;98;2;100
44;Grand Est;88;2;04;456;Serocourt;84;3;87
44;Grand Est;88;2;10;457;Sionne;145;1;146
44;Grand Est;88;1;03;458;Socourt;283;3;286
44;Grand Est;88;2;09;459;Soncourt;43;1;44
44;Grand Est;88;2;10;460;Soulosse-sous-Saint-Élophe;658;13;671
44;Grand Est;88;2;17;461;Suriauville;210;5;215
44;Grand Est;88;3;01;462;Le Syndicat;1887;40;1927
44;Grand Est;88;3;13;463;Taintrux;1505;34;1539
44;Grand Est;88;3;01;464;Tendon;510;7;517
44;Grand Est;88;1;08;465;Thaon-les-Vosges;8583;216;8799
44;Grand Est;88;2;17;466;They-sous-Montfort;127;5;132
44;Grand Est;88;3;01;467;Thiéfosse;573;14;587
44;Grand Est;88;1;15;468;Le Thillot;3316;56;3372
44;Grand Est;88;1;09;469;Thiraucourt;99;6;105
44;Grand Est;88;3;01;470;Le Tholy;1536;38;1574
44;Grand Est;88;2;04;471;Les Thons;101;1;102
44;Grand Est;88;2;17;472;Thuillières;115;4;119
44;Grand Est;88;2;04;473;Tignécourt;98;5;103
44;Grand Est;88;2;10;474;Tilleux;66;0;66
44;Grand Est;88;2;04;475;Tollaincourt;118;5;123
44;Grand Est;88;1;09;476;Totainville;120;1;121
44;Grand Est;88;2;10;477;Trampot;99;1;100
44;Grand Est;88;2;10;478;Tranqueville-Graux;103;1;104
44;Grand Est;88;1;16;479;Trémonzey;251;6;257
44;Grand Est;88;1;03;480;Ubexy;167;0;167
44;Grand Est;88;1;16;481;Uriménil;1331;22;1353
44;Grand Est;88;2;17;482;Urville;56;2;58
44;Grand Est;88;1;08;483;Uxegney;2281;56;2337
44;Grand Est;88;1;16;484;Uzemain;1040;26;1066
44;Grand Est;88;2;17;485;La Vacheresse-et-la-Rouillie;117;0;117
44;Grand Est;88;3;01;486;Vagney;3900;108;4008
44;Grand Est;88;1;16;487;Le Val-d'Ajol;3860;95;3955
44;Grand Est;88;2;17;488;Valfroicourt;233;5;238
44;Grand Est;88;1;09;489;Valleroy-aux-Saules;253;8;261
44;Grand Est;88;2;17;490;Valleroy-le-Sec;183;4;187
44;Grand Est;88;2;04;491;Les Vallois;117;5;122
44;Grand Est;88;3;07;492;Le Valtin;74;1;75
44;Grand Est;88;1;03;493;Varmonzey;23;1;24
44;Grand Est;88;1;04;494;Vaubexy;119;2;121
44;Grand Est;88;1;06;495;Vaudéville;185;6;191
44;Grand Est;88;2;17;496;Vaudoncourt;161;3;164
44;Grand Est;88;1;08;497;Vaxoncourt;463;3;466
44;Grand Est;88;1;15;498;Vecoux;848;20;868
44;Grand Est;88;1;04;499;Velotte-et-Tatignécourt;159;3;162
44;Grand Est;88;3;01;500;Ventron;832;14;846
44;Grand Est;88;3;11;501;Le Vermont;72;0;72
44;Grand Est;88;1;02;502;Vervezelle;134;2;136
44;Grand Est;88;3;11;503;Vexaincourt;148;2;150
44;Grand Est;88;2;09;504;Vicherey;191;2;193
44;Grand Est;88;3;07;505;Vienville;125;2;127
44;Grand Est;88;3;11;506;Vieux-Moulin;311;6;317
44;Grand Est;88;1;09;507;Villers;196;6;202
44;Grand Est;88;1;04;508;Ville-sur-Illon;533;11;544
44;Grand Est;88;1;02;509;Villoncourt;108;1;109
44;Grand Est;88;2;04;510;Villotte;143;6;149
44;Grand Est;88;2;10;511;Villouxel;87;2;89
44;Grand Est;88;1;02;512;Viménil;247;4;251
44;Grand Est;88;1;03;513;Vincey;2151;39;2190
44;Grand Est;88;2;09;514;Viocourt;162;7;169
44;Grand Est;88;2;16;515;Vioménil;154;2;156
44;Grand Est;88;2;17;516;Vittel;4805;138;4943
44;Grand Est;88;2;04;517;Viviers-le-Gras;195;5;200
44;Grand Est;88;2;17;518;Viviers-lès-Offroicourt;34;0;34
44;Grand Est;88;3;13;519;La Voivre;672;21;693
44;Grand Est;88;1;16;520;Les Voivres;292;9;301
44;Grand Est;88;1;03;521;Vomécourt;252;3;255
44;Grand Est;88;1;03;522;Vomécourt-sur-Madon;69;3;72
44;Grand Est;88;2;09;523;Vouxey;160;5;165
44;Grand Est;88;2;17;524;Vrécourt;352;4;356
44;Grand Est;88;1;09;525;Vroville;131;2;133
44;Grand Est;88;3;14;526;Wisembach;423;8;431
44;Grand Est;88;1;11;527;Xaffévillers;140;2;142
44;Grand Est;88;1;02;528;Xamontarupt;154;3;157
44;Grand Est;88;1;03;529;Xaronval;111;4;115
44;Grand Est;88;1;16;530;Xertigny;2583;52;2635
44;Grand Est;88;3;07;531;Xonrupt-Longemer;1500;32;1532
44;Grand Est;88;1;02;532;Zincourt;77;4;81
27;Bourgogne-Franche-Comté;89;1;07;002;Aigremont;75;5;80
27;Bourgogne-Franche-Comté;89;1;08;003;Montholon;2814;87;2901
27;Bourgogne-Franche-Comté;89;2;19;004;Aisy-sur-Armançon;237;11;248
27;Bourgogne-Franche-Comté;89;2;19;005;Ancy-le-Franc;843;22;865
27;Bourgogne-Franche-Comté;89;2;19;006;Ancy-le-Libre;149;6;155
27;Bourgogne-Franche-Comté;89;1;21;007;Andryes;438;12;450
27;Bourgogne-Franche-Comté;89;2;07;008;Angely;156;5;161
27;Bourgogne-Franche-Comté;89;2;05;009;Annay-la-Côte;350;17;367
27;Bourgogne-Franche-Comté;89;2;07;010;Annay-sur-Serein;205;5;210
27;Bourgogne-Franche-Comté;89;2;05;011;Annéot;120;10;130
27;Bourgogne-Franche-Comté;89;2;07;012;Annoux;83;2;85
27;Bourgogne-Franche-Comté;89;1;02;013;Appoigny;3207;86;3293
27;Bourgogne-Franche-Comté;89;3;06;014;Arces-Dilo;608;10;618
27;Bourgogne-Franche-Comté;89;2;12;015;Arcy-sur-Cure;469;12;481
27;Bourgogne-Franche-Comté;89;2;19;016;Argentenay;76;3;79
27;Bourgogne-Franche-Comté;89;2;19;017;Argenteuil-sur-Armançon;219;2;221
27;Bourgogne-Franche-Comté;89;3;20;018;Armeau;767;9;776
27;Bourgogne-Franche-Comté;89;2;19;019;Arthonnay;151;1;152
27;Bourgogne-Franche-Comté;89;2;12;020;Asnières-sous-Bois;113;2;115
27;Bourgogne-Franche-Comté;89;2;12;021;Asquins;287;13;300
27;Bourgogne-Franche-Comté;89;2;05;022;Athie;131;3;134
27;Bourgogne-Franche-Comté;89;1;03;023;Augy;983;22;1005
27;Bourgogne-Franche-Comté;89;1;98;024;Auxerre;34151;1093;35244
27;Bourgogne-Franche-Comté;89;2;05;025;Avallon;6414;221;6635
27;Bourgogne-Franche-Comté;89;3;06;027;Bagneaux;200;5;205
27;Bourgogne-Franche-Comté;89;2;19;028;Baon;61;5;66
27;Bourgogne-Franche-Comté;89;1;13;029;Bassou;880;19;899
27;Bourgogne-Franche-Comté;89;1;12;030;Bazarnes;417;9;426
27;Bourgogne-Franche-Comté;89;1;15;031;Beaumont;628;13;641
27;Bourgogne-Franche-Comté;89;2;05;032;Beauvilliers;64;3;67
27;Bourgogne-Franche-Comté;89;1;09;033;Beauvoir;395;11;406
27;Bourgogne-Franche-Comté;89;1;07;034;Beine;462;16;478
27;Bourgogne-Franche-Comté;89;1;06;035;Bellechaume;440;12;452
27;Bourgogne-Franche-Comté;89;3;10;036;La Belliole;237;10;247
27;Bourgogne-Franche-Comté;89;3;11;037;Béon;520;21;541
27;Bourgogne-Franche-Comté;89;2;19;038;Bernouil;113;0;113
27;Bourgogne-Franche-Comté;89;1;07;039;Béru;76;4;80
27;Bourgogne-Franche-Comté;89;1;12;040;Bessy-sur-Cure;187;4;191
27;Bourgogne-Franche-Comté;89;1;15;041;Beugnon;301;14;315
27;Bourgogne-Franche-Comté;89;2;07;042;Bierry-les-Belles-Fontaines;162;5;167
27;Bourgogne-Franche-Comté;89;2;07;043;Blacy;99;1;100
27;Bourgogne-Franche-Comté;89;2;12;044;Blannay;103;1;104
27;Bourgogne-Franche-Comté;89;1;03;045;Bleigny-le-Carreau;284;6;290
27;Bourgogne-Franche-Comté;89;1;09;046;Bléneau;1164;20;1184
27;Bourgogne-Franche-Comté;89;3;06;048;Bœurs-en-Othe;340;6;346
27;Bourgogne-Franche-Comté;89;2;12;049;Bois-d'Arcy;22;1;23
27;Bourgogne-Franche-Comté;89;1;13;050;Bonnard;873;20;893
27;Bourgogne-Franche-Comté;89;3;20;051;Les Bordes;538;12;550
27;Bourgogne-Franche-Comté;89;1;02;053;Branches;436;10;446
27;Bourgogne-Franche-Comté;89;3;10;054;Brannay;787;11;798
27;Bourgogne-Franche-Comté;89;1;06;055;Brienon-sur-Armançon;3160;55;3215
27;Bourgogne-Franche-Comté;89;3;13;056;Brion;620;21;641
27;Bourgogne-Franche-Comté;89;2;12;057;Brosses;303;5;308
27;Bourgogne-Franche-Comté;89;2;05;058;Bussières;119;3;122
27;Bourgogne-Franche-Comté;89;3;13;059;Bussy-en-Othe;707;9;716
27;Bourgogne-Franche-Comté;89;3;20;060;Bussy-le-Repos;456;10;466
27;Bourgogne-Franche-Comté;89;1;15;061;Butteaux;247;1;248
27;Bourgogne-Franche-Comté;89;1;07;062;Carisey;362;4;366
27;Bourgogne-Franche-Comté;89;3;11;063;La Celle-Saint-Cyr;815;18;833
27;Bourgogne-Franche-Comté;89;2;07;064;Censy;56;1;57
27;Bourgogne-Franche-Comté;89;3;06;065;Cérilly;43;0;43
27;Bourgogne-Franche-Comté;89;3;06;066;Cerisiers;972;23;995
27;Bourgogne-Franche-Comté;89;3;11;067;Cézy;1102;24;1126
27;Bourgogne-Franche-Comté;89;1;07;068;Chablis;2171;39;2210
27;Bourgogne-Franche-Comté;89;1;15;069;Chailley;519;10;529
27;Bourgogne-Franche-Comté;89;2;12;071;Chamoux;101;2;103
27;Bourgogne-Franche-Comté;89;1;09;072;Champcevrais;307;0;307
27;Bourgogne-Franche-Comté;89;1;09;073;Champignelles;911;42;953
27;Bourgogne-Franche-Comté;89;3;14;074;Champigny;2105;41;2146
27;Bourgogne-Franche-Comté;89;3;11;075;Champlay;725;14;739
27;Bourgogne-Franche-Comté;89;1;06;076;Champlost;790;12;802
27;Bourgogne-Franche-Comté;89;1;03;077;Champs-sur-Yonne;1576;93;1669
27;Bourgogne-Franche-Comté;89;3;08;079;Chamvres;658;15;673
27;Bourgogne-Franche-Comté;89;3;18;080;La Chapelle-sur-Oreuse;650;17;667
27;Bourgogne-Franche-Comté;89;1;07;081;La Chapelle-Vaupelteigne;91;0;91
27;Bourgogne-Franche-Comté;89;1;02;083;Charbuy;1867;48;1915
27;Bourgogne-Franche-Comté;89;1;21;084;Charentenay;281;7;288
27;Bourgogne-Franche-Comté;89;1;13;085;Charmoy;1109;26;1135
27;Bourgogne-Franche-Comté;89;1;08;086;Charny Orée de Puisaye;4759;77;4836
27;Bourgogne-Franche-Comté;89;2;19;087;Chassignelles;299;9;308
27;Bourgogne-Franche-Comté;89;1;08;088;Chassy;467;9;476
27;Bourgogne-Franche-Comté;89;2;05;089;Chastellux-sur-Cure;135;4;139
27;Bourgogne-Franche-Comté;89;2;12;091;Châtel-Censoir;571;14;585
27;Bourgogne-Franche-Comté;89;2;07;092;Châtel-Gérard;204;9;213
27;Bourgogne-Franche-Comté;89;3;14;093;Chaumont;645;12;657
27;Bourgogne-Franche-Comté;89;3;20;094;Chaumot;703;12;715
27;Bourgogne-Franche-Comté;89;1;07;095;Chemilly-sur-Serein;138;8;146
27;Bourgogne-Franche-Comté;89;1;15;096;Chemilly-sur-Yonne;904;26;930
27;Bourgogne-Franche-Comté;89;2;19;098;Cheney;228;7;235
27;Bourgogne-Franche-Comté;89;1;13;099;Cheny;2287;46;2333
27;Bourgogne-Franche-Comté;89;3;10;100;Chéroy;1705;23;1728
27;Bourgogne-Franche-Comté;89;1;15;101;Chéu;553;11;564
27;Bourgogne-Franche-Comté;89;1;04;102;Chevannes;2165;68;2233
27;Bourgogne-Franche-Comté;89;1;07;104;Chichée;302;10;312
27;Bourgogne-Franche-Comté;89;1;13;105;Chichery;467;12;479
27;Bourgogne-Franche-Comté;89;1;07;108;Chitry;341;9;350
27;Bourgogne-Franche-Comté;89;3;06;111;Les Clérimois;299;5;304
27;Bourgogne-Franche-Comté;89;2;19;112;Collan;159;8;167
27;Bourgogne-Franche-Comté;89;3;10;113;Collemiers;671;14;685
27;Bourgogne-Franche-Comté;89;3;18;115;Compigny;198;4;202
27;Bourgogne-Franche-Comté;89;3;10;116;Cornant;360;7;367
27;Bourgogne-Franche-Comté;89;1;21;117;Coulangeron;217;1;218
27;Bourgogne-Franche-Comté;89;1;21;118;Coulanges-la-Vineuse;794;20;814
27;Bourgogne-Franche-Comté;89;1;12;119;Coulanges-sur-Yonne;511;10;521
27;Bourgogne-Franche-Comté;89;3;06;120;Coulours;133;5;138
27;Bourgogne-Franche-Comté;89;3;06;122;Courgenay;566;8;574
27;Bourgogne-Franche-Comté;89;1;07;123;Courgis;261;8;269
27;Bourgogne-Franche-Comté;89;3;18;124;Courlon-sur-Yonne;1189;20;1209
27;Bourgogne-Franche-Comté;89;1;21;125;Courson-les-Carrières;924;13;937
27;Bourgogne-Franche-Comté;89;3;10;126;Courtoin;31;1;32
27;Bourgogne-Franche-Comté;89;3;14;127;Courtois-sur-Yonne;782;24;806
27;Bourgogne-Franche-Comté;89;2;12;128;Coutarnoux;138;4;142
27;Bourgogne-Franche-Comté;89;1;12;129;Crain;410;9;419
27;Bourgogne-Franche-Comté;89;1;12;130;Deux Rivières;1265;30;1295
27;Bourgogne-Franche-Comté;89;2;19;131;Cruzy-le-Châtel;230;4;234
27;Bourgogne-Franche-Comté;89;2;19;132;Cry;163;6;169
27;Bourgogne-Franche-Comté;89;3;11;133;Cudot;365;4;369
27;Bourgogne-Franche-Comté;89;2;05;134;Cussy-les-Forges;326;8;334
27;Bourgogne-Franche-Comté;89;3;18;136;Cuy;860;29;889
27;Bourgogne-Franche-Comté;89;2;19;137;Dannemoine;468;10;478
27;Bourgogne-Franche-Comté;89;1;09;139;Diges;1083;37;1120
27;Bourgogne-Franche-Comté;89;2;12;141;Dissangis;118;7;125
27;Bourgogne-Franche-Comté;89;3;20;142;Dixmont;911;15;926
27;Bourgogne-Franche-Comté;89;3;10;143;Dollot;315;2;317
27;Bourgogne-Franche-Comté;89;3;10;144;Domats;806;8;814
27;Bourgogne-Franche-Comté;89;2;12;145;Domecy-sur-Cure;388;5;393
27;Bourgogne-Franche-Comté;89;2;05;146;Domecy-sur-le-Vault;86;2;88
27;Bourgogne-Franche-Comté;89;1;09;147;Dracy;242;2;244
27;Bourgogne-Franche-Comté;89;1;21;148;Druyes-les-Belles-Fontaines;267;5;272
27;Bourgogne-Franche-Comté;89;2;19;149;Dyé;205;3;208
27;Bourgogne-Franche-Comté;89;1;09;150;Égleny;450;9;459
27;Bourgogne-Franche-Comté;89;3;10;151;Égriselles-le-Bocage;1372;21;1393
27;Bourgogne-Franche-Comté;89;1;13;152;Épineau-les-Voves;740;12;752
27;Bourgogne-Franche-Comté;89;2;19;153;Épineuil;533;16;549
27;Bourgogne-Franche-Comté;89;1;21;154;Escamps;887;25;912
27;Bourgogne-Franche-Comté;89;1;21;155;Escolives-Sainte-Camille;709;11;720
27;Bourgogne-Franche-Comté;89;1;06;156;Esnon;395;7;402
27;Bourgogne-Franche-Comté;89;1;21;158;Étais-la-Sauvin;624;14;638
27;Bourgogne-Franche-Comté;89;2;05;159;Étaule;390;10;400
27;Bourgogne-Franche-Comté;89;3;20;160;Étigny;763;23;786
27;Bourgogne-Franche-Comté;89;2;07;161;Étivey;192;5;197
27;Bourgogne-Franche-Comté;89;3;18;162;Évry;393;3;396
27;Bourgogne-Franche-Comté;89;1;08;163;La Ferté-Loupière;524;11;535
27;Bourgogne-Franche-Comté;89;1;12;164;Festigny;92;0;92
27;Bourgogne-Franche-Comté;89;3;06;165;Flacy;112;2;114
27;Bourgogne-Franche-Comté;89;1;08;167;Fleury-la-Vallée;1081;31;1112
27;Bourgogne-Franche-Comté;89;1;07;168;Fleys;176;3;179
27;Bourgogne-Franche-Comté;89;2;19;169;Flogny-la-Chapelle;946;23;969
27;Bourgogne-Franche-Comté;89;2;12;170;Foissy-lès-Vézelay;121;3;124
27;Bourgogne-Franche-Comté;89;3;06;171;Foissy-sur-Vanne;290;3;293
27;Bourgogne-Franche-Comté;89;3;06;172;Fontaine-la-Gaillarde;502;25;527
27;Bourgogne-Franche-Comté;89;1;09;173;Fontaines;467;7;474
27;Bourgogne-Franche-Comté;89;1;07;175;Fontenay-près-Chablis;145;4;149
27;Bourgogne-Franche-Comté;89;2;12;176;Fontenay-près-Vézelay;138;3;141
27;Bourgogne-Franche-Comté;89;1;12;177;Fontenay-sous-Fouronnes;73;0;73
27;Bourgogne-Franche-Comté;89;1;21;179;Fontenoy;298;9;307
27;Bourgogne-Franche-Comté;89;3;10;180;Fouchères;496;11;507
27;Bourgogne-Franche-Comté;89;3;06;181;Fournaudin;118;2;120
27;Bourgogne-Franche-Comté;89;1;21;182;Fouronnes;174;4;178
27;Bourgogne-Franche-Comté;89;2;07;183;Fresnes;66;0;66
27;Bourgogne-Franche-Comté;89;2;19;184;Fulvy;130;2;132
27;Bourgogne-Franche-Comté;89;1;15;186;Germigny;521;13;534
27;Bourgogne-Franche-Comté;89;2;19;187;Gigny;83;2;85
27;Bourgogne-Franche-Comté;89;2;05;188;Girolles;166;6;172
27;Bourgogne-Franche-Comté;89;3;18;189;Gisy-les-Nobles;571;19;590
27;Bourgogne-Franche-Comté;89;2;12;190;Givry;178;8;186
27;Bourgogne-Franche-Comté;89;2;19;191;Gland;46;2;48
27;Bourgogne-Franche-Comté;89;2;07;194;Grimault;114;6;120
27;Bourgogne-Franche-Comté;89;3;17;195;Gron;1242;73;1315
27;Bourgogne-Franche-Comté;89;1;08;196;Valravillon;1752;51;1803
27;Bourgogne-Franche-Comté;89;2;07;197;Guillon-Terre-Plaine;736;15;751
27;Bourgogne-Franche-Comté;89;1;02;198;Gurgy;1702;36;1738
27;Bourgogne-Franche-Comté;89;1;21;199;Gy-l'Évêque;453;9;462
27;Bourgogne-Franche-Comté;89;1;15;200;Hauterive;391;6;397
27;Bourgogne-Franche-Comté;89;1;15;201;Héry;1774;40;1814
27;Bourgogne-Franche-Comté;89;1;21;202;Irancy;256;7;263
27;Bourgogne-Franche-Comté;89;2;05;203;Island;188;5;193
27;Bourgogne-Franche-Comté;89;2;07;204;L'Isle-sur-Serein;660;14;674
27;Bourgogne-Franche-Comté;89;1;15;205;Jaulges;575;4;579
27;Bourgogne-Franche-Comté;89;3;11;206;Joigny;9381;310;9691
27;Bourgogne-Franche-Comté;89;2;07;207;Jouancy;26;0;26
27;Bourgogne-Franche-Comté;89;2;12;208;Joux-la-Ville;1152;18;1170
27;Bourgogne-Franche-Comté;89;3;10;209;Jouy;512;11;523
27;Bourgogne-Franche-Comté;89;2;19;210;Jully;128;7;135
27;Bourgogne-Franche-Comté;89;2;19;211;Junay;68;0;68
27;Bourgogne-Franche-Comté;89;1;21;212;Jussy;364;14;378
27;Bourgogne-Franche-Comté;89;3;06;214;Lailly;195;2;197
27;Bourgogne-Franche-Comté;89;1;21;215;Lain;185;4;189
27;Bourgogne-Franche-Comté;89;1;21;216;Lainsecq;319;10;329
27;Bourgogne-Franche-Comté;89;1;09;217;Lalande;136;3;139
27;Bourgogne-Franche-Comté;89;1;13;218;Laroche-Saint-Cydroine;1258;24;1282
27;Bourgogne-Franche-Comté;89;1;15;219;Lasson;143;1;144
27;Bourgogne-Franche-Comté;89;1;09;220;Lavau;436;2;438
27;Bourgogne-Franche-Comté;89;1;09;221;Leugny;320;5;325
27;Bourgogne-Franche-Comté;89;1;21;222;Levis;218;6;224
27;Bourgogne-Franche-Comté;89;2;19;223;Lézinnes;662;17;679
27;Bourgogne-Franche-Comté;89;1;07;224;Lichères-près-Aigremont;154;3;157
27;Bourgogne-Franche-Comté;89;2;12;225;Lichères-sur-Yonne;43;0;43
27;Bourgogne-Franche-Comté;89;1;07;226;Lignorelles;188;5;193
27;Bourgogne-Franche-Comté;89;1;07;227;Ligny-le-Châtel;1201;27;1228
27;Bourgogne-Franche-Comté;89;1;01;228;Lindry;1373;47;1420
27;Bourgogne-Franche-Comté;89;3;10;229;Lixy;476;13;489
27;Bourgogne-Franche-Comté;89;3;11;230;Looze;438;21;459
27;Bourgogne-Franche-Comté;89;2;05;232;Lucy-le-Bois;300;14;314
27;Bourgogne-Franche-Comté;89;1;12;233;Lucy-sur-Cure;198;5;203
27;Bourgogne-Franche-Comté;89;1;12;234;Lucy-sur-Yonne;119;2;121
27;Bourgogne-Franche-Comté;89;2;05;235;Magny;874;23;897
27;Bourgogne-Franche-Comté;89;3;17;236;Maillot;1206;29;1235
27;Bourgogne-Franche-Comté;89;1;12;237;Mailly-la-Ville;492;9;501
27;Bourgogne-Franche-Comté;89;1;12;238;Mailly-le-Château;540;7;547
27;Bourgogne-Franche-Comté;89;3;17;239;Malay-le-Grand;1558;45;1603
27;Bourgogne-Franche-Comté;89;3;06;240;Malay-le-Petit;321;10;331
27;Bourgogne-Franche-Comté;89;1;07;242;Maligny;797;15;812
27;Bourgogne-Franche-Comté;89;2;07;244;Marmeaux;83;4;87
27;Bourgogne-Franche-Comté;89;3;20;245;Marsangy;835;18;853
27;Bourgogne-Franche-Comté;89;2;07;246;Massangis;349;7;356
27;Bourgogne-Franche-Comté;89;2;19;247;Mélisey;229;2;231
27;Bourgogne-Franche-Comté;89;2;05;248;Menades;40;2;42
27;Bourgogne-Franche-Comté;89;1;06;249;Mercy;77;1;78
27;Bourgogne-Franche-Comté;89;1;07;250;Méré;204;3;207
27;Bourgogne-Franche-Comté;89;1;08;251;Merry-la-Vallée;367;9;376
27;Bourgogne-Franche-Comté;89;1;21;252;Merry-Sec;178;4;182
27;Bourgogne-Franche-Comté;89;2;12;253;Merry-sur-Yonne;194;4;198
27;Bourgogne-Franche-Comté;89;1;09;254;Mézilles;518;8;526
27;Bourgogne-Franche-Comté;89;3;18;255;Michery;1071;23;1094
27;Bourgogne-Franche-Comté;89;1;21;256;Migé;409;2;411
27;Bourgogne-Franche-Comté;89;1;13;257;Migennes;7274;128;7402
27;Bourgogne-Franche-Comté;89;2;07;259;Môlay;94;2;96
27;Bourgogne-Franche-Comté;89;3;06;261;Molinons;275;6;281
27;Bourgogne-Franche-Comté;89;2;19;262;Molosmes;170;8;178
27;Bourgogne-Franche-Comté;89;1;02;263;Monéteau;4110;83;4193
27;Bourgogne-Franche-Comté;89;3;10;264;Montacher-Villegardin;715;26;741
27;Bourgogne-Franche-Comté;89;1;07;265;Montigny-la-Resle;579;20;599
27;Bourgogne-Franche-Comté;89;2;12;266;Montillot;255;6;261
27;Bourgogne-Franche-Comté;89;2;07;267;Montréal;177;6;183
27;Bourgogne-Franche-Comté;89;1;15;268;Mont-Saint-Sulpice;787;19;806
27;Bourgogne-Franche-Comté;89;1;21;270;Mouffy;126;2;128
27;Bourgogne-Franche-Comté;89;2;07;271;Moulins-en-Tonnerrois;105;1;106
27;Bourgogne-Franche-Comté;89;1;09;272;Moulins-sur-Ouanne;288;2;290
27;Bourgogne-Franche-Comté;89;1;21;273;Moutiers-en-Puisaye;275;3;278
27;Bourgogne-Franche-Comté;89;3;10;274;Nailly;1333;37;1370
27;Bourgogne-Franche-Comté;89;1;15;276;Neuvy-Sautour;877;38;915
27;Bourgogne-Franche-Comté;89;1;07;277;Nitry;366;11;377
27;Bourgogne-Franche-Comté;89;3;06;278;Noé;550;5;555
27;Bourgogne-Franche-Comté;89;2;07;279;Noyers;593;19;612
27;Bourgogne-Franche-Comté;89;2;19;280;Nuits;392;9;401
27;Bourgogne-Franche-Comté;89;1;08;281;Les Ormes;336;5;341
27;Bourgogne-Franche-Comté;89;1;15;282;Ormoy;675;11;686
27;Bourgogne-Franche-Comté;89;1;21;283;Ouanne;595;16;611
27;Bourgogne-Franche-Comté;89;2;19;284;Pacy-sur-Armançon;179;4;183
27;Bourgogne-Franche-Comté;89;3;18;285;Pailly;316;3;319
27;Bourgogne-Franche-Comté;89;1;09;286;Parly;833;16;849
27;Bourgogne-Franche-Comté;89;3;17;287;Paron;4825;118;4943
27;Bourgogne-Franche-Comté;89;1;06;288;Paroy-en-Othe;171;8;179
27;Bourgogne-Franche-Comté;89;3;08;289;Paroy-sur-Tholon;280;13;293
27;Bourgogne-Franche-Comté;89;2;07;290;Pasilly;43;1;44
27;Bourgogne-Franche-Comté;89;3;20;291;Passy;338;10;348
27;Bourgogne-Franche-Comté;89;1;15;292;Percey;248;5;253
27;Bourgogne-Franche-Comté;89;1;02;295;Perrigny;1266;31;1297
27;Bourgogne-Franche-Comté;89;2;19;296;Perrigny-sur-Armançon;129;1;130
27;Bourgogne-Franche-Comté;89;2;12;297;Pierre-Perthuis;107;1;108
27;Bourgogne-Franche-Comté;89;3;20;298;Piffonds;598;11;609
27;Bourgogne-Franche-Comté;89;2;19;299;Pimelles;63;2;65
27;Bourgogne-Franche-Comté;89;2;07;300;Pisy;81;1;82
27;Bourgogne-Franche-Comté;89;3;18;302;Plessis-Saint-Jean;209;3;212
27;Bourgogne-Franche-Comté;89;1;07;303;Poilly-sur-Serein;247;6;253
27;Bourgogne-Franche-Comté;89;1;08;304;Poilly-sur-Tholon;675;22;697
27;Bourgogne-Franche-Comté;89;2;05;306;Pontaubert;363;11;374
27;Bourgogne-Franche-Comté;89;1;07;307;Pontigny;754;10;764
27;Bourgogne-Franche-Comté;89;3;06;308;Pont-sur-Vanne;184;7;191
27;Bourgogne-Franche-Comté;89;3;14;309;Pont-sur-Yonne;3316;59;3375
27;Bourgogne-Franche-Comté;89;3;06;310;La Postolle;138;3;141
27;Bourgogne-Franche-Comté;89;1;09;311;Pourrain;1356;27;1383
27;Bourgogne-Franche-Comté;89;2;12;312;Précy-le-Sec;245;5;250
27;Bourgogne-Franche-Comté;89;3;11;313;Précy-sur-Vrin;419;16;435
27;Bourgogne-Franche-Comté;89;1;12;314;Prégilbert;181;1;182
27;Bourgogne-Franche-Comté;89;1;07;315;Préhy;159;1;160
27;Bourgogne-Franche-Comté;89;2;05;316;Provency;252;6;258
27;Bourgogne-Franche-Comté;89;2;05;318;Quarré-les-Tombes;628;20;648
27;Bourgogne-Franche-Comté;89;1;03;319;Quenne;483;14;497
27;Bourgogne-Franche-Comté;89;2;19;320;Quincerot;65;2;67
27;Bourgogne-Franche-Comté;89;2;19;321;Ravières;712;18;730
27;Bourgogne-Franche-Comté;89;2;19;323;Roffey;141;4;145
27;Bourgogne-Franche-Comté;89;1;09;324;Rogny-les-Sept-Écluses;672;11;683
27;Bourgogne-Franche-Comté;89;1;09;325;Ronchères;90;1;91
27;Bourgogne-Franche-Comté;89;3;17;326;Rosoy;1074;31;1105
27;Bourgogne-Franche-Comté;89;3;20;327;Rousson;389;10;399
27;Bourgogne-Franche-Comté;89;1;07;328;Rouvray;369;7;376
27;Bourgogne-Franche-Comté;89;2;19;329;Rugny;73;1;74
27;Bourgogne-Franche-Comté;89;1;21;331;Sainpuits;311;11;322
27;Bourgogne-Franche-Comté;89;3;10;332;Saint-Agnan;957;27;984
27;Bourgogne-Franche-Comté;89;2;07;333;Saint-André-en-Terre-Plaine;149;4;153
27;Bourgogne-Franche-Comté;89;1;08;334;Le Val d'Ocre;555;7;562
27;Bourgogne-Franche-Comté;89;3;11;335;Saint-Aubin-sur-Yonne;427;13;440
27;Bourgogne-Franche-Comté;89;2;05;336;Saint-Brancher;280;7;287
27;Bourgogne-Franche-Comté;89;1;03;337;Saint-Bris-le-Vineux;1023;26;1049
27;Bourgogne-Franche-Comté;89;3;16;338;Saint-Clément;2812;81;2893
27;Bourgogne-Franche-Comté;89;2;12;339;Sainte-Colombe;187;9;196
27;Bourgogne-Franche-Comté;89;1;07;341;Saint-Cyr-les-Colons;448;5;453
27;Bourgogne-Franche-Comté;89;3;18;342;Saint-Denis-lès-Sens;640;18;658
27;Bourgogne-Franche-Comté;89;1;09;344;Saint-Fargeau;1482;13;1495
27;Bourgogne-Franche-Comté;89;1;15;345;Saint-Florentin;4211;55;4266
27;Bourgogne-Franche-Comté;89;1;01;346;Saint-Georges-sur-Baulche;3225;145;3370
27;Bourgogne-Franche-Comté;89;2;05;347;Saint-Germain-des-Champs;343;10;353
27;Bourgogne-Franche-Comté;89;3;11;348;Saint-Julien-du-Sault;2224;49;2273
27;Bourgogne-Franche-Comté;89;2;05;349;Saint-Léger-Vauban;356;11;367
27;Bourgogne-Franche-Comté;89;3;11;350;Saint-Loup-d'Ordon;260;5;265
27;Bourgogne-Franche-Comté;89;2;05;351;Sainte-Magnance;478;8;486
27;Bourgogne-Franche-Comté;89;1;09;352;Saint-Martin-des-Champs;265;7;272
27;Bourgogne-Franche-Comté;89;3;11;353;Saint-Martin-d'Ordon;421;4;425
27;Bourgogne-Franche-Comté;89;3;16;354;Saint-Martin-du-Tertre;1529;42;1571
27;Bourgogne-Franche-Comté;89;2;19;355;Saint-Martin-sur-Armançon;147;6;153
27;Bourgogne-Franche-Comté;89;3;06;359;Saint-Maurice-aux-Riches-Hommes;413;5;418
27;Bourgogne-Franche-Comté;89;1;08;360;Saint-Maurice-le-Vieil;372;8;380
27;Bourgogne-Franche-Comté;89;1;08;361;Saint-Maurice-Thizouaille;253;2;255
27;Bourgogne-Franche-Comté;89;2;12;362;Saint-Moré;178;5;183
27;Bourgogne-Franche-Comté;89;1;12;363;Sainte-Pallaye;104;4;108
27;Bourgogne-Franche-Comté;89;2;12;364;Saint-Père;292;6;298
27;Bourgogne-Franche-Comté;89;1;09;365;Saint-Privé;525;11;536
27;Bourgogne-Franche-Comté;89;1;21;367;Saints-en-Puisaye;543;11;554
27;Bourgogne-Franche-Comté;89;1;21;368;Saint-Sauveur-en-Puisaye;895;22;917
27;Bourgogne-Franche-Comté;89;3;14;369;Saint-Sérotin;581;12;593
27;Bourgogne-Franche-Comté;89;3;10;370;Saint-Valérien;1750;21;1771
27;Bourgogne-Franche-Comté;89;2;07;371;Sainte-Vertu;78;5;83
27;Bourgogne-Franche-Comté;89;3;06;373;Saligny;679;10;689
27;Bourgogne-Franche-Comté;89;2;19;374;Sambourg;70;3;73
27;Bourgogne-Franche-Comté;89;2;07;375;Santigny;84;3;87
27;Bourgogne-Franche-Comté;89;2;07;376;Sarry;135;7;142
27;Bourgogne-Franche-Comté;89;2;07;377;Sauvigny-le-Beuréal;68;0;68
27;Bourgogne-Franche-Comté;89;2;05;378;Sauvigny-le-Bois;729;15;744
27;Bourgogne-Franche-Comté;89;2;07;379;Savigny-en-Terre-Plaine;144;3;147
27;Bourgogne-Franche-Comté;89;3;10;380;Savigny-sur-Clairis;451;7;458
27;Bourgogne-Franche-Comté;89;1;15;382;Seignelay;1457;38;1495
27;Bourgogne-Franche-Comté;89;1;21;383;Sementron;103;2;105
27;Bourgogne-Franche-Comté;89;1;08;384;Senan;682;17;699
27;Bourgogne-Franche-Comté;89;2;19;385;Sennevoy-le-Bas;76;3;79
27;Bourgogne-Franche-Comté;89;2;19;386;Sennevoy-le-Haut;113;1;114
27;Bourgogne-Franche-Comté;89;3;99;387;Sens;26854;513;27367
27;Bourgogne-Franche-Comté;89;3;08;388;Sépeaux-Saint Romain;507;16;523
27;Bourgogne-Franche-Comté;89;3;18;390;Serbonnes;669;9;678
27;Bourgogne-Franche-Comté;89;3;18;391;Sergines;1260;26;1286
27;Bourgogne-Franche-Comté;89;2;05;392;Sermizelles;244;3;247
27;Bourgogne-Franche-Comté;89;2;19;393;Serrigny;111;2;113
27;Bourgogne-Franche-Comté;89;1;12;394;Sery;76;1;77
27;Bourgogne-Franche-Comté;89;3;06;395;Les Sièges;404;8;412
27;Bourgogne-Franche-Comté;89;1;08;397;Sommecaise;372;6;378
27;Bourgogne-Franche-Comté;89;1;15;398;Sormery;364;5;369
27;Bourgogne-Franche-Comté;89;3;18;399;Soucy;1575;42;1617
27;Bourgogne-Franche-Comté;89;1;21;400;Sougères-en-Puisaye;317;6;323
27;Bourgogne-Franche-Comté;89;1;15;402;Soumaintrain;218;3;221
27;Bourgogne-Franche-Comté;89;2;19;403;Stigny;85;8;93
27;Bourgogne-Franche-Comté;89;3;10;404;Subligny;525;9;534
27;Bourgogne-Franche-Comté;89;1;21;405;Les Hauts de Forterre;499;9;508
27;Bourgogne-Franche-Comté;89;2;07;406;Talcy;76;2;78
27;Bourgogne-Franche-Comté;89;2;19;407;Tanlay;915;30;945
27;Bourgogne-Franche-Comté;89;1;09;408;Tannerre-en-Puisaye;274;7;281
27;Bourgogne-Franche-Comté;89;2;12;409;Tharoiseau;61;1;62
27;Bourgogne-Franche-Comté;89;2;05;410;Tharot;104;1;105
27;Bourgogne-Franche-Comté;89;3;06;411;Les Vallées de la Vanne;1020;18;1038
27;Bourgogne-Franche-Comté;89;2;07;412;Thizy;184;7;191
27;Bourgogne-Franche-Comté;89;2;19;413;Thorey;39;1;40
27;Bourgogne-Franche-Comté;89;3;18;414;Thorigny-sur-Oreuse;1405;29;1434
27;Bourgogne-Franche-Comté;89;2;05;415;Thory;198;3;201
27;Bourgogne-Franche-Comté;89;1;21;416;Thury;442;7;449
27;Bourgogne-Franche-Comté;89;2;19;417;Tissey;110;2;112
27;Bourgogne-Franche-Comté;89;2;19;418;Tonnerre;4345;163;4508
27;Bourgogne-Franche-Comté;89;1;09;419;Toucy;2589;143;2732
27;Bourgogne-Franche-Comté;89;1;21;420;Treigny-Perreuse-Sainte-Colombe;1007;21;1028
27;Bourgogne-Franche-Comté;89;2;19;422;Trichey;42;2;44
27;Bourgogne-Franche-Comté;89;2;19;423;Tronchoy;127;3;130
27;Bourgogne-Franche-Comté;89;1;12;424;Trucy-sur-Yonne;133;6;139
27;Bourgogne-Franche-Comté;89;1;15;425;Turny;665;20;685
27;Bourgogne-Franche-Comté;89;1;21;426;Val-de-Mercy;387;12;399
27;Bourgogne-Franche-Comté;89;1;04;427;Vallan;677;19;696
27;Bourgogne-Franche-Comté;89;3;10;428;Vallery;568;6;574
27;Bourgogne-Franche-Comté;89;1;07;430;Varennes;321;8;329
27;Bourgogne-Franche-Comté;89;2;07;431;Vassy-sous-Pisy;68;5;73
27;Bourgogne-Franche-Comté;89;3;06;432;Vaudeurs;453;8;461
27;Bourgogne-Franche-Comté;89;2;05;433;Vault-de-Lugny;269;5;274
27;Bourgogne-Franche-Comté;89;3;06;434;Vaumort;341;8;349
27;Bourgogne-Franche-Comté;89;1;06;436;Venizy;871;17;888
27;Bourgogne-Franche-Comté;89;1;07;437;Venouse;298;7;305
27;Bourgogne-Franche-Comté;89;1;03;438;Venoy;1750;191;1941
27;Bourgogne-Franche-Comté;89;1;15;439;Vergigny;1519;21;1540
27;Bourgogne-Franche-Comté;89;3;11;440;Verlin;412;5;417
27;Bourgogne-Franche-Comté;89;1;12;441;Vermenton;1250;25;1275
27;Bourgogne-Franche-Comté;89;3;10;442;Vernoy;239;7;246
27;Bourgogne-Franche-Comté;89;3;20;443;Véron;1855;61;1916
27;Bourgogne-Franche-Comté;89;2;19;445;Vézannes;52;2;54
27;Bourgogne-Franche-Comté;89;2;12;446;Vézelay;433;7;440
27;Bourgogne-Franche-Comté;89;2;19;447;Vézinnes;157;2;159
27;Bourgogne-Franche-Comté;89;3;14;449;Villeblevin;1796;35;1831
27;Bourgogne-Franche-Comté;89;3;10;450;Villebougis;629;14;643
27;Bourgogne-Franche-Comté;89;3;06;451;Villechétive;249;5;254
27;Bourgogne-Franche-Comté;89;3;11;452;Villecien;367;13;380
27;Bourgogne-Franche-Comté;89;1;01;453;Villefargeau;1118;23;1141
27;Bourgogne-Franche-Comté;89;3;14;456;Villemanoche;666;8;674
27;Bourgogne-Franche-Comté;89;3;14;458;Villenavotte;161;8;169
27;Bourgogne-Franche-Comté;89;3;10;459;Villeneuve-la-Dondagre;329;0;329
27;Bourgogne-Franche-Comté;89;3;14;460;Villeneuve-la-Guyard;3458;66;3524
27;Bourgogne-Franche-Comté;89;3;06;461;Villeneuve-l'Archevêque;1109;19;1128
27;Bourgogne-Franche-Comté;89;1;09;462;Villeneuve-les-Genêts;304;5;309
27;Bourgogne-Franche-Comté;89;1;07;463;Villeneuve-Saint-Salves;255;4;259
27;Bourgogne-Franche-Comté;89;3;20;464;Villeneuve-sur-Yonne;5148;85;5233
27;Bourgogne-Franche-Comté;89;3;14;465;Villeperrot;324;1;325
27;Bourgogne-Franche-Comté;89;3;10;466;Villeroy;386;9;395
27;Bourgogne-Franche-Comté;89;3;10;467;Villethierry;809;14;823
27;Bourgogne-Franche-Comté;89;3;11;468;Villevallier;418;64;482
27;Bourgogne-Franche-Comté;89;3;18;469;Perceneige;947;23;970
27;Bourgogne-Franche-Comté;89;2;19;470;Villiers-les-Hauts;122;3;125
27;Bourgogne-Franche-Comté;89;3;06;471;Villiers-Louis;470;16;486
27;Bourgogne-Franche-Comté;89;1;09;472;Villiers-Saint-Benoît;442;9;451
27;Bourgogne-Franche-Comté;89;1;15;474;Villiers-Vineux;270;6;276
27;Bourgogne-Franche-Comté;89;2;19;475;Villon;108;2;110
27;Bourgogne-Franche-Comté;89;1;07;477;Villy;114;2;116
27;Bourgogne-Franche-Comté;89;1;21;478;Vincelles;914;17;931
27;Bourgogne-Franche-Comté;89;1;21;479;Vincelottes;289;6;295
27;Bourgogne-Franche-Comté;89;3;18;480;Vinneuf;1606;19;1625
27;Bourgogne-Franche-Comté;89;2;19;481;Vireaux;104;6;110
27;Bourgogne-Franche-Comté;89;2;19;482;Viviers;108;1;109
27;Bourgogne-Franche-Comté;89;3;18;483;Voisines;515;18;533
27;Bourgogne-Franche-Comté;89;2;12;485;Voutenay-sur-Cure;199;6;205
27;Bourgogne-Franche-Comté;89;2;19;486;Yrouerre;151;3;154
27;Bourgogne-Franche-Comté;90;1;05;001;Andelnans;1165;21;1186
27;Bourgogne-Franche-Comté;90;1;08;002;Angeot;355;6;361
27;Bourgogne-Franche-Comté;90;1;07;003;Anjoutey;582;22;604
27;Bourgogne-Franche-Comté;90;1;05;004;Argiésans;540;8;548
27;Bourgogne-Franche-Comté;90;1;07;005;Auxelles-Bas;443;12;455
27;Bourgogne-Franche-Comté;90;1;07;006;Auxelles-Haut;284;7;291
27;Bourgogne-Franche-Comté;90;1;05;007;Banvillars;291;12;303
27;Bourgogne-Franche-Comté;90;1;01;008;Bavilliers;4627;108;4735
27;Bourgogne-Franche-Comté;90;1;06;009;Beaucourt;5016;65;5081
27;Bourgogne-Franche-Comté;90;1;99;010;Belfort;45458;767;46225
27;Bourgogne-Franche-Comté;90;1;05;011;Bermont;376;9;385
27;Bourgogne-Franche-Comté;90;1;08;012;Bessoncourt;1302;47;1349
27;Bourgogne-Franche-Comté;90;1;08;013;Bethonvilliers;243;11;254
27;Bourgogne-Franche-Comté;90;1;08;014;Boron;489;8;497
27;Bourgogne-Franche-Comté;90;1;05;015;Botans;238;13;251
27;Bourgogne-Franche-Comté;90;1;07;016;Bourg-sous-Châtelet;123;2;125
27;Bourgogne-Franche-Comté;90;1;05;017;Bourogne;1848;26;1874
27;Bourgogne-Franche-Comté;90;1;08;018;Brebotte;400;7;407
27;Bourgogne-Franche-Comté;90;1;08;019;Bretagne;285;6;291
27;Bourgogne-Franche-Comté;90;1;05;020;Buc;264;11;275
27;Bourgogne-Franche-Comté;90;1;05;021;Charmois;375;4;379
27;Bourgogne-Franche-Comté;90;1;05;022;Châtenois-les-Forges;2625;50;2675
27;Bourgogne-Franche-Comté;90;1;07;023;Chaux;1176;31;1207
27;Bourgogne-Franche-Comté;90;1;08;024;Chavanatte;138;3;141
27;Bourgogne-Franche-Comté;90;1;08;025;Chavannes-les-Grands;340;4;344
27;Bourgogne-Franche-Comté;90;1;05;026;Chèvremont;1572;37;1609
27;Bourgogne-Franche-Comté;90;1;06;027;Courcelles;120;0;120
27;Bourgogne-Franche-Comté;90;1;06;028;Courtelevant;382;7;389
27;Bourgogne-Franche-Comté;90;1;01;029;Cravanche;1938;51;1989
27;Bourgogne-Franche-Comté;90;1;06;030;Croix;173;3;176
27;Bourgogne-Franche-Comté;90;1;08;031;Cunelières;338;9;347
27;Bourgogne-Franche-Comté;90;1;01;032;Danjoutin;3573;67;3640
27;Bourgogne-Franche-Comté;90;1;06;033;Delle;5689;85;5774
27;Bourgogne-Franche-Comté;90;1;09;034;Denney;760;26;786
27;Bourgogne-Franche-Comté;90;1;05;035;Dorans;808;10;818
27;Bourgogne-Franche-Comté;90;1;08;036;Eguenigue;269;9;278
27;Bourgogne-Franche-Comté;90;1;09;037;Éloie;955;27;982
27;Bourgogne-Franche-Comté;90;1;01;039;Essert;3316;104;3420
27;Bourgogne-Franche-Comté;90;1;07;041;Étueffont;1401;43;1444
27;Bourgogne-Franche-Comté;90;1;09;042;Évette-Salbert;2021;69;2090
27;Bourgogne-Franche-Comté;90;1;06;043;Faverois;586;1;587
27;Bourgogne-Franche-Comté;90;1;07;044;Felon;239;4;243
27;Bourgogne-Franche-Comté;90;1;06;045;Fêche-l'Église;758;13;771
27;Bourgogne-Franche-Comté;90;1;06;046;Florimont;449;6;455
27;Bourgogne-Franche-Comté;90;1;08;047;Fontaine;594;15;609
27;Bourgogne-Franche-Comté;90;1;08;048;Fontenelle;127;4;131
27;Bourgogne-Franche-Comté;90;1;08;049;Foussemagne;917;18;935
27;Bourgogne-Franche-Comté;90;1;08;050;Frais;237;7;244
27;Bourgogne-Franche-Comté;90;1;08;051;Froidefontaine;472;8;480
27;Bourgogne-Franche-Comté;90;1;07;052;Giromagny;2914;80;2994
27;Bourgogne-Franche-Comté;90;1;08;053;Grandvillars;2995;61;3056
27;Bourgogne-Franche-Comté;90;1;07;054;Grosmagny;516;9;525
27;Bourgogne-Franche-Comté;90;1;08;055;Grosne;331;6;337
27;Bourgogne-Franche-Comté;90;1;06;056;Joncherey;1416;29;1445
27;Bourgogne-Franche-Comté;90;1;07;057;Lachapelle-sous-Chaux;754;27;781
27;Bourgogne-Franche-Comté;90;1;07;058;Lachapelle-sous-Rougemont;584;6;590
27;Bourgogne-Franche-Comté;90;1;08;059;Lacollonge;226;10;236
27;Bourgogne-Franche-Comté;90;1;08;060;Lagrange;139;5;144
27;Bourgogne-Franche-Comté;90;1;07;061;Lamadeleine-Val-des-Anges;44;2;46
27;Bourgogne-Franche-Comté;90;1;08;062;Larivière;279;10;289
27;Bourgogne-Franche-Comté;90;1;06;063;Lebetain;413;9;422
27;Bourgogne-Franche-Comté;90;1;06;064;Lepuix-Neuf;308;4;312
27;Bourgogne-Franche-Comté;90;1;07;065;Lepuix;1141;20;1161
27;Bourgogne-Franche-Comté;90;1;07;066;Leval;243;1;244
27;Bourgogne-Franche-Comté;90;1;08;067;Menoncourt;400;18;418
27;Bourgogne-Franche-Comté;90;1;05;068;Meroux-Moval;1390;27;1417
27;Bourgogne-Franche-Comté;90;1;08;069;Méziré;1294;25;1319
27;Bourgogne-Franche-Comté;90;1;06;070;Montbouton;403;9;412
27;Bourgogne-Franche-Comté;90;1;08;071;Montreux-Château;1172;21;1193
27;Bourgogne-Franche-Comté;90;1;08;072;Morvillars;1068;21;1089
27;Bourgogne-Franche-Comté;90;1;08;074;Novillard;304;4;308
27;Bourgogne-Franche-Comté;90;1;09;075;Offemont;4164;91;4255
27;Bourgogne-Franche-Comté;90;1;01;076;Pérouse;1180;42;1222
27;Bourgogne-Franche-Comté;90;1;08;077;Petit-Croix;298;7;305
27;Bourgogne-Franche-Comté;90;1;07;078;Petitefontaine;190;5;195
27;Bourgogne-Franche-Comté;90;1;07;079;Petitmagny;321;5;326
27;Bourgogne-Franche-Comté;90;1;08;080;Phaffans;435;13;448
27;Bourgogne-Franche-Comté;90;1;06;081;Réchésy;767;13;780
27;Bourgogne-Franche-Comté;90;1;08;082;Autrechêne;276;9;285
27;Bourgogne-Franche-Comté;90;1;08;083;Recouvrance;132;0;132
27;Bourgogne-Franche-Comté;90;1;08;084;Reppe;336;3;339
27;Bourgogne-Franche-Comté;90;1;07;085;Riervescemont;93;2;95
27;Bourgogne-Franche-Comté;90;1;07;086;Romagny-sous-Rougemont;219;7;226
27;Bourgogne-Franche-Comté;90;1;09;087;Roppe;1037;31;1068
27;Bourgogne-Franche-Comté;90;1;07;088;Rougegoutte;973;22;995
27;Bourgogne-Franche-Comté;90;1;07;089;Rougemont-le-Château;1492;51;1543
27;Bourgogne-Franche-Comté;90;1;06;090;Saint-Dizier-l'Évêque;433;12;445
27;Bourgogne-Franche-Comté;90;1;07;091;Saint-Germain-le-Châtelet;652;23;675
27;Bourgogne-Franche-Comté;90;1;09;093;Sermamagny;924;20;944
27;Bourgogne-Franche-Comté;90;1;05;094;Sevenans;703;22;725
27;Bourgogne-Franche-Comté;90;1;08;095;Suarce;432;3;435
27;Bourgogne-Franche-Comté;90;1;06;096;Thiancourt;280;8;288
27;Bourgogne-Franche-Comté;90;1;05;097;Trévenans;1281;32;1313
27;Bourgogne-Franche-Comté;90;1;05;098;Urcerey;245;4;249
27;Bourgogne-Franche-Comté;90;1;09;099;Valdoie;5251;238;5489
27;Bourgogne-Franche-Comté;90;1;08;100;Vauthiermont;195;11;206
27;Bourgogne-Franche-Comté;90;1;08;101;Vellescot;243;6;249
27;Bourgogne-Franche-Comté;90;1;07;102;Vescemont;712;23;735
27;Bourgogne-Franche-Comté;90;1;09;103;Vétrigne;668;22;690
27;Bourgogne-Franche-Comté;90;1;05;104;Vézelois;999;23;1022
27;Bourgogne-Franche-Comté;90;1;06;105;Villars-le-Sec;178;5;183
11;Île-de-France;91;1;08;001;Abbéville-la-Rivière;328;8;336
11;Île-de-France;91;1;08;016;Angerville;4374;53;4427
11;Île-de-France;91;3;05;017;Angervilliers;1725;25;1750
11;Île-de-France;91;3;01;021;Arpajon;11165;101;11266
11;Île-de-France;91;1;08;022;Arrancourt;126;5;131
11;Île-de-France;91;3;02;027;Athis-Mons;35641;286;35927
11;Île-de-France;91;1;08;035;Authon-la-Plaine;373;8;381
11;Île-de-France;91;2;13;037;Auvernaux;325;1;326
11;Île-de-France;91;1;08;038;Auvers-Saint-Georges;1272;21;1293
11;Île-de-France;91;3;01;041;Avrainville;1017;7;1024
11;Île-de-France;91;3;11;044;Ballainvilliers;4666;45;4711
11;Île-de-France;91;2;13;045;Ballancourt-sur-Essonne;7706;106;7812
11;Île-de-France;91;1;13;047;Baulne;1363;14;1377
11;Île-de-France;91;3;10;064;Bièvres;4796;77;4873
11;Île-de-France;91;1;08;067;Blandy;115;4;119
11;Île-de-France;91;2;13;069;Boigneville;390;9;399
11;Île-de-France;91;1;08;075;Bois-Herpin;81;1;82
11;Île-de-France;91;1;08;079;Boissy-la-Rivière;500;6;506
11;Île-de-France;91;1;08;080;Boissy-le-Cutté;1367;13;1380
11;Île-de-France;91;1;08;081;Boissy-le-Sec;692;16;708
11;Île-de-France;91;1;01;085;Boissy-sous-Saint-Yon;3806;47;3853
11;Île-de-France;91;2;15;086;Bondoufle;10326;100;10426
11;Île-de-France;91;3;10;093;Boullay-les-Troux;647;21;668
11;Île-de-France;91;1;01;095;Bouray-sur-Juine;2095;27;2122
11;Île-de-France;91;2;07;097;Boussy-Saint-Antoine;7980;77;8057
11;Île-de-France;91;1;08;098;Boutervilliers;430;5;435
11;Île-de-France;91;1;13;099;Boutigny-sur-Essonne;2952;42;2994
11;Île-de-France;91;1;08;100;Bouville;650;15;665
11;Île-de-France;91;3;03;103;Brétigny-sur-Orge;27006;355;27361
11;Île-de-France;91;3;05;105;Breuillet;8759;123;8882
11;Île-de-France;91;1;05;106;Breux-Jouy;1280;12;1292
11;Île-de-France;91;1;08;109;Brières-les-Scellés;1282;10;1292
11;Île-de-France;91;3;05;111;Briis-sous-Forges;3394;38;3432
11;Île-de-France;91;1;08;112;Brouy;125;4;129
11;Île-de-France;91;2;98;114;Brunoy;25344;431;25775
11;Île-de-France;91;3;01;115;Bruyères-le-Châtel;3594;45;3639
11;Île-de-France;91;2;13;121;Buno-Bonnevaux;464;4;468
11;Île-de-France;91;3;10;122;Bures-sur-Yvette;9240;202;9442
11;Île-de-France;91;1;08;129;Cerny;3346;164;3510
11;Île-de-France;91;1;08;130;Chalo-Saint-Mars;1020;28;1048
11;Île-de-France;91;1;08;131;Chalou-Moulineux;390;8;398
11;Île-de-France;91;1;05;132;Chamarande;1134;12;1146
11;Île-de-France;91;2;13;135;Champcueil;2880;57;2937
11;Île-de-France;91;3;11;136;Champlan;2771;17;2788
11;Île-de-France;91;1;08;137;Champmotteux;367;7;374
11;Île-de-France;91;1;08;145;Chatignonville;72;0;72
11;Île-de-France;91;1;05;148;Chauffour-lès-Étréchy;140;0;140
11;Île-de-France;91;3;01;156;Cheptainville;2227;30;2257
11;Île-de-France;91;2;13;159;Chevannes;1569;28;1597
11;Île-de-France;91;3;12;161;Chilly-Mazarin;19943;107;20050
11;Île-de-France;91;2;04;174;Corbeil-Essonnes;52340;273;52613
11;Île-de-France;91;1;05;175;Corbreuse;1712;30;1742
11;Île-de-France;91;2;13;179;Le Coudray-Montceaux;4828;43;4871
11;Île-de-France;91;2;13;180;Courances;332;10;342
11;Île-de-France;91;2;13;184;Courdimanche-sur-Essonne;277;7;284
11;Île-de-France;91;3;05;186;Courson-Monteloup;583;8;591
11;Île-de-France;91;2;19;191;Crosne;9458;50;9508
11;Île-de-France;91;2;13;195;Dannemois;833;12;845
11;Île-de-France;91;1;08;198;D'Huison-Longueville;1509;23;1532
11;Île-de-France;91;1;05;200;Dourdan;10733;177;10910
11;Île-de-France;91;2;06;201;Draveil;28595;256;28851
11;Île-de-France;91;2;04;204;Écharcon;768;13;781
11;Île-de-France;91;3;01;207;Égly;6539;56;6595
11;Île-de-France;91;2;07;215;Épinay-sous-Sénart;12197;83;12280
11;Île-de-France;91;3;11;216;Épinay-sur-Orge;11102;114;11216
11;Île-de-France;91;1;08;223;Étampes;26251;203;26454
11;Île-de-France;91;2;06;225;Étiolles;3114;148;3262
11;Île-de-France;91;1;05;226;Étréchy;6806;94;6900
11;Île-de-France;91;2;09;228;Évry-Courcouronnes;66106;437;66543
11;Île-de-France;91;1;13;232;La Ferté-Alais;3656;55;3711
11;Île-de-France;91;2;15;235;Fleury-Mérogis;13708;21;13729
11;Île-de-France;91;1;08;240;Fontaine-la-Rivière;179;4;183
11;Île-de-France;91;3;05;243;Fontenay-lès-Briis;2281;33;2314
11;Île-de-France;91;2;13;244;Fontenay-le-Vicomte;1565;27;1592
11;Île-de-France;91;1;05;247;La Forêt-le-Roi;510;11;521
11;Île-de-France;91;1;08;248;La Forêt-Sainte-Croix;163;1;164
11;Île-de-France;91;3;05;249;Forges-les-Bains;3973;75;4048
11;Île-de-France;91;3;10;272;Gif-sur-Yvette;21439;557;21996
11;Île-de-France;91;2;13;273;Gironville-sur-Essonne;763;18;781
11;Île-de-France;91;3;10;274;Gometz-la-Ville;1511;24;1535
11;Île-de-France;91;3;18;275;Gometz-le-Châtel;2618;48;2666
11;Île-de-France;91;1;05;284;Les Granges-le-Roi;1184;23;1207
11;Île-de-France;91;2;20;286;Grigny;27571;84;27655
11;Île-de-France;91;3;01;292;Guibeville;871;6;877
11;Île-de-France;91;1;13;293;Guigneville-sur-Essonne;893;17;910
11;Île-de-France;91;1;08;294;Guillerval;813;8;821
11;Île-de-France;91;3;14;312;Igny;10157;330;10487
11;Île-de-France;91;1;13;315;Itteville;6638;63;6701
11;Île-de-France;91;1;01;318;Janville-sur-Juine;1964;48;2012
11;Île-de-France;91;3;05;319;Janvry;638;10;648
11;Île-de-France;91;3;02;326;Juvisy-sur-Orge;17656;117;17773
11;Île-de-France;91;1;01;330;Lardy;5462;102;5564
11;Île-de-France;91;3;03;332;Leudeville;1557;25;1582
11;Île-de-France;91;3;01;333;Leuville-sur-Orge;4350;43;4393
11;Île-de-France;91;3;05;338;Limours;6460;121;6581
11;Île-de-France;91;3;11;339;Linas;6864;49;6913
11;Île-de-France;91;2;04;340;Lisses;7302;64;7366
11;Île-de-France;91;3;11;345;Longjumeau;21105;137;21242
11;Île-de-France;91;3;03;347;Longpont-sur-Orge;6378;83;6461
11;Île-de-France;91;2;13;359;Maisse;2809;39;2848
11;Île-de-France;91;3;18;363;Marcoussis;8262;136;8398
11;Île-de-France;91;1;08;374;Marolles-en-Beauce;239;4;243
11;Île-de-France;91;3;03;376;Marolles-en-Hurepoix;5607;53;5660
11;Île-de-France;91;3;12;377;Massy;50506;338;50844
11;Île-de-France;91;1;05;378;Mauchamps;331;3;334
11;Île-de-France;91;2;13;386;Mennecy;15669;245;15914
11;Île-de-France;91;1;08;390;Le Mérévillois;3307;43;3350
11;Île-de-France;91;1;08;393;Mérobert;630;8;638
11;Île-de-France;91;1;08;399;Mespuits;214;1;215
11;Île-de-France;91;2;13;405;Milly-la-Forêt;4620;91;4711
11;Île-de-France;91;2;13;408;Moigny-sur-École;1252;31;1283
11;Île-de-France;91;3;10;411;Les Molières;1856;49;1905
11;Île-de-France;91;1;13;412;Mondeville;733;11;744
11;Île-de-France;91;1;08;414;Monnerville;378;5;383
11;Île-de-France;91;2;99;421;Montgeron;23943;274;24217
11;Île-de-France;91;3;11;425;Montlhéry;8561;227;8788
11;Île-de-France;91;3;17;432;Morangis;13131;84;13215
11;Île-de-France;91;1;08;433;Morigny-Champigny;4376;105;4481
11;Île-de-France;91;2;16;434;Morsang-sur-Orge;20149;170;20319
11;Île-de-France;91;2;07;435;Morsang-sur-Seine;561;18;579
11;Île-de-France;91;2;13;441;Nainville-les-Roches;517;11;528
11;Île-de-France;91;3;01;457;La Norville;4316;46;4362
11;Île-de-France;91;3;18;458;Nozay;4490;73;4563
11;Île-de-France;91;3;01;461;Ollainville;4803;59;4862
11;Île-de-France;91;2;13;463;Oncy-sur-École;1040;21;1061
11;Île-de-France;91;2;13;468;Ormoy;2200;21;2221
11;Île-de-France;91;1;08;469;Ormoy-la-Rivière;909;50;959
11;Île-de-France;91;3;14;471;Orsay;15554;336;15890
11;Île-de-France;91;1;08;473;Orveau;155;2;157
11;Île-de-France;91;3;14;477;Palaiseau;34750;306;35056
11;Île-de-France;91;3;02;479;Paray-Vieille-Poste;7823;62;7885
11;Île-de-France;91;3;10;482;Pecqueuse;547;11;558
11;Île-de-France;91;3;15;494;Le Plessis-Pâté;4114;58;4172
11;Île-de-France;91;1;08;495;Plessis-Saint-Benoist;331;4;335
11;Île-de-France;91;2;13;507;Prunay-sur-Essonne;287;5;292
11;Île-de-France;91;1;08;508;Puiselet-le-Marais;259;4;263
11;Île-de-France;91;1;08;511;Pussay;2120;29;2149
11;Île-de-France;91;2;07;514;Quincy-sous-Sénart;9463;59;9522
11;Île-de-France;91;1;05;519;Richarville;391;11;402
11;Île-de-France;91;2;15;521;Ris-Orangis;29643;186;29829
11;Île-de-France;91;1;05;525;Roinville;1313;25;1338
11;Île-de-France;91;1;08;526;Roinvilliers;106;1;107
11;Île-de-France;91;1;08;533;Saclas;1854;24;1878
11;Île-de-France;91;3;10;534;Saclay;4261;58;4319
11;Île-de-France;91;3;10;538;Saint-Aubin;691;18;709
11;Île-de-France;91;1;05;540;Saint-Chéron;5264;79;5343
11;Île-de-France;91;1;08;544;Saint-Cyr-la-Rivière;506;6;512
11;Île-de-France;91;1;05;546;Saint-Cyr-sous-Dourdan;941;22;963
11;Île-de-France;91;1;08;547;Saint-Escobille;478;16;494
11;Île-de-France;91;3;16;549;Sainte-Geneviève-des-Bois;35879;311;36190
11;Île-de-France;91;3;01;552;Saint-Germain-lès-Arpajon;11068;82;11150
11;Île-de-France;91;2;06;553;Saint-Germain-lès-Corbeil;7474;97;7571
11;Île-de-France;91;1;08;556;Saint-Hilaire;408;8;416
11;Île-de-France;91;3;18;560;Saint-Jean-de-Beauregard;482;5;487
11;Île-de-France;91;3;05;568;Saint-Maurice-Montcouronne;1540;37;1577
11;Île-de-France;91;3;03;570;Saint-Michel-sur-Orge;21298;143;21441
11;Île-de-France;91;2;07;573;Saint-Pierre-du-Perray;11514;104;11618
11;Île-de-France;91;2;07;577;Saintry-sur-Seine;5835;66;5901
11;Île-de-France;91;1;05;578;Saint-Sulpice-de-Favières;268;5;273
11;Île-de-France;91;3;03;579;Saint-Vrain;3029;51;3080
11;Île-de-France;91;1;01;581;Saint-Yon;907;10;917
11;Île-de-France;91;3;11;587;Saulx-les-Chartreux;6593;57;6650
11;Île-de-France;91;3;17;589;Savigny-sur-Orge;37190;251;37441
11;Île-de-France;91;1;05;593;Sermaise;1605;37;1642
11;Île-de-France;91;2;13;599;Soisy-sur-École;1245;19;1264
11;Île-de-France;91;2;06;600;Soisy-sur-Seine;7218;139;7357
11;Île-de-France;91;1;05;602;Souzy-la-Briche;445;9;454
11;Île-de-France;91;1;08;613;Congerville-Thionville;215;8;223
11;Île-de-France;91;2;07;617;Tigery;4380;77;4457
11;Île-de-France;91;1;01;619;Torfou;273;10;283
11;Île-de-France;91;1;08;629;Valpuiseaux;620;14;634
11;Île-de-France;91;1;05;630;Le Val-Saint-Germain;1498;32;1530
11;Île-de-France;91;2;07;631;Varennes-Jarcy;2302;31;2333
11;Île-de-France;91;3;05;634;Vaugrigneuse;1389;32;1421
11;Île-de-France;91;3;10;635;Vauhallan;2054;33;2087
11;Île-de-France;91;1;08;639;Vayres-sur-Essonne;962;68;1030
11;Île-de-France;91;3;10;645;Verrières-le-Buisson;14602;329;14931
11;Île-de-France;91;2;15;648;Vert-le-Grand;2260;26;2286
11;Île-de-France;91;2;15;649;Vert-le-Petit;2782;28;2810
11;Île-de-France;91;1;13;654;Videlles;590;17;607
11;Île-de-France;91;2;19;657;Vigneux-sur-Seine;31495;145;31640
11;Île-de-France;91;2;04;659;Villabé;5469;44;5513
11;Île-de-France;91;3;18;661;Villebon-sur-Yvette;10406;167;10573
11;Île-de-France;91;1;05;662;Villeconin;747;14;761
11;Île-de-France;91;3;11;665;La Ville-du-Bois;8021;91;8112
11;Île-de-France;91;3;18;666;Villejust;2446;18;2464
11;Île-de-France;91;3;16;667;Villemoisson-sur-Orge;7014;88;7102
11;Île-de-France;91;1;08;671;Villeneuve-sur-Auvers;598;6;604
11;Île-de-France;91;3;10;679;Villiers-le-Bâcle;1155;22;1177
11;Île-de-France;91;3;16;685;Villiers-sur-Orge;4592;33;4625
11;Île-de-France;91;2;20;687;Viry-Châtillon;31098;199;31297
11;Île-de-France;91;3;17;689;Wissous;7063;71;7134
11;Île-de-France;91;2;21;691;Yerres;29097;228;29325
11;Île-de-France;91;3;18;692;Les Ulis;25165;134;25299
11;Île-de-France;92;1;01;002;Antony;62906;733;63639
11;Île-de-France;92;2;95;004;Asnières-sur-Seine;88004;668;88672
11;Île-de-France;92;1;03;007;Bagneux;41967;155;42122
11;Île-de-France;92;2;11;009;Bois-Colombes;29555;262;29817
11;Île-de-France;92;3;96;012;Boulogne-Billancourt;120911;1251;122162
11;Île-de-France;92;1;03;014;Bourg-la-Reine;20974;317;21291
11;Île-de-France;92;1;06;019;Châtenay-Malabry;34383;365;34748
11;Île-de-France;92;1;07;020;Châtillon;36392;296;36688
11;Île-de-France;92;3;17;022;Chaville;20524;306;20830
11;Île-de-France;92;1;08;023;Clamart;53179;561;53740
11;Île-de-France;92;2;09;024;Clichy;62933;233;63166
11;Île-de-France;92;2;97;025;Colombes;86775;553;87328
11;Île-de-France;92;2;98;026;Courbevoie;82074;627;82701
11;Île-de-France;92;1;07;032;Fontenay-aux-Roses;25174;215;25389
11;Île-de-France;92;2;23;033;Garches;17557;403;17960
11;Île-de-France;92;2;11;035;La Garenne-Colombes;29624;266;29890
11;Île-de-France;92;2;14;036;Gennevilliers;49880;216;50096
11;Île-de-France;92;3;15;040;Issy-les-Moulineaux;67937;704;68641
11;Île-de-France;92;2;16;044;Levallois-Perret;67258;551;67809
11;Île-de-France;92;1;18;046;Malakoff;31230;182;31412
11;Île-de-France;92;3;23;047;Marnes-la-Coquette;1756;59;1815
11;Île-de-France;92;3;17;048;Meudon;45825;692;46517
11;Île-de-France;92;1;18;049;Montrouge;47907;267;48174
11;Île-de-France;92;2;99;050;Nanterre;95782;620;96402
11;Île-de-France;92;2;21;051;Neuilly-sur-Seine;59388;1023;60411
11;Île-de-France;92;1;06;060;Le Plessis-Robinson;29562;157;29719
11;Île-de-France;92;2;13;062;Puteaux;44009;266;44275
11;Île-de-France;92;2;22;063;Rueil-Malmaison;78265;1448;79713
11;Île-de-France;92;2;23;064;Saint-Cloud;29560;555;30115
11;Île-de-France;92;1;06;071;Sceaux;20359;362;20721
11;Île-de-France;92;3;05;072;Sèvres;23108;364;23472
11;Île-de-France;92;2;20;073;Suresnes;49482;510;49992
11;Île-de-France;92;3;08;075;Vanves;27871;286;28157
11;Île-de-France;92;2;23;076;Vaucresson;8627;314;8941
11;Île-de-France;92;3;23;077;Ville-d'Avray;10883;287;11170
11;Île-de-France;92;2;14;078;Villeneuve-la-Garenne;24592;78;24670
11;Île-de-France;93;3;01;001;Aubervilliers;89401;158;89559
11;Île-de-France;93;2;02;005;Aulnay-sous-Bois;86485;388;86873
11;Île-de-France;93;1;03;006;Bagnolet;38470;101;38571
11;Île-de-France;93;2;04;007;Le Blanc-Mesnil;57989;127;58116
11;Île-de-France;93;1;95;008;Bobigny;54906;160;55066
11;Île-de-France;93;1;06;010;Bondy;53342;167;53509
11;Île-de-France;93;2;07;013;Le Bourget;15660;35;15695
11;Île-de-France;93;2;11;014;Clichy-sous-Bois;29568;56;29624
11;Île-de-France;93;2;20;015;Coubron;4975;42;5017
11;Île-de-France;93;3;07;027;La Courneuve;46828;123;46951
11;Île-de-France;93;2;96;029;Drancy;71276;259;71535
11;Île-de-France;93;2;07;030;Dugny;11200;32;11232
11;Île-de-France;93;3;97;031;Épinay-sur-Seine;54419;150;54569
11;Île-de-France;93;2;10;032;Gagny;39588;229;39817
11;Île-de-France;93;2;14;033;Gournay-sur-Marne;6814;62;6876
11;Île-de-France;93;3;18;039;L'Île-Saint-Denis;8646;19;8665
11;Île-de-France;93;1;03;045;Les Lilas;23276;120;23396
11;Île-de-France;93;2;11;046;Livry-Gargan;45618;200;45818
11;Île-de-France;93;2;20;047;Montfermeil;28006;135;28141
11;Île-de-France;93;1;98;048;Montreuil;111367;587;111954
11;Île-de-France;93;2;21;049;Neuilly-Plaisance;20934;125;21059
11;Île-de-France;93;2;10;050;Neuilly-sur-Marne;36535;105;36640
11;Île-de-France;93;2;14;051;Noisy-le-Grand;68930;422;69352
11;Île-de-France;93;1;05;053;Noisy-le-Sec;45043;113;45156
11;Île-de-France;93;1;15;055;Pantin;60419;178;60597
11;Île-de-France;93;2;06;057;Les Pavillons-sous-Bois;23904;99;24003
11;Île-de-France;93;3;09;059;Pierrefitte-sur-Seine;31344;49;31393
11;Île-de-France;93;1;15;061;Le Pré-Saint-Gervais;17290;52;17342
11;Île-de-France;93;2;21;062;Le Raincy;14753;196;14949
11;Île-de-France;93;1;03;063;Romainville;31469;85;31554
11;Île-de-France;93;2;12;064;Rosny-sous-Bois;45442;180;45622
11;Île-de-France;93;3;99;066;Saint-Denis;113116;911;114027
11;Île-de-France;93;3;18;070;Saint-Ouen-sur-Seine;51547;109;51656
11;Île-de-France;93;2;19;071;Sevran;51778;179;51957
11;Île-de-France;93;3;17;072;Stains;39193;84;39277
11;Île-de-France;93;2;20;073;Tremblay-en-France;36477;176;36653
11;Île-de-France;93;2;20;074;Vaujours;7194;89;7283
11;Île-de-France;93;2;21;077;Villemomble;30583;180;30763
11;Île-de-France;93;2;19;078;Villepinte;38204;79;38283
11;Île-de-France;93;3;09;079;Villetaneuse;13433;80;13513
11;Île-de-France;94;3;15;001;Ablon-sur-Seine;5906;32;5938
11;Île-de-France;94;1;01;002;Alfortville;45151;166;45317
11;Île-de-France;94;3;02;003;Arcueil;21840;122;21962
11;Île-de-France;94;1;16;004;Boissy-Saint-Léger;17286;59;17345
11;Île-de-France;94;1;18;011;Bonneuil-sur-Marne;18424;64;18488
11;Île-de-France;94;2;22;015;Bry-sur-Marne;17592;204;17796
11;Île-de-France;94;3;02;016;Cachan;30214;278;30492
11;Île-de-France;94;2;93;017;Champigny-sur-Marne;77439;312;77751
11;Île-de-France;94;2;05;018;Charenton-le-Pont;29632;210;29842
11;Île-de-France;94;1;04;019;Chennevières-sur-Marne;18011;104;18115
11;Île-de-France;94;3;19;021;Chevilly-Larue;20372;75;20447
11;Île-de-France;94;3;06;022;Choisy-le-Roi;46229;237;46466
11;Île-de-France;94;1;94;028;Créteil;92566;418;92984
11;Île-de-France;94;2;09;033;Fontenay-sous-Bois;51386;421;51807
11;Île-de-France;94;3;10;034;Fresnes;28556;123;28679
11;Île-de-France;94;3;12;037;Gentilly;18813;137;18950
11;Île-de-France;94;3;10;038;L'Haÿ-les-Roses;31647;200;31847
11;Île-de-France;94;3;11;041;Ivry-sur-Seine;64016;232;64248
11;Île-de-France;94;2;05;042;Joinville-le-Pont;19128;150;19278
11;Île-de-France;94;3;12;043;Le Kremlin-Bicêtre;24513;129;24642
11;Île-de-France;94;1;21;044;Limeil-Brévannes;28290;101;28391
11;Île-de-France;94;2;13;046;Maisons-Alfort;57639;305;57944
11;Île-de-France;94;1;16;047;Mandres-les-Roses;4788;48;4836
11;Île-de-France;94;1;16;048;Marolles-en-Brie;4737;107;4844
11;Île-de-France;94;2;95;052;Nogent-sur-Marne;33578;242;33820
11;Île-de-France;94;1;16;053;Noiseau;4602;42;4644
11;Île-de-France;94;3;15;054;Orly;24361;165;24526
11;Île-de-France;94;1;18;055;Ormesson-sur-Marne;10528;83;10611
11;Île-de-France;94;1;16;056;Périgny;2707;33;2740
11;Île-de-France;94;2;14;058;Le Perreux-sur-Marne;33697;284;33981
11;Île-de-France;94;1;22;059;Le Plessis-Trévise;19651;82;19733
11;Île-de-France;94;1;16;060;La Queue-en-Brie;12148;125;12273
11;Île-de-France;94;3;19;065;Rungis;5625;48;5673
11;Île-de-France;94;2;23;067;Saint-Mandé;21991;200;22191
11;Île-de-France;94;2;96;068;Saint-Maur-des-Fossés;74520;929;75449
11;Île-de-France;94;2;05;069;Saint-Maurice;14560;113;14673
11;Île-de-France;94;1;16;070;Santeny;3994;61;4055
11;Île-de-France;94;1;18;071;Sucy-en-Brie;27040;278;27318
11;Île-de-France;94;3;19;073;Thiais;30788;206;30994
11;Île-de-France;94;3;21;074;Valenton;14538;41;14579
11;Île-de-France;94;1;16;075;Villecresnes;11846;73;11919
11;Île-de-France;94;3;20;076;Villejuif;56349;236;56585
11;Île-de-France;94;3;15;077;Villeneuve-le-Roi;21411;82;21493
11;Île-de-France;94;3;97;078;Villeneuve-Saint-Georges;34845;94;34939
11;Île-de-France;94;2;22;079;Villiers-sur-Marne;29672;148;29820
11;Île-de-France;94;2;98;080;Vincennes;49697;471;50168
11;Île-de-France;94;3;99;081;Vitry-sur-Seine;95649;489;96138
11;Île-de-France;95;3;16;002;Ableiges;1105;14;1119
11;Île-de-France;95;3;20;008;Aincourt;879;12;891
11;Île-de-France;95;3;20;011;Ambleville;394;3;397
11;Île-de-France;95;3;20;012;Amenucourt;206;1;207
11;Île-de-France;95;2;15;014;Andilly;2703;41;2744
11;Île-de-France;95;1;98;018;Argenteuil;108567;491;109058
11;Île-de-France;95;2;11;019;Arnouville;14364;70;14434
11;Île-de-France;95;3;16;023;Arronville;630;3;633
11;Île-de-France;95;3;20;024;Arthies;271;4;275
11;Île-de-France;95;2;14;026;Asnières-sur-Oise;3083;42;3125
11;Île-de-France;95;2;09;028;Attainville;1695;8;1703
11;Île-de-France;95;3;17;039;Auvers-sur-Oise;6792;100;6892
11;Île-de-France;95;3;20;040;Avernes;860;13;873
11;Île-de-France;95;2;07;042;Baillet-en-France;1893;15;1908
11;Île-de-France;95;3;20;046;Banthelu;149;2;151
11;Île-de-France;95;1;19;051;Beauchamp;8900;93;8993
11;Île-de-France;95;3;14;052;Beaumont-sur-Oise;9572;99;9671
11;Île-de-France;95;3;16;054;Le Bellay-en-Vexin;214;5;219
11;Île-de-France;95;2;09;055;Bellefontaine;473;3;476
11;Île-de-France;95;2;09;056;Belloy-en-France;2217;10;2227
11;Île-de-France;95;3;14;058;Bernes-sur-Oise;2743;25;2768
11;Île-de-France;95;3;16;059;Berville;362;4;366
11;Île-de-France;95;1;19;060;Bessancourt;7876;57;7933
11;Île-de-France;95;3;07;061;Béthemont-la-Forêt;409;2;411
11;Île-de-France;95;1;03;063;Bezons;31866;112;31978
11;Île-de-France;95;3;05;074;Boisemont;855;17;872
11;Île-de-France;95;3;16;078;Boissy-l'Aillerie;1934;26;1960
11;Île-de-France;95;2;21;088;Bonneuil-en-France;1158;2;1160
11;Île-de-France;95;2;07;091;Bouffémont;6596;58;6654
11;Île-de-France;95;2;21;094;Bouqueval;303;3;306
11;Île-de-France;95;3;20;101;Bray-et-Lû;966;10;976
11;Île-de-France;95;3;16;102;Bréançon;420;9;429
11;Île-de-France;95;3;16;110;Brignancourt;221;3;224
11;Île-de-France;95;3;14;116;Bruyères-sur-Oise;4367;35;4402
11;Île-de-France;95;3;20;119;Buhy;320;3;323
11;Île-de-France;95;3;17;120;Butry-sur-Oise;2266;28;2294
11;Île-de-France;95;3;99;127;Cergy;67790;485;68275
11;Île-de-France;95;3;14;134;Champagne-sur-Oise;5019;61;5080
11;Île-de-France;95;3;20;139;La Chapelle-en-Vexin;322;5;327
11;Île-de-France;95;3;20;141;Charmont;36;0;36
11;Île-de-France;95;3;16;142;Chars;2042;17;2059
11;Île-de-France;95;2;09;144;Châtenay-en-France;77;1;78
11;Île-de-France;95;2;09;149;Chaumontel;3230;53;3283
11;Île-de-France;95;3;20;150;Chaussy;599;8;607
11;Île-de-France;95;3;07;151;Chauvry;297;5;302
11;Île-de-France;95;2;12;154;Chennevières-lès-Louvres;308;3;311
11;Île-de-France;95;3;20;157;Chérence;121;3;124
11;Île-de-France;95;3;20;166;Cléry-en-Vexin;473;6;479
11;Île-de-France;95;3;16;169;Commeny;511;3;514
11;Île-de-France;95;3;20;170;Condécourt;544;2;546
11;Île-de-France;95;1;10;176;Cormeilles-en-Parisis;26074;223;26297
11;Île-de-France;95;3;16;177;Cormeilles-en-Vexin;1298;14;1312
11;Île-de-France;95;3;16;181;Courcelles-sur-Viosne;298;3;301
11;Île-de-France;95;3;20;183;Courdimanche;6720;108;6828
11;Île-de-France;95;2;06;197;Deuil-la-Barre;22050;196;22246
11;Île-de-France;95;2;07;199;Domont;15685;189;15874
11;Île-de-France;95;1;08;203;Eaubonne;25498;284;25782
11;Île-de-France;95;2;09;205;Écouen;7099;43;7142
11;Île-de-France;95;2;15;210;Enghien-les-Bains;11416;158;11574
11;Île-de-France;95;3;16;211;Ennery;2467;23;2490
11;Île-de-France;95;2;12;212;Épiais-lès-Louvres;112;0;112
11;Île-de-France;95;3;16;213;Épiais-Rhus;616;15;631
11;Île-de-France;95;2;09;214;Épinay-Champlâtreux;66;0;66
11;Île-de-France;95;3;05;218;Éragny;18317;133;18450
11;Île-de-France;95;1;08;219;Ermont;29230;223;29453
11;Île-de-France;95;2;09;229;Ézanville;9594;57;9651
11;Île-de-France;95;2;09;241;Fontenay-en-Parisis;2078;13;2091
11;Île-de-France;95;2;09;250;Fosses;9830;65;9895
11;Île-de-France;95;1;10;252;Franconville;37347;147;37494
11;Île-de-France;95;3;20;253;Frémainville;515;9;524
11;Île-de-France;95;3;16;254;Frémécourt;551;7;558
11;Île-de-France;95;1;17;256;Frépillon;3346;46;3392
11;Île-de-France;95;1;13;257;La Frette-sur-Seine;4655;54;4709
11;Île-de-France;95;3;17;258;Frouville;349;8;357
11;Île-de-France;95;2;11;268;Garges-lès-Gonesse;43215;79;43294
11;Île-de-France;95;3;20;270;Genainville;537;9;546
11;Île-de-France;95;3;16;271;Génicourt;514;9;523
11;Île-de-France;95;2;21;277;Gonesse;25853;97;25950
11;Île-de-France;95;2;12;280;Goussainville;30910;142;31052
11;Île-de-France;95;3;16;282;Gouzangrez;156;4;160
11;Île-de-France;95;3;16;287;Grisy-les-Plâtres;698;13;711
11;Île-de-France;95;2;06;288;Groslay;8474;45;8519
11;Île-de-France;95;3;20;295;Guiry-en-Vexin;143;3;146
11;Île-de-France;95;3;16;298;Haravilliers;566;6;572
11;Île-de-France;95;3;20;301;Haute-Isle;290;6;296
11;Île-de-France;95;3;16;303;Le Heaulme;203;1;204
11;Île-de-France;95;3;17;304;Hédouville;281;2;283
11;Île-de-France;95;1;13;306;Herblay-sur-Seine;31747;223;31970
11;Île-de-France;95;3;17;308;Hérouville-en-Vexin;572;13;585
11;Île-de-France;95;3;20;309;Hodent;213;0;213
11;Île-de-France;95;3;14;313;L'Isle-Adam;11723;200;11923
11;Île-de-France;95;2;09;316;Jagny-sous-Bois;271;7;278
11;Île-de-France;95;3;05;323;Jouy-le-Moutier;17225;132;17357
11;Île-de-France;95;3;17;328;Labbeville;644;7;651
11;Île-de-France;95;2;09;331;Lassy;191;3;194
11;Île-de-France;95;3;16;341;Livilliers;382;4;386
11;Île-de-France;95;3;20;348;Longuesse;535;9;544
11;Île-de-France;95;2;12;351;Louvres;11356;80;11436
11;Île-de-France;95;2;09;352;Luzarches;4828;78;4906
11;Île-de-France;95;2;09;353;Maffliers;1830;18;1848
11;Île-de-France;95;3;20;355;Magny-en-Vexin;5810;55;5865
11;Île-de-France;95;2;09;365;Mareil-en-France;718;8;726
11;Île-de-France;95;2;15;369;Margency;2830;47;2877
11;Île-de-France;95;3;16;370;Marines;3438;53;3491
11;Île-de-France;95;2;12;371;Marly-la-Ville;5661;42;5703
11;Île-de-France;95;3;20;379;Maudétour-en-Vexin;193;3;196
11;Île-de-France;95;3;16;387;Menouville;63;0;63
11;Île-de-France;95;3;20;388;Menucourt;5998;47;6045
11;Île-de-France;95;3;17;392;Mériel;5211;55;5266
11;Île-de-France;95;3;17;394;Méry-sur-Oise;9983;100;10083
11;Île-de-France;95;2;09;395;Le Mesnil-Aubry;907;9;916
11;Île-de-France;95;2;07;409;Moisselles;1264;3;1267
11;Île-de-France;95;3;16;422;Montgeroult;338;3;341
11;Île-de-France;95;1;13;424;Montigny-lès-Cormeilles;22186;119;22305
11;Île-de-France;95;2;15;426;Montlignon;2917;74;2991
11;Île-de-France;95;2;06;427;Montmagny;14550;65;14615
11;Île-de-France;95;2;15;428;Montmorency;21688;254;21942
11;Île-de-France;95;3;20;429;Montreuil-sur-Epte;398;8;406
11;Île-de-France;95;2;07;430;Montsoult;3703;34;3737
11;Île-de-France;95;3;14;436;Mours;1655;8;1663
11;Île-de-France;95;3;16;438;Moussy;116;2;118
11;Île-de-France;95;3;14;445;Nerville-la-Forêt;753;5;758
11;Île-de-France;95;3;17;446;Nesles-la-Vallée;1780;31;1811
11;Île-de-France;95;3;16;447;Neuilly-en-Vexin;229;4;233
11;Île-de-France;95;3;05;450;Neuville-sur-Oise;2056;28;2084
11;Île-de-France;95;3;14;452;Nointel;868;7;875
11;Île-de-France;95;3;14;456;Noisy-sur-Oise;647;4;651
11;Île-de-France;95;3;16;459;Nucourt;706;12;718
11;Île-de-France;95;3;20;462;Omerville;322;8;330
11;Île-de-France;95;3;04;476;Osny;17111;219;17330
11;Île-de-France;95;3;14;480;Parmain;5602;112;5714
11;Île-de-France;95;3;16;483;Le Perchay;531;4;535
11;Île-de-France;95;3;14;487;Persan;14029;53;14082
11;Île-de-France;95;1;19;488;Pierrelaye;9734;38;9772
11;Île-de-France;95;2;07;489;Piscop;669;68;737
11;Île-de-France;95;1;07;491;Le Plessis-Bouchard;8454;70;8524
11;Île-de-France;95;2;09;492;Le Plessis-Gassot;82;2;84
11;Île-de-France;95;2;09;493;Le Plessis-Luzarches;130;1;131
11;Île-de-France;95;3;16;500;Pontoise;31973;480;32453
11;Île-de-France;95;3;14;504;Presles;3948;51;3999
11;Île-de-France;95;2;09;509;Puiseux-en-France;3583;32;3615
11;Île-de-France;95;3;04;510;Puiseux-Pontoise;571;11;582
11;Île-de-France;95;3;20;523;La Roche-Guyon;479;37;516
11;Île-de-France;95;2;21;527;Roissy-en-France;2793;24;2817
11;Île-de-France;95;3;14;529;Ronquerolles;874;20;894
11;Île-de-France;95;3;20;535;Sagy;1103;22;1125
11;Île-de-France;95;2;06;539;Saint-Brice-sous-Forêt;15102;80;15182
11;Île-de-France;95;3;20;541;Saint-Clair-sur-Epte;993;10;1003
11;Île-de-France;95;3;20;543;Saint-Cyr-en-Arthies;239;1;240
11;Île-de-France;95;3;20;554;Saint-Gervais;891;19;910
11;Île-de-France;95;2;01;555;Saint-Gratien;20914;146;21060
11;Île-de-France;95;1;07;563;Saint-Leu-la-Forêt;16076;166;16242
11;Île-de-France;95;2;09;566;Saint-Martin-du-Tertre;2656;23;2679
11;Île-de-France;95;3;17;572;Saint-Ouen-l'Aumône;24743;106;24849
11;Île-de-France;95;2;07;574;Saint-Prix;7220;78;7298
11;Île-de-France;95;2;12;580;Saint-Witz;2439;109;2548
11;Île-de-France;95;1;01;582;Sannois;26524;354;26878
11;Île-de-France;95;3;16;584;Santeuil;663;7;670
11;Île-de-France;95;2;18;585;Sarcelles;58483;232;58715
11;Île-de-France;95;3;20;592;Seraincourt;1297;14;1311
11;Île-de-France;95;2;09;594;Seugy;1038;14;1052
11;Île-de-France;95;2;15;598;Soisy-sous-Montmorency;18061;167;18228
11;Île-de-France;95;2;12;604;Survilliers;4276;29;4305
11;Île-de-France;95;1;19;607;Taverny;26607;166;26773
11;Île-de-France;95;3;20;610;Théméricourt;301;7;308
11;Île-de-France;95;3;16;611;Theuville;53;0;53
11;Île-de-France;95;2;21;612;Le Thillay;4597;20;4617
11;Île-de-France;95;3;16;625;Us;1339;11;1350
11;Île-de-France;95;3;16;627;Vallangoujard;594;12;606
11;Île-de-France;95;3;17;628;Valmondois;1222;25;1247
11;Île-de-France;95;2;21;633;Vaudherland;101;0;101
11;Île-de-France;95;3;20;637;Vauréal;16020;187;16207
11;Île-de-France;95;2;12;641;Vémars;2710;18;2728
11;Île-de-France;95;3;20;651;Vétheuil;885;18;903
11;Île-de-France;95;2;09;652;Viarmes;5264;65;5329
11;Île-de-France;95;3;20;656;Vienne-en-Arthies;376;6;382
11;Île-de-France;95;3;20;658;Vigny;1098;20;1118
11;Île-de-France;95;2;09;660;Villaines-sous-Bois;762;9;771
11;Île-de-France;95;2;12;675;Villeron;1534;14;1548
11;Île-de-France;95;3;20;676;Villers-en-Arthies;490;10;500
11;Île-de-France;95;3;14;678;Villiers-Adam;857;16;873
11;Île-de-France;95;2;21;680;Villiers-le-Bel;28636;106;28742
11;Île-de-France;95;2;09;682;Villiers-le-Sec;193;3;196
11;Île-de-France;95;3;20;690;Wy-dit-Joli-Village;330;3;333
01;Guadeloupe;971;2;93;101;Les Abymes;52948;495;53443
01;Guadeloupe;971;2;14;102;Anse-Bertrand;3871;58;3929
01;Guadeloupe;971;1;94;103;Baie-Mahault;30316;458;30774
01;Guadeloupe;971;1;21;104;Baillif;5122;88;5210
01;Guadeloupe;971;1;06;105;Basse-Terre;9892;216;10108
01;Guadeloupe;971;1;95;106;Bouillante;6760;109;6869
01;Guadeloupe;971;1;07;107;Capesterre-Belle-Eau;17628;160;17788
01;Guadeloupe;971;2;10;108;Capesterre-de-Marie-Galante;3247;27;3274
01;Guadeloupe;971;1;20;109;Gourbeyre;7638;110;7748
01;Guadeloupe;971;2;16;110;La Désirade;1406;30;1436
01;Guadeloupe;971;1;18;111;Deshaies;3963;60;4023
01;Guadeloupe;971;2;10;112;Grand-Bourg;4803;71;4874
01;Guadeloupe;971;2;96;113;Le Gosier;26919;267;27186
01;Guadeloupe;971;1;13;114;Goyave;7635;143;7778
01;Guadeloupe;971;1;09;115;Lamentin;17774;297;18071
01;Guadeloupe;971;2;12;116;Morne-à-l'Eau;16223;213;16436
01;Guadeloupe;971;2;11;117;Le Moule;22230;269;22499
01;Guadeloupe;971;1;97;118;Petit-Bourg;24412;369;24781
01;Guadeloupe;971;2;14;119;Petit-Canal;8195;124;8319
01;Guadeloupe;971;2;15;120;Pointe-à-Pitre;14498;83;14581
01;Guadeloupe;971;1;18;121;Pointe-Noire;5963;132;6095
01;Guadeloupe;971;2;14;122;Port-Louis;5601;79;5680
01;Guadeloupe;971;1;06;124;Saint-Claude;10506;229;10735
01;Guadeloupe;971;2;16;125;Saint-François;12184;138;12322
01;Guadeloupe;971;2;10;126;Saint-Louis;2462;32;2494
01;Guadeloupe;971;2;98;128;Sainte-Anne;24430;235;24665
01;Guadeloupe;971;1;99;129;Sainte-Rose;17840;261;18101
01;Guadeloupe;971;1;20;130;Terre-de-Bas;939;21;960
01;Guadeloupe;971;1;20;131;Terre-de-Haut;1513;49;1562
01;Guadeloupe;971;1;20;132;Trois-Rivières;7733;137;7870
01;Guadeloupe;971;1;20;133;Vieux-Fort;1841;30;1871
01;Guadeloupe;971;1;21;134;Vieux-Habitants;7067;178;7245
02;Martinique;972;2;NA;201;L'Ajoupa-Bouillon;1736;34;1770
02;Martinique;972;3;NA;202;Les Anses-d'Arlet;3630;26;3656
02;Martinique;972;2;NA;203;Basse-Pointe;2727;41;2768
02;Martinique;972;4;NA;204;Le Carbet;3424;51;3475
02;Martinique;972;4;NA;205;Case-Pilote;4475;58;4533
02;Martinique;972;3;NA;206;Le Diamant;5447;72;5519
02;Martinique;972;3;NA;207;Ducos;17504;261;17765
02;Martinique;972;4;NA;208;Fonds-Saint-Denis;661;12;673
02;Martinique;972;1;NA;209;Fort-de-France;75286;799;76085
02;Martinique;972;3;NA;210;Le François;16082;174;16256
02;Martinique;972;2;NA;211;Grand'Rivière;554;14;568
02;Martinique;972;2;NA;212;Gros-Morne;9758;64;9822
02;Martinique;972;1;NA;213;Le Lamentin;39628;563;40191
02;Martinique;972;2;NA;214;Le Lorrain;6713;85;6798
02;Martinique;972;2;NA;215;Macouba;1034;3;1037
02;Martinique;972;2;NA;216;Le Marigot;3078;48;3126
02;Martinique;972;3;NA;217;Le Marin;8647;71;8718
02;Martinique;972;4;NA;218;Le Morne-Rouge;4635;60;4695
02;Martinique;972;4;NA;219;Le Prêcheur;1291;13;1304
02;Martinique;972;3;NA;220;Rivière-Pilote;11675;143;11818
02;Martinique;972;3;NA;221;Rivière-Salée;11780;244;12024
02;Martinique;972;2;NA;222;Le Robert;21627;166;21793
02;Martinique;972;3;NA;223;Saint-Esprit;10120;98;10218
02;Martinique;972;1;NA;224;Saint-Joseph;16137;225;16362
02;Martinique;972;4;NA;225;Saint-Pierre;4107;52;4159
02;Martinique;972;3;NA;226;Sainte-Anne;4464;68;4532
02;Martinique;972;3;NA;227;Sainte-Luce;9425;202;9627
02;Martinique;972;2;NA;228;Sainte-Marie;14843;178;15021
02;Martinique;972;1;NA;229;Schœlcher;19467;171;19638
02;Martinique;972;2;NA;230;La Trinité;11860;135;11995
02;Martinique;972;3;NA;231;Les Trois-Îlets;7194;126;7320
02;Martinique;972;3;NA;232;Le Vauclin;8552;95;8647
02;Martinique;972;4;NA;233;Le Morne-Vert;1806;31;1837
02;Martinique;972;4;NA;234;Bellefontaine;1858;126;1984
03;Guyane;973;1;NA;301;Régina;844;26;870
03;Guyane;973;1;NA;302;Cayenne;65956;371;66327
03;Guyane;973;1;NA;303;Iracoubo;1729;13;1742
03;Guyane;973;1;NA;304;Kourou;24805;232;25037
03;Guyane;973;1;NA;305;Macouria;19087;165;19252
03;Guyane;973;2;NA;306;Mana;11605;158;11763
03;Guyane;973;1;NA;307;Matoury;34474;192;34666
03;Guyane;973;1;NA;308;Saint-Georges;4303;93;4396
03;Guyane;973;1;NA;309;Remire-Montjoly;25793;333;26126
03;Guyane;973;1;NA;310;Roura;3436;54;3490
03;Guyane;973;2;NA;311;Saint-Laurent-du-Maroni;49173;302;49475
03;Guyane;973;1;NA;312;Sinnamary;2855;44;2899
03;Guyane;973;1;NA;313;Montsinéry-Tonnegrande;3141;20;3161
03;Guyane;973;1;NA;314;Ouanary;266;1;267
03;Guyane;973;2;NA;352;Saül;153;7;160
03;Guyane;973;2;NA;353;Maripasoula;9768;136;9904
03;Guyane;973;1;NA;356;Camopi;1894;24;1918
03;Guyane;973;2;NA;357;Grand-Santi;8859;6;8865
03;Guyane;973;1;NA;358;Saint-Élie;244;1;245
03;Guyane;973;2;NA;360;Apatou;9582;21;9603
03;Guyane;973;2;NA;361;Awala-Yalimapo;1482;6;1488
03;Guyane;973;2;NA;362;Papaichton;5684;17;5701
04;La Réunion;974;2;01;401;Les Avirons;11470;210;11680
04;La Réunion;974;3;06;402;Bras-Panon;13416;206;13622
04;La Réunion;974;2;16;403;Entre-Deux;7040;69;7109
04;La Réunion;974;2;01;404;L'Étang-Salé;13645;196;13841
04;La Réunion;974;2;22;405;Petite-Île;12401;142;12543
04;La Réunion;974;3;07;406;La Plaine-des-Palmistes;6723;96;6819
04;La Réunion;974;4;02;407;Le Port;32619;245;32864
04;La Réunion;974;4;03;408;La Possession;33370;396;33766
04;La Réunion;974;3;91;409;Saint-André;56857;472;57329
04;La Réunion;974;3;92;410;Saint-Benoît;36994;271;37265
04;La Réunion;974;1;93;411;Saint-Denis;153001;1458;154459
04;La Réunion;974;2;94;412;Saint-Joseph;38465;532;38997
04;La Réunion;974;4;95;413;Saint-Leu;34740;484;35224
04;La Réunion;974;2;96;414;Saint-Louis;53744;578;54322
04;La Réunion;974;4;97;415;Saint-Paul;104301;1296;105597
04;La Réunion;974;2;98;416;Saint-Pierre;83930;892;84822
04;La Réunion;974;2;08;417;Saint-Philippe;5085;65;5150
04;La Réunion;974;1;23;418;Sainte-Marie;34350;424;34774
04;La Réunion;974;3;08;419;Sainte-Rose;6237;80;6317
04;La Réunion;974;1;04;420;Sainte-Suzanne;24086;241;24327
04;La Réunion;974;3;06;421;Salazie;7310;76;7386
04;La Réunion;974;2;99;422;Le Tampon;80778;950;81728
04;La Réunion;974;4;14;423;Les Trois-Bassins;6953;90;7043
04;La Réunion;974;2;16;424;Cilaos;5568;83;5651
